"genus","family","order","W","V","H","N","K","p"
"Aa","Orchidaceae","Asparagales",0,0,1,25,1,0
"Aaronsohnia","Asteraceae","Asterales",0,0,0,2,0,NA
"Abacopteris","Thelypteridaceae","Polypodiales",0,0,0,6,0,NA
"Abarema","Fabaceae","Fabales",8,0,0,53,8,1
"Abatia","Salicaceae","Malpighiales",8,0,0,10,8,1
"Abdominea","Orchidaceae","Asparagales",0,0,1,1,1,0
"Abelia","Caprifoliaceae","Dipsacales",6,0,0,29,6,1
"Abeliophyllum","Oleaceae","Lamiales",1,0,0,1,1,1
"Abelmoschus","Malvaceae","Malvales",1,0,3,10,4,0.25
"Abies","Pinaceae","Pinales",41,0,0,48,41,1
"Abobra","Cucurbitaceae","Cucurbitales",0,0,1,1,1,0
"Abolboda","Xyridaceae","Poales",0,0,1,22,1,0
"Abrahamia","Anacardiaceae","Sapindales",3,0,0,15,3,1
"Abrodictyum","Hymenophyllaceae","Hymenophyllales",0,0,0,10,0,NA
"Abroma","Malvaceae","Malvales",0,0,0,1,0,NA
"Abronia","Nyctaginaceae","Caryophyllales",0,0,2,30,2,0
"Abrophyllum","Rousseaceae","Asterales",1,0,0,2,1,1
"Abrotanella","Asteraceae","Asterales",0,1,1,20,1,0
"Abrus","Fabaceae","Fabales",1,0,0,19,1,1
"Absinthium","Asteraceae","Asterales",0,0,0,1,0,NA
"Absolmsia","Apocynaceae","Gentianales",0,0,0,1,0,NA
"Abuta","Menispermaceae","Ranunculales",10,0,0,33,10,1
"Abutilon","Malvaceae","Malvales",8,0,2,216,10,0.8
"Acacia","Fabaceae","Fabales",437,0,1,1393,438,0.997716894977169
"Acaciella","Fabaceae","Fabales",0,0,0,23,0,NA
"Acaena","Rosaceae","Rosales",0,0,5,31,5,0
"Acalypha","Euphorbiaceae","Malpighiales",18,0,12,454,30,0.6
"Acampe","Orchidaceae","Asparagales",0,0,3,8,3,0
"Acamptopappus","Asteraceae","Asterales",1,0,0,2,1,1
"Acanthella","Melastomataceae","Myrtales",0,0,0,2,0,NA
"Acanthephippium","Orchidaceae","Asparagales",0,0,2,13,2,0
"Acanthocalycium","Cactaceae","Caryophyllales",0,0,0,2,0,NA
"Acanthocarpus","Asparagaceae","Asparagales",1,0,0,7,1,1
"Acanthocephalus","Asteraceae","Asterales",0,0,0,2,0,NA
"Acanthocereus","Cactaceae","Caryophyllales",0,0,0,5,0,NA
"Acanthochlamys","Velloziaceae","Pandanales",0,0,0,1,0,NA
"Acanthocladium","Asteraceae","Asterales",1,0,0,1,1,1
"Acanthocladus","Polygalaceae","Fabales",0,0,0,9,0,NA
"Acanthodesmos","Asteraceae","Asterales",0,0,0,1,0,NA
"Acanthogilia","Polemoniaceae","Ericales",1,0,0,1,1,1
"Acantholimon","Plumbaginaceae","Caryophyllales",0,0,0,295,0,NA
"Acantholippia","Verbenaceae","Lamiales",3,0,0,6,3,1
"Acanthomintha","Lamiaceae","Lamiales",0,0,0,4,0,NA
"Acanthonema","Gesneriaceae","Lamiales",0,0,0,2,0,NA
"Acanthopale","Acanthaceae","Lamiales",0,0,0,9,0,NA
"Acanthophoenix","Arecaceae","Arecales",1,0,0,3,1,1
"Acanthophyllum","Caryophyllaceae","Caryophyllales",0,0,0,59,0,NA
"Acanthoprasium","Lamiaceae","Lamiales",0,0,0,2,0,NA
"Acanthopsis","Acanthaceae","Lamiales",0,0,0,8,0,NA
"Acanthorrhinum","Plantaginaceae","Lamiales",0,0,0,2,0,NA
"Acanthoscyphus","Polygonaceae","Caryophyllales",0,0,0,1,0,NA
"Acanthosicyos","Cucurbitaceae","Cucurbitales",1,0,0,2,1,1
"Acanthospermum","Asteraceae","Asterales",0,0,1,6,1,0
"Acanthostachys","Bromeliaceae","Poales",0,0,1,2,1,0
"Acanthostyles","Asteraceae","Asterales",0,0,0,2,0,NA
"Acanthosyris","Santalaceae","Santalales",4,0,0,6,4,1
"Acanthothamnus","Celastraceae","Celastrales",0,0,0,1,0,NA
"Acanthura","Acanthaceae","Lamiales",0,0,0,1,0,NA
"Acanthus","Acanthaceae","Lamiales",3,0,1,29,4,0.75
"Acareosperma","Vitaceae","Vitales",0,0,0,1,0,NA
"Acaulimalva","Malvaceae","Malvales",0,0,0,21,0,NA
"Acca","Myrtaceae","Myrtales",1,0,0,3,1,1
"Accara","Myrtaceae","Myrtales",0,0,0,1,0,NA
"Acentra","Violaceae","Malpighiales",0,0,0,1,0,NA
"Acer","Sapindaceae","Sapindales",66,0,0,164,66,1
"Aceratium","Elaeocarpaceae","Oxalidales",5,0,0,21,5,1
"Acharia","Achariaceae","Malpighiales",0,1,0,1,0,NA
"Achatocarpus","Achatocarpaceae","Caryophyllales",3,0,0,10,3,1
"Achetaria","Plantaginaceae","Lamiales",0,0,0,10,0,NA
"Achillea","Asteraceae","Asterales",0,0,9,151,9,0
"Achimenantha","Gesneriaceae","Lamiales",0,0,0,1,0,NA
"Achimenes","Gesneriaceae","Lamiales",0,0,2,26,2,0
"Achlyphila","Xyridaceae","Poales",0,0,0,1,0,NA
"Achlys","Berberidaceae","Ranunculales",0,0,1,2,1,0
"Achnatherum","Poaceae","Poales",0,0,0,1,0,NA
"Achnophora","Asteraceae","Asterales",0,0,0,1,0,NA
"Achnopogon","Asteraceae","Asterales",0,0,0,2,0,NA
"Achuaria","Rutaceae","Sapindales",0,0,0,1,0,NA
"Achudemia","Urticaceae","Rosales",0,0,0,3,0,NA
"Achyrachaena","Asteraceae","Asterales",0,0,0,1,0,NA
"Achyranthes","Amaranthaceae","Caryophyllales",0,0,2,12,2,0
"Achyrocalyx","Acanthaceae","Lamiales",0,0,0,4,0,NA
"Achyrocline","Asteraceae","Asterales",0,0,0,45,0,NA
"Achyronia","Fabaceae","Fabales",0,0,0,136,0,NA
"Achyronychia","Caryophyllaceae","Caryophyllales",0,0,0,1,0,NA
"Achyropappus","Asteraceae","Asterales",0,0,0,1,0,NA
"Achyrophorus","Asteraceae","Asterales",0,0,0,4,0,NA
"Achyropsis","Amaranthaceae","Caryophyllales",0,0,1,6,1,0
"Achyrospermum","Lamiaceae","Lamiales",2,0,1,25,3,0.666666666666667
"Aciachne","Poaceae","Poales",0,0,0,3,0,NA
"Acianthera","Orchidaceae","Asparagales",0,0,4,221,4,0
"Acianthus","Orchidaceae","Asparagales",0,0,4,20,4,0
"Acicarpha","Calyceraceae","Asterales",0,0,1,5,1,0
"Acidanthera","Iridaceae","Asparagales",0,0,0,1,0,NA
"Acidocroton","Euphorbiaceae","Malpighiales",1,0,0,11,1,1
"Acidonia","Proteaceae","Proteales",1,0,0,1,1,1
"Acidosasa","Poaceae","Poales",0,0,0,11,0,NA
"Acidoton","Euphorbiaceae","Malpighiales",2,0,0,6,2,1
"Acilepidopsis","Asteraceae","Asterales",0,0,0,1,0,NA
"Acilepis","Asteraceae","Asterales",0,0,0,32,0,NA
"Acineta","Orchidaceae","Asparagales",0,0,2,17,2,0
"Acinodendron","Melastomataceae","Myrtales",2,0,0,491,2,1
"Acinos","Lamiaceae","Lamiales",1,0,0,1,1,1
"Acioa","Chrysobalanaceae","Malpighiales",2,0,0,4,2,1
"Aciotis","Melastomataceae","Myrtales",0,0,0,16,0,NA
"Aciphylla","Apiaceae","Apiales",0,0,1,45,1,0
"Acis","Amaryllidaceae","Asparagales",0,0,4,9,4,0
"Acisanthera","Melastomataceae","Myrtales",0,0,0,21,0,NA
"Acleisanthes","Nyctaginaceae","Caryophyllales",0,2,0,17,0,NA
"Acmadenia","Rutaceae","Sapindales",1,0,0,33,1,1
"Acmanthera","Malpighiaceae","Malpighiales",1,0,0,7,1,1
"Acmella","Asteraceae","Asterales",0,0,1,31,1,0
"Acmispon","Fabaceae","Fabales",0,0,1,33,1,0
"Acmopyle","Podocarpaceae","Araucariales",2,0,0,2,2,1
"Acnida","Amaranthaceae","Caryophyllales",0,0,0,1,0,NA
"Acnistus","Solanaceae","Solanales",0,0,0,1,0,NA
"Acoelorrhaphe","Arecaceae","Arecales",1,0,0,1,1,1
"Acokanthera","Apocynaceae","Gentianales",4,0,0,5,4,1
"Acome","Capparaceae","Brassicales",0,0,0,1,0,NA
"Acomis","Asteraceae","Asterales",0,0,0,4,0,NA
"Aconitum","Ranunculaceae","Ranunculales",0,0,8,337,8,0
"Aconogonum","Polygonaceae","Caryophyllales",0,0,0,3,0,NA
"Acorus","Acoraceae","Acorales",0,0,2,2,2,0
"Acosmium","Fabaceae","Fabales",4,0,0,18,4,1
"Acostia","Poaceae","Poales",0,0,0,1,0,NA
"Acourtia","Asteraceae","Asterales",0,0,0,84,0,NA
"Acrachne","Poaceae","Poales",0,0,0,3,0,NA
"Acradenia","Rutaceae","Sapindales",2,0,0,2,2,1
"Acranthera","Rubiaceae","Gentianales",0,0,0,38,0,NA
"Acridocarpus","Malpighiaceae","Malpighiales",6,0,0,43,6,1
"Acriopsis","Orchidaceae","Asparagales",0,0,0,9,0,NA
"Acrisione","Asteraceae","Asterales",1,0,0,1,1,1
"Acritochaete","Poaceae","Poales",0,0,0,1,0,NA
"Acritopappus","Asteraceae","Asterales",0,0,0,17,0,NA
"Acrobotrys","Rubiaceae","Gentianales",0,0,0,1,0,NA
"Acrocarpus","Fabaceae","Fabales",1,0,0,1,1,1
"Acroceras","Poaceae","Poales",0,0,2,24,2,0
"Acrochaene","Orchidaceae","Asparagales",0,0,0,1,0,NA
"Acrocomia","Arecaceae","Arecales",3,0,0,8,3,1
"Acrodon","Aizoaceae","Caryophyllales",0,0,0,8,0,NA
"Acroglochin","Amaranthaceae","Caryophyllales",0,0,0,2,0,NA
"Acrolophia","Orchidaceae","Asparagales",0,0,0,7,0,NA
"Acronema","Apiaceae","Apiales",0,0,0,38,0,NA
"Acronychia","Rutaceae","Sapindales",15,0,0,51,15,1
"Acropelta","Dryopteridaceae","Polypodiales",0,0,0,1,0,NA
"Acrophorus","Dryopteridaceae","Polypodiales",0,0,0,7,0,NA
"Acrophyllum","Cunoniaceae","Oxalidales",2,0,0,2,2,1
"Acropogon","Malvaceae","Malvales",1,0,0,24,1,1
"Acropteris","Pteridaceae","Polypodiales",0,0,0,1,0,NA
"Acrorchis","Orchidaceae","Asparagales",0,0,1,1,1,0
"Acrorumohra","Dryopteridaceae","Polypodiales",0,0,0,6,0,NA
"Acrosanthes","Aizoaceae","Caryophyllales",1,0,0,6,1,1
"Acrosorus","Polypodiaceae","Polypodiales",0,0,0,1,0,NA
"Acrostemon","Ericaceae","Ericales",0,0,0,11,0,NA
"Acrostichum","Pteridaceae","Polypodiales",0,0,15,20,15,0
"Acrosynanthus","Rubiaceae","Gentianales",0,0,0,7,0,NA
"Acrotome","Lamiaceae","Lamiales",0,0,0,8,0,NA
"Acrotrema","Dilleniaceae","Dilleniales",0,0,0,10,0,NA
"Acrotriche","Ericaceae","Ericales",3,0,0,18,3,1
"Acrymia","Lamiaceae","Lamiales",0,0,0,1,0,NA
"Acsmithia","Cunoniaceae","Oxalidales",3,0,0,16,3,1
"Actaea","Ranunculaceae","Ranunculales",0,0,6,30,6,0
"Actephila","Phyllanthaceae","Malpighiales",3,0,0,30,3,1
"Actinanthella","Loranthaceae","Santalales",0,0,0,2,0,NA
"Actinanthus","Apiaceae","Apiales",0,0,0,1,0,NA
"Actinea","Asteraceae","Asterales",0,0,0,1,0,NA
"Actinella","Asteraceae","Asterales",0,0,0,2,0,NA
"Actinidia","Actinidiaceae","Ericales",30,0,0,75,30,1
"Actiniopteris","Pteridaceae","Polypodiales",0,0,2,5,2,0
"Actinobole","Asteraceae","Asterales",0,0,1,4,1,0
"Actinocarya","Boraginaceae","UnknownOrder-Boraginaceae",0,0,0,2,0,NA
"Actinocephalus","Eriocaulaceae","Poales",0,0,0,32,0,NA
"Actinocheita","Anacardiaceae","Sapindales",1,0,0,1,1,1
"Actinocladum","Poaceae","Poales",0,0,0,1,0,NA
"Actinodaphne","Lauraceae","Laurales",18,0,0,137,18,1
"Actinodium","Myrtaceae","Myrtales",1,0,0,1,1,1
"Actinokentia","Arecaceae","Arecales",1,0,0,2,1,1
"Actinolema","Apiaceae","Apiales",0,0,0,2,0,NA
"Actinorhytis","Arecaceae","Arecales",1,0,0,1,1,1
"Actinoschoenus","Cyperaceae","Poales",0,0,0,3,0,NA
"Actinoscirpus","Cyperaceae","Poales",0,0,1,1,1,0
"Actinoseris","Asteraceae","Asterales",0,0,0,1,0,NA
"Actinospermum","Asteraceae","Asterales",0,0,0,1,0,NA
"Actinostachys","Schizaeaceae","Schizaeales",0,0,0,6,0,NA
"Actinostemma","Cucurbitaceae","Cucurbitales",0,0,1,3,1,0
"Actinostemon","Euphorbiaceae","Malpighiales",4,0,0,20,4,1
"Actinostrobus","Cupressaceae","Cupressales",1,0,0,3,1,1
"Actinotus","Apiaceae","Apiales",0,0,2,19,2,0
"Acuania","Fabaceae","Fabales",0,0,0,1,0,NA
"Acunaeanthus","Rubiaceae","Gentianales",0,0,0,1,0,NA
"Acystopteris","Cystopteridaceae","Polypodiales",0,0,0,3,0,NA
"Ada","Orchidaceae","Asparagales",0,0,0,1,0,NA
"Adamantinia","Orchidaceae","Asparagales",0,0,0,1,0,NA
"Adamea","Melastomataceae","Myrtales",0,0,0,1,0,NA
"Adansonia","Malvaceae","Malvales",3,0,0,8,3,1
"Adectum","Dennstaedtiaceae","Polypodiales",0,0,0,1,0,NA
"Adelanthus","Icacinaceae","UnknownOrder-Icacinaceae",0,0,0,18,0,NA
"Adelia","Euphorbiaceae","Malpighiales",9,0,0,10,9,1
"Adelobotrys","Melastomataceae","Myrtales",3,0,0,28,3,1
"Adelocaryum","Boraginaceae","UnknownOrder-Boraginaceae",0,0,0,4,0,NA
"Adelostemma","Apocynaceae","Gentianales",0,0,0,1,0,NA
"Adelostigma","Asteraceae","Asterales",0,0,0,2,0,NA
"Adelphia","Malpighiaceae","Malpighiales",0,0,0,4,0,NA
"Adenandra","Rutaceae","Sapindales",16,0,0,19,16,1
"Adenanthellum","Asteraceae","Asterales",0,0,0,1,0,NA
"Adenanthera","Fabaceae","Fabales",5,0,0,13,5,1
"Adenanthos","Proteaceae","Proteales",31,0,0,36,31,1
"Adenarake","Ochnaceae","Malpighiales",0,0,0,2,0,NA
"Adenaria","Lythraceae","Myrtales",1,0,0,1,1,1
"Adenia","Passifloraceae","Malpighiales",0,0,2,103,2,0
"Adenium","Apocynaceae","Gentianales",1,0,0,5,1,1
"Adenoa","Passifloraceae","Malpighiales",0,0,0,1,0,NA
"Adenocalymma","Bignoniaceae","Lamiales",10,1,0,82,10,1
"Adenocarpus","Fabaceae","Fabales",4,0,0,16,4,1
"Adenocaulon","Asteraceae","Asterales",0,0,1,5,1,0
"Adenochilus","Orchidaceae","Asparagales",0,0,1,2,1,0
"Adenochlaena","Euphorbiaceae","Malpighiales",1,0,0,2,1,1
"Adenocline","Euphorbiaceae","Malpighiales",1,1,0,3,1,1
"Adenocritonia","Asteraceae","Asterales",0,0,0,3,0,NA
"Adenoderris","Dryopteridaceae","Polypodiales",0,0,0,3,0,NA
"Adenodolichos","Fabaceae","Fabales",0,0,1,22,1,0
"Adenoglossa","Asteraceae","Asterales",0,0,0,1,0,NA
"Adenogramma","Molluginaceae","Caryophyllales",1,0,1,11,2,0.5
"Adenolisianthus","Gentianaceae","Gentianales",0,0,0,1,0,NA
"Adenolobus","Fabaceae","Fabales",0,0,0,2,0,NA
"Adenoncos","Orchidaceae","Asparagales",0,0,1,17,1,0
"Adenoon","Asteraceae","Asterales",0,0,0,1,0,NA
"Adenopappus","Asteraceae","Asterales",0,0,0,1,0,NA
"Adenopeltis","Euphorbiaceae","Malpighiales",1,0,0,1,1,1
"Adenophaedra","Euphorbiaceae","Malpighiales",1,0,0,3,1,1
"Adenophora","Campanulaceae","Asterales",0,0,7,62,7,0
"Adenophorus","Polypodiaceae","Polypodiales",0,0,0,8,0,NA
"Adenophyllum","Asteraceae","Asterales",0,0,0,10,0,NA
"Adenopodia","Fabaceae","Fabales",0,0,0,7,0,NA
"Adenorandia","Rubiaceae","Gentianales",0,0,0,1,0,NA
"Adenosciadium","Apiaceae","Apiales",0,0,0,1,0,NA
"Adenosma","Plantaginaceae","Lamiales",0,0,0,26,0,NA
"Adenostemma","Asteraceae","Asterales",0,0,0,27,0,NA
"Adenostoma","Rosaceae","Rosales",2,0,0,2,2,1
"Adenostyles","Asteraceae","Asterales",0,0,2,10,2,0
"Adenothamnus","Asteraceae","Asterales",0,0,0,1,0,NA
"Adesmia","Fabaceae","Fabales",3,0,2,226,5,0.6
"Adhatoda","Acanthaceae","Lamiales",0,0,0,1,0,NA
"Adiantopsis","Pteridaceae","Polypodiales",0,0,0,17,0,NA
"Adiantum","Pteridaceae","Polypodiales",0,0,15,171,15,0
"Adina","Rubiaceae","Gentianales",2,0,0,4,2,1
"Adinandra","Pentaphylacaceae","Ericales",21,0,0,106,21,1
"Adinauclea","Rubiaceae","Gentianales",1,0,0,1,1,1
"Adiscanthus","Rutaceae","Sapindales",1,0,0,1,1,1
"Adlumia","Papaveraceae","Ranunculales",0,0,0,2,0,NA
"Adolphia","Rhamnaceae","Rosales",2,0,0,2,2,1
"Adonidia","Arecaceae","Arecales",1,0,0,1,1,1
"Adonis","Ranunculaceae","Ranunculales",0,0,5,32,5,0
"Adopogon","Asteraceae","Asterales",0,0,0,1,0,NA
"Adoxa","Adoxaceae","Dipsacales",0,0,1,2,1,0
"Adriana","Euphorbiaceae","Malpighiales",1,0,0,2,1,1
"Adromischus","Crassulaceae","Saxifragales",0,0,0,29,0,NA
"Adrorhizon","Orchidaceae","Asparagales",0,0,0,1,0,NA
"Aechmea","Bromeliaceae","Poales",0,0,29,283,29,0
"Aedesia","Asteraceae","Asterales",0,0,0,3,0,NA
"Aegialitis","Plumbaginaceae","Caryophyllales",1,0,0,2,1,1
"Aegiceras","Primulaceae","Ericales",2,0,0,2,2,1
"Aegilops","Poaceae","Poales",0,0,17,25,17,0
"Aegilotriticum","Poaceae","Poales",0,0,0,8,0,NA
"Aeginetia","Orobanchaceae","Lamiales",0,0,0,6,0,NA
"Aegiphila","Lamiaceae","Lamiales",14,0,0,150,14,1
"Aegle","Rutaceae","Sapindales",1,0,0,2,1,1
"Aeglopsis","Rutaceae","Sapindales",0,0,0,5,0,NA
"Aegokeras","Apiaceae","Apiales",0,0,0,1,0,NA
"Aegonychon","Boraginaceae","UnknownOrder-Boraginaceae",0,0,0,1,0,NA
"Aegopodium","Apiaceae","Apiales",0,0,1,8,1,0
"Aegopogon","Poaceae","Poales",0,0,1,4,1,0
"Aeluropus","Poaceae","Poales",0,0,1,5,1,0
"Aenhenrya","Orchidaceae","Asparagales",0,0,0,1,0,NA
"Aenictophyton","Fabaceae","Fabales",0,0,0,1,0,NA
"Aenigmatanthera","Malpighiaceae","Malpighiales",0,0,0,2,0,NA
"Aenigmopteris","Tectariaceae","Polypodiales",0,0,0,2,0,NA
"Aeolanthus","Lamiaceae","Lamiales",0,0,0,1,0,NA
"Aeollanthus","Lamiaceae","Lamiales",0,0,7,44,7,0
"Aeonium","Crassulaceae","Saxifragales",0,0,0,89,0,NA
"Aequatorium","Asteraceae","Asterales",0,0,0,23,0,NA
"Aerangis","Orchidaceae","Asparagales",0,0,17,53,17,0
"Aeranthes","Orchidaceae","Asparagales",0,0,3,45,3,0
"Aerides","Orchidaceae","Asparagales",0,0,2,31,2,0
"Aerva","Amaranthaceae","Caryophyllales",0,0,1,20,1,0
"Aeschynanthus","Gesneriaceae","Lamiales",0,0,2,194,2,0
"Aeschynomene","Fabaceae","Fabales",0,0,2,170,2,0
"Aesculus","Sapindaceae","Sapindales",12,0,0,23,12,1
"Aetanthus","Loranthaceae","Santalales",0,0,0,16,0,NA
"Aetheolaena","Asteraceae","Asterales",0,0,0,18,0,NA
"Aetheolirion","Commelinaceae","Commelinales",0,0,0,1,0,NA
"Aetheorhiza","Asteraceae","Asterales",0,0,1,1,1,0
"Aetheorhyncha","Orchidaceae","Asparagales",0,0,1,1,1,0
"Aethephyllum","Aizoaceae","Caryophyllales",0,0,0,1,0,NA
"Aethionema","Brassicaceae","Brassicales",0,0,2,56,2,0
"Aethusa","Apiaceae","Apiales",0,0,1,1,1,0
"Aetoxylon","Thymelaeaceae","Malvales",1,0,0,1,1,1
"Aextoxicon","Aextoxicaceae","Berberidopsidales",1,0,0,1,1,1
"Affonsea","Fabaceae","Fabales",0,0,0,14,0,NA
"Afgekia","Fabaceae","Fabales",1,0,0,3,1,1
"Afraegle","Rutaceae","Sapindales",0,0,0,1,0,NA
"Aframmi","Apiaceae","Apiales",0,0,0,2,0,NA
"Aframomum","Zingiberaceae","Zingiberales",0,0,4,55,4,0
"Afraurantium","Rutaceae","Sapindales",0,0,0,1,0,NA
"Afrobrunnichia","Polygonaceae","Caryophyllales",0,0,0,2,0,NA
"Afrocalathea","Marantaceae","Zingiberales",0,0,1,1,1,0
"Afrocanthium","Rubiaceae","Gentianales",5,0,0,17,5,1
"Afrocarpus","Podocarpaceae","Araucariales",3,0,0,5,3,1
"Afrofittonia","Acanthaceae","Lamiales",0,0,0,1,0,NA
"Afroguatteria","Annonaceae","Magnoliales",0,0,0,2,0,NA
"Afrolicania","Chrysobalanaceae","Malpighiales",1,0,0,1,1,1
"Afroligusticum","Apiaceae","Apiales",0,0,0,13,0,NA
"Afrolimon","Plumbaginaceae","Caryophyllales",0,0,0,1,0,NA
"Afropteris","Pteridaceae","Polypodiales",0,0,2,2,2,0
"Afrosciadium","Apiaceae","Apiales",0,0,0,18,0,NA
"Afrosison","Apiaceae","Apiales",0,0,0,3,0,NA
"Afrostyrax","Huaceae","Oxalidales",2,0,0,3,2,1
"Afrothismia","Burmanniaceae","Dioscoreales",0,0,0,12,0,NA
"Afrotrewia","Euphorbiaceae","Malpighiales",1,0,0,1,1,1
"Afrotrichloris","Poaceae","Poales",0,0,0,2,0,NA
"Afrotrilepis","Cyperaceae","Poales",0,0,0,2,0,NA
"Afrotysonia","Boraginaceae","UnknownOrder-Boraginaceae",0,0,0,3,0,NA
"Afrovivella","Crassulaceae","Saxifragales",0,0,0,1,0,NA
"Afzelia","Fabaceae","Fabales",9,0,0,12,9,1
"Agalinis","Orobanchaceae","Lamiales",0,1,14,65,14,0
"Agalmyla","Gesneriaceae","Lamiales",0,0,1,96,1,0
"Aganisia","Orchidaceae","Asparagales",0,0,3,4,3,0
"Aganonerion","Apocynaceae","Gentianales",0,0,0,1,0,NA
"Aganope","Fabaceae","Fabales",0,0,0,11,0,NA
"Aganosma","Apocynaceae","Gentianales",0,3,0,8,0,NA
"Agapanthus","Amaryllidaceae","Asparagales",0,0,4,9,4,0
"Agapetes","Ericaceae","Ericales",2,0,0,147,2,1
"Agarista","Ericaceae","Ericales",9,0,0,31,9,1
"Agastache","Lamiaceae","Lamiales",0,0,7,22,7,0
"Agastachys","Proteaceae","Proteales",1,0,0,1,1,1
"Agasthiyamalaia","Clusiaceae","Malpighiales",0,0,0,1,0,NA
"Agasyllis","Apiaceae","Apiales",0,0,0,1,0,NA
"Agatea","Violaceae","Malpighiales",0,0,0,8,0,NA
"Agathelpis","Scrophulariaceae","Lamiales",0,0,1,6,1,0
"Agathis","Araucariaceae","Araucariales",13,0,0,18,13,1
"Agathisanthemum","Rubiaceae","Gentianales",0,1,0,4,0,NA
"Agathophora","Amaranthaceae","Caryophyllales",0,0,0,1,0,NA
"Agathosma","Rutaceae","Sapindales",2,0,0,145,2,1
"Agauria","Ericaceae","Ericales",0,0,0,3,0,NA
"Agave","Asparagaceae","Asparagales",2,0,26,200,28,0.0714285714285714
"Agdestis","Phytolaccaceae","Caryophyllales",0,0,1,1,1,0
"Agelaea","Connaraceae","Oxalidales",4,0,0,15,4,1
"Agelanthus","Loranthaceae","Santalales",3,0,0,61,3,1
"Agenium","Poaceae","Poales",0,0,0,3,0,NA
"Ageratella","Asteraceae","Asterales",0,0,0,2,0,NA
"Ageratina","Asteraceae","Asterales",3,0,0,334,3,1
"Ageratinastrum","Asteraceae","Asterales",0,0,0,5,0,NA
"Ageratum","Asteraceae","Asterales",0,0,2,51,2,0
"Agianthus","Brassicaceae","Brassicales",0,0,0,1,0,NA
"Aglaia","Meliaceae","Sapindales",42,0,0,114,42,1
"Aglaodorum","Araceae","Alismatales",0,0,0,1,0,NA
"Aglaomorpha","Polypodiaceae","Polypodiales",0,0,0,9,0,NA
"Aglaonema","Araceae","Alismatales",0,0,1,22,1,0
"Aglossorrhyncha","Orchidaceae","Asparagales",0,0,0,13,0,NA
"Agnesia","Poaceae","Poales",0,0,0,1,0,NA
"Agnorhiza","Asteraceae","Asterales",0,0,0,5,0,NA
"Agonandra","Opiliaceae","Santalales",6,0,0,10,6,1
"Agonis","Myrtaceae","Myrtales",3,0,0,5,3,1
"Agoseris","Asteraceae","Asterales",0,0,2,15,2,0
"Agouticarpa","Rubiaceae","Gentianales",0,0,0,7,0,NA
"Agrianthus","Asteraceae","Asterales",0,0,0,9,0,NA
"Agrimonia","Rosaceae","Rosales",0,0,4,18,4,0
"Agriophyllum","Amaranthaceae","Caryophyllales",0,0,1,6,1,0
"Agrocharis","Apiaceae","Apiales",0,0,0,3,0,NA
"Agroelymus","Poaceae","Poales",0,0,0,10,0,NA
"Agrohordeum","Poaceae","Poales",0,0,0,1,0,NA
"Agropogon","Poaceae","Poales",0,0,0,1,0,NA
"Agropyron","Poaceae","Poales",0,0,6,26,6,0
"Agropyropsis","Poaceae","Poales",0,0,0,1,0,NA
"Agrositanion","Poaceae","Poales",0,0,0,1,0,NA
"Agrostemma","Caryophyllaceae","Caryophyllales",0,0,1,2,1,0
"Agrostis","Poaceae","Poales",0,0,36,228,36,0
"Agrostistachys","Euphorbiaceae","Malpighiales",2,0,0,6,2,1
"Agrostocrinum","Xanthorrhoeaceae","Asparagales",0,0,1,2,1,0
"Agrostophyllum","Orchidaceae","Asparagales",0,0,2,102,2,0
"Agrostopoa","Poaceae","Poales",0,0,0,3,0,NA
"Agrotrigia","Poaceae","Poales",0,0,0,6,0,NA
"Aguiaria","Malvaceae","Malvales",0,0,0,1,0,NA
"Ahernia","Salicaceae","Malpighiales",1,0,0,1,1,1
"Aichryson","Crassulaceae","Saxifragales",0,0,0,18,0,NA
"Aidia","Rubiaceae","Gentianales",6,0,0,55,6,1
"Aidiopsis","Rubiaceae","Gentianales",0,0,0,1,0,NA
"Ailanthus","Simaroubaceae","Sapindales",5,0,0,7,5,1
"Ainsliaea","Asteraceae","Asterales",0,0,2,68,2,0
"Ainsworthia","Apiaceae","Apiales",0,0,0,2,0,NA
"Aiouea","Lauraceae","Laurales",5,0,0,26,5,1
"Aiphanes","Arecaceae","Arecales",19,0,0,28,19,1
"Aira","Poaceae","Poales",0,0,4,9,4,0
"Airampoa","Cactaceae","Caryophyllales",0,0,0,1,0,NA
"Airopsis","Poaceae","Poales",0,0,0,1,0,NA
"Airosperma","Rubiaceae","Gentianales",0,0,0,6,0,NA
"Airyantha","Fabaceae","Fabales",0,0,0,2,0,NA
"Aistopetalum","Cunoniaceae","Oxalidales",1,0,0,2,1,1
"Aizoanthemum","Aizoaceae","Caryophyllales",0,0,0,7,0,NA
"Aizoon","Aizoaceae","Caryophyllales",0,0,0,15,0,NA
"Ajania","Asteraceae","Asterales",2,0,1,36,3,0.666666666666667
"Ajaniopsis","Asteraceae","Asterales",0,0,0,1,0,NA
"Ajuga","Lamiaceae","Lamiales",0,0,9,71,9,0
"Ajugoides","Lamiaceae","Lamiales",0,0,0,1,0,NA
"Akania","Akaniaceae","Brassicales",1,0,0,1,1,1
"Akeassia","Asteraceae","Asterales",0,0,0,1,0,NA
"Akebia","Lardizabalaceae","Ranunculales",1,0,0,5,1,1
"Akrosida","Malvaceae","Malvales",0,0,0,2,0,NA
"Akschindlium","Fabaceae","Fabales",0,0,0,1,0,NA
"Alafia","Apocynaceae","Gentianales",0,2,0,26,0,NA
"Alamania","Orchidaceae","Asparagales",0,0,1,1,1,0
"Alangium","Cornaceae","Cornales",16,0,0,27,16,1
"Alania","Boryaceae","Asparagales",0,1,0,1,0,NA
"Alansmia","Polypodiaceae","Polypodiales",0,0,0,26,0,NA
"Alantsilodendron","Fabaceae","Fabales",3,0,0,9,3,1
"Alatiliparis","Orchidaceae","Asparagales",0,0,0,5,0,NA
"Alatoseta","Asteraceae","Asterales",0,0,0,1,0,NA
"Alberta","Rubiaceae","Gentianales",1,0,0,1,1,1
"Albertinia","Asteraceae","Asterales",0,0,0,1,0,NA
"Albertisia","Menispermaceae","Ranunculales",2,0,0,20,2,1
"Albidella","Alismataceae","Alismatales",0,0,0,1,0,NA
"Albizia","Fabaceae","Fabales",42,0,0,137,42,1
"Alboviodoxa","Asteraceae","Asterales",0,0,0,1,0,NA
"Albraunia","Plantaginaceae","Lamiales",0,0,0,3,0,NA
"Albuca","Asparagaceae","Asparagales",0,0,17,157,17,0
"Alcantarea","Bromeliaceae","Poales",0,0,0,1,0,NA
"Alcea","Malvaceae","Malvales",0,0,0,77,0,NA
"Alchemilla","Rosaceae","Rosales",1,2,7,598,8,0.125
"Alchornea","Euphorbiaceae","Malpighiales",14,0,0,52,14,1
"Alchorneopsis","Euphorbiaceae","Malpighiales",2,0,0,2,2,1
"Alcicornium","Polypodiaceae","Polypodiales",0,0,0,2,0,NA
"Aldama","Asteraceae","Asterales",0,0,0,2,0,NA
"Aldina","Fabaceae","Fabales",4,0,0,16,4,1
"Aldrovanda","Droseraceae","Caryophyllales",0,0,1,1,1,0
"Alectra","Orobanchaceae","Lamiales",0,0,2,34,2,0
"Alectryon","Sapindaceae","Sapindales",12,0,0,40,12,1
"Aleisanthia","Rubiaceae","Gentianales",0,0,0,2,0,NA
"Aleisanthiopsis","Rubiaceae","Gentianales",0,0,0,2,0,NA
"Alepidea","Apiaceae","Apiales",0,0,0,37,0,NA
"Alepidocline","Asteraceae","Asterales",0,0,1,4,1,0
"Alepis","Loranthaceae","Santalales",1,0,0,1,1,1
"Aletes","Apiaceae","Apiales",0,0,0,1,0,NA
"Aletris","Nartheciaceae","Dioscoreales",0,0,8,25,8,0
"Aleurites","Euphorbiaceae","Malpighiales",0,0,0,2,0,NA
"Aleuritopteris","Pteridaceae","Polypodiales",0,0,0,34,0,NA
"Alexa","Fabaceae","Fabales",3,0,0,11,3,1
"Alexfloydia","Poaceae","Poales",0,0,0,1,0,NA
"Alexgeorgea","Restionaceae","Poales",0,0,1,3,1,0
"Alfaroa","Juglandaceae","Fagales",4,0,0,8,4,1
"Alfredia","Asteraceae","Asterales",0,0,1,8,1,0
"Algernonia","Euphorbiaceae","Malpighiales",0,0,0,12,0,NA
"Algrizea","Myrtaceae","Myrtales",0,0,0,2,0,NA
"Alhagi","Fabaceae","Fabales",1,0,1,8,2,0.5
"Alibertia","Rubiaceae","Gentianales",2,0,0,26,2,1
"Alicia","Malpighiaceae","Malpighiales",0,0,0,2,0,NA
"Aliciella","Polemoniaceae","Ericales",0,0,0,21,0,NA
"Aliella","Asteraceae","Asterales",0,0,0,3,0,NA
"Alinula","Cyperaceae","Poales",0,0,1,4,1,0
"Aliopsis","Gentianaceae","Gentianales",0,0,0,1,0,NA
"Alisma","Alismataceae","Alismatales",0,0,6,11,6,0
"Alismorchis","Orchidaceae","Asparagales",0,0,0,2,0,NA
"Alistilus","Fabaceae","Fabales",0,0,0,3,0,NA
"Alkanna","Boraginaceae","UnknownOrder-Boraginaceae",0,0,1,64,1,0
"Allagopappus","Asteraceae","Asterales",0,0,0,2,0,NA
"Allagoptera","Arecaceae","Arecales",3,0,0,5,3,1
"Allamanda","Apocynaceae","Gentianales",2,0,0,15,2,1
"Allanblackia","Clusiaceae","Malpighiales",4,0,0,9,4,1
"Allantodia","Athyriaceae","Polypodiales",0,0,0,98,0,NA
"Allantoma","Lecythidaceae","Ericales",4,0,0,8,4,1
"Allantospermum","Ixonanthaceae","Malpighiales",0,0,0,2,0,NA
"Allardia","Asteraceae","Asterales",0,0,0,2,0,NA
"Alleizettella","Rubiaceae","Gentianales",0,0,0,2,0,NA
"Allenrolfea","Amaranthaceae","Caryophyllales",3,0,0,3,3,1
"Allexis","Violaceae","Malpighiales",0,0,0,4,0,NA
"Alliaria","Brassicaceae","Brassicales",0,0,1,3,1,0
"Allionia","Nyctaginaceae","Caryophyllales",0,0,1,3,1,0
"Allittia","Asteraceae","Asterales",0,0,0,2,0,NA
"Allium","Amaryllidaceae","Asparagales",0,0,137,918,137,0
"Allmania","Amaranthaceae","Caryophyllales",0,0,0,1,0,NA
"Allmaniopsis","Amaranthaceae","Caryophyllales",0,0,0,1,0,NA
"Allocassine","Celastraceae","Celastrales",1,0,0,1,1,1
"Allocasuarina","Casuarinaceae","Fagales",58,0,0,61,58,1
"Allocheilos","Gesneriaceae","Lamiales",0,0,0,3,0,NA
"Allochrusa","Caryophyllaceae","Caryophyllales",0,0,0,8,0,NA
"Alloeochaete","Poaceae","Poales",0,0,0,6,0,NA
"Alloispermum","Asteraceae","Asterales",0,0,1,16,1,0
"Allolepis","Poaceae","Poales",0,0,0,1,0,NA
"Allomaieta","Melastomataceae","Myrtales",0,0,0,7,0,NA
"Allomarkgrafia","Apocynaceae","Gentianales",1,1,0,9,1,1
"Allomorphia","Melastomataceae","Myrtales",0,0,0,6,0,NA
"Alloneuron","Melastomataceae","Myrtales",0,0,0,4,0,NA
"Allophyllum","Polemoniaceae","Ericales",0,0,0,5,0,NA
"Allophylus","Sapindaceae","Sapindales",33,0,0,212,33,1
"Alloplectus","Gesneriaceae","Lamiales",0,0,0,6,0,NA
"Allopterigeron","Asteraceae","Asterales",0,0,0,1,0,NA
"Allosanthus","Sapindaceae","Sapindales",1,0,0,1,1,1
"Alloschemone","Araceae","Alismatales",0,0,0,2,0,NA
"Allosidastrum","Malvaceae","Malvales",0,0,0,4,0,NA
"Allosorus","Pteridaceae","Polypodiales",0,0,0,4,0,NA
"Allostelites","Equisetaceae","Equisetales",0,0,0,1,0,NA
"Allostigma","Gesneriaceae","Lamiales",0,0,0,1,0,NA
"Allosyncarpia","Myrtaceae","Myrtales",0,0,0,1,0,NA
"Alloteropsis","Poaceae","Poales",0,0,2,5,2,0
"Allotropa","Ericaceae","Ericales",0,0,0,1,0,NA
"Allowissadula","Malvaceae","Malvales",0,0,0,10,0,NA
"Allowoodsonia","Apocynaceae","Gentianales",0,0,0,1,0,NA
"Alloxylon","Proteaceae","Proteales",4,0,0,4,4,1
"Alluaudia","Didiereaceae","Caryophyllales",4,0,0,6,4,1
"Alluaudiopsis","Didiereaceae","Caryophyllales",0,0,0,2,0,NA
"Almaleea","Fabaceae","Fabales",0,0,0,5,0,NA
"Almeidea","Rutaceae","Sapindales",0,0,0,5,0,NA
"Almutaster","Asteraceae","Asterales",0,0,0,1,0,NA
"Alniphyllum","Styracaceae","Ericales",2,0,0,3,2,1
"Alnus","Betulaceae","Fagales",26,0,0,44,26,1
"Alocasia","Araceae","Alismatales",0,0,3,80,3,0
"Alococarpum","Apiaceae","Apiales",0,0,0,1,0,NA
"Aloe","Xanthorrhoeaceae","Asparagales",28,1,46,558,74,0.378378378378378
"Aloinopsis","Aizoaceae","Caryophyllales",0,0,0,15,0,NA
"Alomia","Asteraceae","Asterales",0,0,0,5,0,NA
"Alomiella","Asteraceae","Asterales",0,0,0,2,0,NA
"Alonsoa","Scrophulariaceae","Lamiales",0,0,2,14,2,0
"Alopecurus","Poaceae","Poales",0,0,11,47,11,0
"Alophia","Iridaceae","Asparagales",0,0,5,5,5,0
"Aloysia","Verbenaceae","Lamiales",2,0,0,44,2,1
"Alphandia","Euphorbiaceae","Malpighiales",2,0,0,3,2,1
"Alphitonia","Rhamnaceae","Rosales",9,0,0,19,9,1
"Alphonsea","Annonaceae","Magnoliales",9,0,0,38,9,1
"Alpinia","Zingiberaceae","Zingiberales",0,0,18,244,18,0
"Alrawia","Asparagaceae","Asparagales",0,0,0,2,0,NA
"Alseis","Rubiaceae","Gentianales",6,0,0,18,6,1
"Alseodaphne","Lauraceae","Laurales",11,0,0,57,11,1
"Alseuosmia","Alseuosmiaceae","Asterales",1,0,0,5,1,1
"Alsinidendron","Caryophyllaceae","Caryophyllales",0,0,0,5,0,NA
"Alsodeiopsis","Icacinaceae","UnknownOrder-Icacinaceae",3,0,0,8,3,1
"Alsomitra","Cucurbitaceae","Cucurbitales",0,0,1,1,1,0
"Alsophila","Cyatheaceae","Cyatheales",0,0,0,71,0,NA
"Alstonia","Apocynaceae","Gentianales",17,0,0,43,17,1
"Alstroemeria","Alstroemeriaceae","Liliales",0,0,31,128,31,0
"Altamiranoa","Crassulaceae","Saxifragales",0,0,0,1,0,NA
"Altensteinia","Orchidaceae","Asparagales",0,0,0,7,0,NA
"Alternanthera","Amaranthaceae","Caryophyllales",0,0,5,137,5,0
"Althaea","Malvaceae","Malvales",0,0,1,17,1,0
"Althenia","Potamogetonaceae","Alismatales",0,0,0,2,0,NA
"Altingia","Altingiaceae","Saxifragales",6,0,0,11,6,1
"Altoparadisium","Poaceae","Poales",0,0,1,2,1,0
"Aluta","Myrtaceae","Myrtales",2,0,0,5,2,1
"Alvaradoa","Picramniaceae","Picramniales",1,0,0,6,1,1
"Alvesia","Lamiaceae","Lamiales",0,0,0,3,0,NA
"Alvimia","Poaceae","Poales",1,0,0,3,1,1
"Alvimiantha","Rhamnaceae","Rosales",0,0,0,1,0,NA
"Alvordia","Asteraceae","Asterales",0,0,0,4,0,NA
"Alyogyne","Malvaceae","Malvales",4,0,0,5,4,1
"Alysicarpus","Fabaceae","Fabales",0,0,0,34,0,NA
"Alyssoides","Brassicaceae","Brassicales",0,0,0,2,0,NA
"Alyssopsis","Brassicaceae","Brassicales",0,0,0,2,0,NA
"Alyssum","Brassicaceae","Brassicales",0,0,4,207,4,0
"Alyxia","Apocynaceae","Gentianales",4,0,0,105,4,1
"Alzatea","Penaeaceae","Myrtales",1,0,0,1,1,1
"Amaioua","Rubiaceae","Gentianales",2,0,0,9,2,1
"Amalia","Orchidaceae","Asparagales",0,0,0,1,0,NA
"Amalocalyx","Apocynaceae","Gentianales",0,1,0,1,0,NA
"Amalophyllon","Gesneriaceae","Lamiales",0,0,2,13,2,0
"Amana","Liliaceae","Liliales",0,0,2,3,2,0
"Amanoa","Phyllanthaceae","Malpighiales",9,0,0,16,9,1
"Amaracarpus","Rubiaceae","Gentianales",0,0,0,30,0,NA
"Amaranthus","Amaranthaceae","Caryophyllales",0,0,18,105,18,0
"Amaroria","Simaroubaceae","Sapindales",1,0,0,1,1,1
"Amaryllis","Amaryllidaceae","Asparagales",0,0,2,4,2,0
"Amasonia","Lamiaceae","Lamiales",0,0,0,5,0,NA
"Amauria","Asteraceae","Asterales",0,0,0,3,0,NA
"Amauriopsis","Asteraceae","Asterales",0,0,0,1,0,NA
"Amauropelta","Thelypteridaceae","Polypodiales",0,0,0,12,0,NA
"Ambassa","Asteraceae","Asterales",0,0,0,1,0,NA
"Ambavia","Annonaceae","Magnoliales",1,0,0,2,1,1
"Ambelania","Apocynaceae","Gentianales",1,0,0,3,1,1
"Amberboa","Asteraceae","Asterales",0,0,0,9,0,NA
"Ambilobea","Burseraceae","Sapindales",0,0,0,1,0,NA
"Amblovenatum","Thelypteridaceae","Polypodiales",0,0,0,1,0,NA
"Amblyanthopsis","Primulaceae","Ericales",0,0,0,4,0,NA
"Amblyanthus","Primulaceae","Ericales",0,0,0,4,0,NA
"Amblygonocarpus","Fabaceae","Fabales",1,0,0,1,1,1
"Amblynotus","Boraginaceae","UnknownOrder-Boraginaceae",0,0,0,1,0,NA
"Amblyocarpum","Asteraceae","Asterales",0,0,1,1,1,0
"Amblyolepis","Asteraceae","Asterales",0,0,0,1,0,NA
"Amblyopappus","Asteraceae","Asterales",0,0,1,1,1,0
"Amblysperma","Asteraceae","Asterales",0,0,0,1,0,NA
"Amblytropis","Fabaceae","Fabales",0,0,0,4,0,NA
"Ambongia","Acanthaceae","Lamiales",0,0,0,1,0,NA
"Amborella","Amborellaceae","Amborellales",1,0,0,1,1,1
"Amboroa","Asteraceae","Asterales",0,0,0,2,0,NA
"Ambrella","Orchidaceae","Asparagales",0,0,0,1,0,NA
"Ambrosia","Asteraceae","Asterales",6,0,4,51,10,0.6
"Ambrosina","Araceae","Alismatales",0,0,0,1,0,NA
"Amburana","Fabaceae","Fabales",1,0,0,2,1,1
"Ameghinoa","Asteraceae","Asterales",0,0,0,1,0,NA
"Amelanchier","Rosaceae","Rosales",14,0,0,28,14,1
"Amelasorbus","Rosaceae","Rosales",0,0,0,1,0,NA
"Amellus","Asteraceae","Asterales",0,0,0,12,0,NA
"Amentotaxus","Taxaceae","Cupressales",2,0,0,6,2,1
"Amerimnon","Fabaceae","Fabales",0,0,0,33,0,NA
"Ameroglossum","Scrophulariaceae","Lamiales",0,0,0,1,0,NA
"Amerosedum","Crassulaceae","Saxifragales",0,0,0,1,0,NA
"Amesia","Orchidaceae","Asparagales",0,0,0,1,0,NA
"Amesiella","Orchidaceae","Asparagales",0,0,2,3,2,0
"Amesiodendron","Sapindaceae","Sapindales",1,0,0,3,1,1
"Amethystea","Lamiaceae","Lamiales",0,0,0,1,0,NA
"Amherstia","Fabaceae","Fabales",1,0,0,1,1,1
"Amianthium","Melanthiaceae","Liliales",0,0,0,1,0,NA
"Amicia","Fabaceae","Fabales",0,0,0,8,0,NA
"Amischotolype","Commelinaceae","Commelinales",0,0,3,10,3,0
"Amitostigma","Orchidaceae","Asparagales",0,0,1,29,1,0
"Ammandra","Arecaceae","Arecales",1,0,0,1,1,1
"Ammannia","Lythraceae","Myrtales",0,0,4,24,4,0
"Ammi","Apiaceae","Apiales",0,0,1,6,1,0
"Ammobium","Asteraceae","Asterales",0,0,1,2,1,0
"Ammocalamagrostis","Poaceae","Poales",0,0,0,1,0,NA
"Ammocharis","Amaryllidaceae","Asparagales",0,0,0,7,0,NA
"Ammochloa","Poaceae","Poales",0,0,0,3,0,NA
"Ammodaucus","Apiaceae","Apiales",0,0,0,1,0,NA
"Ammodendron","Fabaceae","Fabales",1,0,0,5,1,1
"Ammoides","Apiaceae","Apiales",0,0,0,3,0,NA
"Ammophila","Poaceae","Poales",0,0,2,3,2,0
"Ammopiptanthus","Fabaceae","Fabales",1,0,0,2,1,1
"Ammoselinum","Apiaceae","Apiales",0,0,0,5,0,NA
"Ammosperma","Brassicaceae","Brassicales",0,0,0,2,0,NA
"Amolinia","Asteraceae","Asterales",0,0,0,1,0,NA
"Amomum","Zingiberaceae","Zingiberales",0,0,16,179,16,0
"Amomyrtella","Myrtaceae","Myrtales",0,0,0,2,0,NA
"Amomyrtus","Myrtaceae","Myrtales",2,0,0,2,2,1
"Amoreuxia","Bixaceae","Malvales",0,0,1,4,1,0
"Amoria","Fabaceae","Fabales",0,0,0,2,0,NA
"Amorimia","Malpighiaceae","Malpighiales",0,0,0,10,0,NA
"Amorpha","Fabaceae","Fabales",3,0,0,18,3,1
"Amorphophallus","Araceae","Alismatales",0,0,66,198,66,0
"Ampelamus","Apocynaceae","Gentianales",0,0,0,2,0,NA
"Ampelaster","Asteraceae","Asterales",0,0,0,1,0,NA
"Ampelocalamus","Poaceae","Poales",1,0,0,13,1,1
"Ampelocera","Ulmaceae","Rosales",5,0,0,12,5,1
"Ampelocissus","Vitaceae","Vitales",0,1,0,96,0,NA
"Ampelodesmos","Poaceae","Poales",0,0,1,2,1,0
"Ampelopsis","Vitaceae","Vitales",2,0,1,24,3,0.666666666666667
"Ampelopteris","Thelypteridaceae","Polypodiales",0,0,0,1,0,NA
"Ampelosicyos","Cucurbitaceae","Cucurbitales",0,1,0,6,0,NA
"Ampelosycios","Cucurbitaceae","Cucurbitales",0,1,0,2,0,NA
"Ampelozizyphus","Rhamnaceae","Rosales",0,0,0,2,0,NA
"Amperea","Euphorbiaceae","Malpighiales",1,0,0,8,1,1
"Amphiachyris","Asteraceae","Asterales",0,0,0,2,0,NA
"Amphiasma","Rubiaceae","Gentianales",3,0,1,7,4,0.75
"Amphiblemma","Melastomataceae","Myrtales",0,0,0,8,0,NA
"Amphibolia","Aizoaceae","Caryophyllales",0,0,0,13,0,NA
"Amphibolis","Cymodoceaceae","Alismatales",0,0,1,2,1,0
"Amphibologyne","Boraginaceae","UnknownOrder-Boraginaceae",0,0,0,1,0,NA
"Amphicarpaea","Fabaceae","Fabales",0,0,1,4,1,0
"Amphicarpum","Poaceae","Poales",0,0,1,2,1,0
"Amphicosmia","Cyatheaceae","Cyatheales",0,0,0,2,0,NA
"Amphidasya","Rubiaceae","Gentianales",0,1,0,13,0,NA
"Amphidoxa","Asteraceae","Asterales",0,0,0,1,0,NA
"Amphiglossa","Asteraceae","Asterales",0,0,0,11,0,NA
"Amphilophium","Bignoniaceae","Lamiales",7,0,0,43,7,1
"Amphimas","Fabaceae","Fabales",2,0,0,3,2,1
"Amphineurion","Apocynaceae","Gentianales",0,1,0,1,0,NA
"Amphineuron","Thelypteridaceae","Polypodiales",0,0,0,6,0,NA
"Amphinomia","Fabaceae","Fabales",0,0,0,2,0,NA
"Amphiolanthus","Linderniaceae","Lamiales",0,0,0,3,0,NA
"Amphipappus","Asteraceae","Asterales",1,0,0,1,1,1
"Amphipetalum","Portulacaceae","Caryophyllales",0,0,0,1,0,NA
"Amphiphyllum","Rapateaceae","Poales",0,0,0,1,0,NA
"Amphipogon","Poaceae","Poales",0,0,2,8,2,0
"Amphipterum","Hymenophyllaceae","Hymenophyllales",0,0,0,1,0,NA
"Amphipterygium","Anacardiaceae","Sapindales",1,0,0,5,1,1
"Amphirrhox","Violaceae","Malpighiales",1,0,0,2,1,1
"Amphiscirpus","Cyperaceae","Poales",0,0,1,1,1,0
"Amphistemon","Rubiaceae","Gentianales",0,0,0,2,0,NA
"Amphitecna","Bignoniaceae","Lamiales",4,0,0,19,4,1
"Amphithalea","Fabaceae","Fabales",15,0,0,23,15,1
"Amphoricarpos","Asteraceae","Asterales",0,0,0,5,0,NA
"Amphorocalyx","Melastomataceae","Myrtales",0,0,0,5,0,NA
"Amphorogyne","Santalaceae","Santalales",0,0,0,3,0,NA
"Amphymenium","Fabaceae","Fabales",0,0,0,1,0,NA
"Amsinckia","Boraginaceae","UnknownOrder-Boraginaceae",0,0,1,14,1,0
"Amsonia","Apocynaceae","Gentianales",0,0,3,19,3,0
"Amydrium","Araceae","Alismatales",0,0,0,5,0,NA
"Amyema","Loranthaceae","Santalales",10,0,0,94,10,1
"Amylotheca","Loranthaceae","Santalales",1,0,0,4,1,1
"Amyrea","Euphorbiaceae","Malpighiales",1,0,0,11,1,1
"Amyris","Rutaceae","Sapindales",3,0,0,58,3,1
"Amyxa","Thymelaeaceae","Malvales",1,0,0,1,1,1
"Anabasis","Amaranthaceae","Caryophyllales",6,0,0,28,6,1
"Anacampseros","Anacampserotaceae","Caryophyllales",0,1,0,55,0,NA
"Anacamptiplatanthera","Orchidaceae","Asparagales",0,0,0,1,0,NA
"Anacamptis","Orchidaceae","Asparagales",0,0,0,34,0,NA
"Anacamptorchis","Orchidaceae","Asparagales",0,0,0,1,0,NA
"Anacantha","Asteraceae","Asterales",0,0,0,3,0,NA
"Anacaona","Cucurbitaceae","Cucurbitales",0,1,0,1,0,NA
"Anacardium","Anacardiaceae","Sapindales",7,0,0,20,7,1
"Anacolosa","Olacaceae","Santalales",2,0,0,15,2,1
"Anacyclus","Asteraceae","Asterales",0,0,0,12,0,NA
"Anadelphia","Poaceae","Poales",0,0,0,14,0,NA
"Anadenanthera","Fabaceae","Fabales",2,0,0,2,2,1
"Anadendrum","Araceae","Alismatales",0,0,0,12,0,NA
"Anaectocalyx","Melastomataceae","Myrtales",0,0,0,2,0,NA
"Anagallis","Primulaceae","Ericales",0,0,14,34,14,0
"Anagyris","Fabaceae","Fabales",1,0,0,1,1,1
"Anakasia","Araliaceae","Apiales",0,0,0,1,0,NA
"Anamaria","Scrophulariaceae","Lamiales",0,0,0,1,0,NA
"Anamirta","Menispermaceae","Ranunculales",1,0,0,1,1,1
"Ananas","Bromeliaceae","Poales",0,0,2,6,2,0
"Anangia","Cucurbitaceae","Cucurbitales",0,0,0,1,0,NA
"Ananthacorus","Pteridaceae","Polypodiales",0,0,0,1,0,NA
"Anapalina","Iridaceae","Asparagales",0,0,0,1,0,NA
"Anapausia","Polypodiaceae","Polypodiales",0,0,0,2,0,NA
"Anapeltis","Polypodiaceae","Polypodiales",0,0,0,3,0,NA
"Anaphalioides","Asteraceae","Asterales",0,0,2,8,2,0
"Anaphalis","Asteraceae","Asterales",0,0,3,113,3,0
"Anaphyllopsis","Araceae","Alismatales",0,0,0,3,0,NA
"Anaphyllum","Araceae","Alismatales",0,0,0,2,0,NA
"Anarrhinum","Plantaginaceae","Lamiales",0,0,0,8,0,NA
"Anarthria","Anarthriaceae","Poales",0,0,6,6,6,0
"Anarthrophyllum","Fabaceae","Fabales",1,0,0,16,1,1
"Anarthropteris","Polypodiaceae","Polypodiales",0,0,0,1,0,NA
"Anastatica","Brassicaceae","Brassicales",0,0,0,1,0,NA
"Anastrabe","Stilbaceae","Lamiales",0,0,0,1,0,NA
"Anastraphia","Asteraceae","Asterales",0,0,0,11,0,NA
"Anathallis","Orchidaceae","Asparagales",0,0,1,152,1,0
"Anatropanthus","Apocynaceae","Gentianales",0,0,0,1,0,NA
"Anaxagorea","Annonaceae","Magnoliales",12,0,0,25,12,1
"Anaxeton","Asteraceae","Asterales",1,0,0,10,1,1
"Ancana","Annonaceae","Magnoliales",1,0,0,2,1,1
"Ancathia","Asteraceae","Asterales",0,0,0,1,0,NA
"Anchietea","Violaceae","Malpighiales",0,0,0,8,0,NA
"Anchomanes","Araceae","Alismatales",0,0,2,6,2,0
"Anchonium","Brassicaceae","Brassicales",0,0,0,2,0,NA
"Anchusa","Boraginaceae","UnknownOrder-Boraginaceae",0,0,3,37,3,0
"Ancistrachne","Poaceae","Poales",0,0,0,4,0,NA
"Ancistragrostis","Poaceae","Poales",0,0,0,1,0,NA
"Ancistranthus","Acanthaceae","Lamiales",0,0,0,1,0,NA
"Ancistrocarphus","Asteraceae","Asterales",0,0,0,2,0,NA
"Ancistrocarpus","Malvaceae","Malvales",0,0,0,3,0,NA
"Ancistrocarya","Boraginaceae","UnknownOrder-Boraginaceae",0,0,0,1,0,NA
"Ancistrochilus","Orchidaceae","Asparagales",0,0,1,2,1,0
"Ancistrocladus","Ancistrocladaceae","Caryophyllales",5,1,0,21,5,1
"Ancistrorhynchus","Orchidaceae","Asparagales",0,0,4,18,4,0
"Ancistrostylis","Acanthaceae","Lamiales",0,0,0,1,0,NA
"Ancistrothyrsus","Passifloraceae","Malpighiales",0,0,0,2,0,NA
"Ancistrotropis","Fabaceae","Fabales",0,0,0,6,0,NA
"Ancylobothrys","Apocynaceae","Gentianales",2,0,0,7,2,1
"Ancylostemon","Gesneriaceae","Lamiales",0,0,0,17,0,NA
"Ancylotropis","Polygalaceae","Fabales",0,0,0,2,0,NA
"Andeimalva","Malvaceae","Malvales",0,0,0,4,0,NA
"Anderbergia","Asteraceae","Asterales",0,0,0,6,0,NA
"Andersonia","Ericaceae","Ericales",4,0,0,30,4,1
"Andinia","Orchidaceae","Asparagales",0,0,1,13,1,0
"Andira","Fabaceae","Fabales",10,0,0,48,10,1
"Andrachne","Phyllanthaceae","Malpighiales",3,0,0,22,3,1
"Andradea","Nyctaginaceae","Caryophyllales",1,0,0,1,1,1
"Andreadoxa","Rutaceae","Sapindales",0,0,0,1,0,NA
"Andriana","Apiaceae","Apiales",0,0,0,3,0,NA
"Androcalymma","Fabaceae","Fabales",0,0,0,1,0,NA
"Androcorys","Orchidaceae","Asparagales",0,0,0,10,0,NA
"Androcymbium","Colchicaceae","Liliales",0,0,7,57,7,0
"Andrographis","Acanthaceae","Lamiales",0,0,1,32,1,0
"Androlepis","Bromeliaceae","Poales",0,0,1,2,1,0
"Andromeda","Ericaceae","Ericales",2,0,0,4,2,1
"Andropogon","Poaceae","Poales",0,0,9,120,9,0
"Andropterum","Poaceae","Poales",0,0,0,1,0,NA
"Androsace","Primulaceae","Ericales",0,1,8,170,8,0
"Androsiphonia","Passifloraceae","Malpighiales",0,0,0,1,0,NA
"Androstachys","Picrodendraceae","Malpighiales",1,0,0,1,1,1
"Androstephium","Asparagaceae","Asparagales",0,0,1,2,1,0
"Androtium","Anacardiaceae","Sapindales",1,0,0,1,1,1
"Androtrichum","Cyperaceae","Poales",0,0,0,2,0,NA
"Androya","Scrophulariaceae","Lamiales",0,0,0,1,0,NA
"Andryala","Asteraceae","Asterales",0,0,4,30,4,0
"Andrzeiowskia","Brassicaceae","Brassicales",0,0,0,1,0,NA
"Anechites","Apocynaceae","Gentianales",0,1,0,1,0,NA
"Aneilema","Commelinaceae","Commelinales",0,0,9,62,9,0
"Anelsonia","Brassicaceae","Brassicales",0,0,1,1,1,0
"Anemarrhena","Asparagaceae","Asparagales",0,0,1,1,1,0
"Anemia","Anemiaceae","Schizaeales",0,0,0,85,0,NA
"Anemidictyon","Anemiaceae","Schizaeales",0,0,0,1,0,NA
"Anemocarpa","Asteraceae","Asterales",0,0,1,3,1,0
"Anemoclema","Ranunculaceae","Ranunculales",0,0,0,1,0,NA
"Anemone","Ranunculaceae","Ranunculales",0,0,17,172,17,0
"Anemonella","Ranunculaceae","Ranunculales",0,0,1,1,1,0
"Anemonidium","Ranunculaceae","Ranunculales",0,0,0,1,0,NA
"Anemonoides","Ranunculaceae","Ranunculales",0,0,0,1,0,NA
"Anemonopsis","Ranunculaceae","Ranunculales",0,0,0,1,0,NA
"Anemopaegma","Bignoniaceae","Lamiales",9,0,0,45,9,1
"Anemopsis","Saururaceae","Piperales",0,0,1,1,1,0
"Anetanthus","Gesneriaceae","Lamiales",0,0,1,2,1,0
"Anethum","Apiaceae","Apiales",0,0,1,4,1,0
"Anetium","Pteridaceae","Polypodiales",0,0,0,2,0,NA
"Aneulophus","Erythroxylaceae","Malpighiales",0,0,0,2,0,NA
"Angadenia","Apocynaceae","Gentianales",0,1,0,2,0,NA
"Angeldiazia","Asteraceae","Asterales",0,0,0,1,0,NA
"Angelica","Apiaceae","Apiales",0,0,10,116,10,0
"Angelonia","Plantaginaceae","Lamiales",0,0,0,34,0,NA
"Angelphytum","Asteraceae","Asterales",0,2,0,15,0,NA
"Angianthus","Asteraceae","Asterales",0,0,2,19,2,0
"Anginon","Apiaceae","Apiales",1,0,0,13,1,1
"Angiopteris","Marattiaceae","Marattiales",0,0,73,75,73,0
"Angkalanthus","Acanthaceae","Lamiales",0,0,0,1,0,NA
"Angolaea","Podostemaceae","Malpighiales",0,0,0,1,0,NA
"Angolluma","Apocynaceae","Gentianales",0,0,0,1,0,NA
"Angophora","Myrtaceae","Myrtales",14,0,0,16,14,1
"Angoseseli","Apiaceae","Apiales",0,0,0,2,0,NA
"Angostura","Rutaceae","Sapindales",0,0,0,21,0,NA
"Angostylis","Euphorbiaceae","Malpighiales",0,0,0,2,0,NA
"Angraecopsis","Orchidaceae","Asparagales",0,0,3,22,3,0
"Angraecum","Orchidaceae","Asparagales",0,0,19,221,19,0
"Anguloa","Orchidaceae","Asparagales",0,0,1,13,1,0
"Angylocalyx","Fabaceae","Fabales",2,0,0,6,2,1
"Aniba","Lauraceae","Laurales",21,0,0,48,21,1
"Anigozanthos","Haemodoraceae","Commelinales",0,0,9,11,9,0
"Anil","Fabaceae","Fabales",0,0,0,1,0,NA
"Anila","Fabaceae","Fabales",0,0,0,28,0,NA
"Anisacanthus","Acanthaceae","Lamiales",0,0,0,17,0,NA
"Anisadenia","Linaceae","Malpighiales",0,0,0,2,0,NA
"Anisantherina","Orobanchaceae","Lamiales",0,0,0,1,0,NA
"Aniseia","Convolvulaceae","Solanales",0,0,3,6,3,0
"Aniselytron","Poaceae","Poales",0,0,0,2,0,NA
"Anisocampium","Athyriaceae","Polypodiales",0,0,0,5,0,NA
"Anisocapparis","Capparaceae","Brassicales",0,0,0,1,0,NA
"Anisocarpus","Asteraceae","Asterales",0,0,0,2,0,NA
"Anisochaeta","Asteraceae","Asterales",0,0,0,1,0,NA
"Anisochilus","Lamiaceae","Lamiales",0,0,1,17,1,0
"Anisocoma","Asteraceae","Asterales",0,0,0,1,0,NA
"Anisocycla","Menispermaceae","Ranunculales",1,0,0,5,1,1
"Anisodontea","Malvaceae","Malvales",1,0,0,20,1,1
"Anisodus","Solanaceae","Solanales",0,0,0,4,0,NA
"Anisogonium","Athyriaceae","Polypodiales",0,0,0,2,0,NA
"Anisolotus","Fabaceae","Fabales",0,0,0,1,0,NA
"Anisomeles","Lamiaceae","Lamiales",0,0,2,5,2,0
"Anisomeria","Phytolaccaceae","Caryophyllales",0,0,0,4,0,NA
"Anisopappus","Asteraceae","Asterales",0,0,2,38,2,0
"Anisophyllea","Anisophylleaceae","Cucurbitales",16,0,0,36,16,1
"Anisophyllum","Euphorbiaceae","Malpighiales",0,0,0,1,0,NA
"Anisopoda","Apiaceae","Apiales",0,0,0,1,0,NA
"Anisopogon","Poaceae","Poales",0,0,1,1,1,0
"Anisoptera","Dipterocarpaceae","Malvales",9,0,0,10,9,1
"Anisopus","Apocynaceae","Gentianales",0,0,0,4,0,NA
"Anisosciadium","Apiaceae","Apiales",0,0,0,3,0,NA
"Anisosepalum","Acanthaceae","Lamiales",0,0,0,3,0,NA
"Anisostachya","Acanthaceae","Lamiales",0,0,0,2,0,NA
"Anisotes","Acanthaceae","Lamiales",1,0,0,18,1,1
"Anisothrix","Asteraceae","Asterales",1,0,0,2,1,1
"Anisotoma","Apocynaceae","Gentianales",0,1,0,2,0,NA
"Anisotome","Apiaceae","Apiales",0,0,2,15,2,0
"Ankyropetalum","Caryophyllaceae","Caryophyllales",0,0,0,3,0,NA
"Anna","Gesneriaceae","Lamiales",1,0,0,3,1,1
"Annesijoa","Euphorbiaceae","Malpighiales",0,0,0,1,0,NA
"Anneslea","Pentaphylacaceae","Ericales",1,0,0,4,1,1
"Anneslia","Fabaceae","Fabales",0,0,0,11,0,NA
"Annesorhiza","Apiaceae","Apiales",0,0,1,15,1,0
"Annickia","Annonaceae","Magnoliales",4,0,0,11,4,1
"Annona","Annonaceae","Magnoliales",30,0,0,166,30,1
"Anoda","Malvaceae","Malvales",0,0,0,23,0,NA
"Anodendron","Apocynaceae","Gentianales",2,0,0,17,2,1
"Anodopetalum","Cunoniaceae","Oxalidales",1,0,0,1,1,1
"Anoectochilus","Orchidaceae","Asparagales",0,0,0,43,0,NA
"Anogeissus","Combretaceae","Myrtales",5,0,0,8,5,1
"Anogramma","Pteridaceae","Polypodiales",0,0,0,6,0,NA
"Anomacanthus","Acanthaceae","Lamiales",0,0,0,1,0,NA
"Anomalanthus","Ericaceae","Ericales",0,0,0,12,0,NA
"Anomianthus","Annonaceae","Magnoliales",0,0,0,1,0,NA
"Anomochloa","Poaceae","Poales",0,0,1,1,1,0
"Anomospermum","Menispermaceae","Ranunculales",4,0,0,8,4,1
"Anomostachys","Euphorbiaceae","Malpighiales",0,0,0,1,0,NA
"Anonidium","Annonaceae","Magnoliales",2,0,0,4,2,1
"Anoplocaryum","Boraginaceae","UnknownOrder-Boraginaceae",0,0,0,5,0,NA
"Anoplophytum","Bromeliaceae","Poales",0,0,0,1,0,NA
"Anopteris","Pteridaceae","Polypodiales",0,0,2,2,2,0
"Anopterus","Escalloniaceae","Escalloniales",2,0,0,2,2,1
"Anopyxis","Rhizophoraceae","Malpighiales",1,0,0,1,1,1
"Anotea","Malvaceae","Malvales",1,0,0,1,1,1
"Anotis","Rubiaceae","Gentianales",0,0,0,1,0,NA
"Anredera","Basellaceae","Caryophyllales",0,1,0,12,0,NA
"Ansellia","Orchidaceae","Asparagales",0,0,1,1,1,0
"Antegibbaeum","Aizoaceae","Caryophyllales",0,0,0,1,0,NA
"Antennaria","Asteraceae","Asterales",0,1,5,61,5,0
"Anteremanthus","Asteraceae","Asterales",0,0,0,1,0,NA
"Anthaenantia","Poaceae","Poales",0,0,0,3,0,NA
"Anthaenantiopsis","Poaceae","Poales",0,0,1,4,1,0
"Anthematricaria","Asteraceae","Asterales",0,0,0,1,0,NA
"Anthemimatricaria","Asteraceae","Asterales",0,0,0,3,0,NA
"Anthemis","Asteraceae","Asterales",0,0,5,178,5,0
"Anthephora","Poaceae","Poales",0,0,0,11,0,NA
"Anthericopsis","Commelinaceae","Commelinales",0,0,1,1,1,0
"Anthericum","Asparagaceae","Asparagales",0,0,2,9,2,0
"Antheropeas","Asteraceae","Asterales",0,0,0,2,0,NA
"Antheroporum","Fabaceae","Fabales",0,0,0,3,0,NA
"Antherostele","Rubiaceae","Gentianales",0,0,0,4,0,NA
"Antherothamnus","Scrophulariaceae","Lamiales",0,0,1,1,1,0
"Antherotoma","Melastomataceae","Myrtales",0,0,0,4,0,NA
"Anthobolus","Santalaceae","Santalales",0,0,0,4,0,NA
"Anthocarpa","Meliaceae","Sapindales",1,0,0,1,1,1
"Anthocercis","Solanaceae","Solanales",7,0,0,10,7,1
"Anthochlamys","Amaranthaceae","Caryophyllales",0,0,1,6,1,0
"Anthochloa","Poaceae","Poales",0,0,0,1,0,NA
"Anthochortus","Restionaceae","Poales",0,0,1,7,1,0
"Anthocleista","Gentianaceae","Gentianales",3,0,0,15,3,1
"Anthodiscus","Caryocaraceae","Malpighiales",4,0,0,10,4,1
"Anthodon","Celastraceae","Celastrales",2,0,0,5,2,1
"Anthogonium","Orchidaceae","Asparagales",0,0,1,1,1,0
"Anthonotha","Fabaceae","Fabales",4,0,0,30,4,1
"Anthopteropsis","Ericaceae","Ericales",0,0,0,1,0,NA
"Anthopterus","Ericaceae","Ericales",1,0,0,12,1,1
"Anthorrhiza","Rubiaceae","Gentianales",0,0,0,9,0,NA
"Anthospermopsis","Rubiaceae","Gentianales",0,0,0,1,0,NA
"Anthospermum","Rubiaceae","Gentianales",6,0,1,39,7,0.857142857142857
"Anthostema","Euphorbiaceae","Malpighiales",3,0,0,3,3,1
"Anthotium","Goodeniaceae","Asterales",0,0,3,4,3,0
"Anthotroche","Solanaceae","Solanales",3,0,0,3,3,1
"Anthoxanthum","Poaceae","Poales",0,0,2,17,2,0
"Anthrichaerophyllum","Apiaceae","Apiales",0,0,0,1,0,NA
"Anthriscus","Apiaceae","Apiales",0,0,3,15,3,0
"Anthurium","Araceae","Alismatales",0,0,14,926,14,0
"Anthyllis","Fabaceae","Fabales",3,0,1,35,4,0.75
"Antiaris","Moraceae","Rosales",1,0,0,1,1,1
"Antiaropsis","Moraceae","Rosales",1,0,0,2,1,1
"Anticharis","Scrophulariaceae","Lamiales",0,0,0,8,0,NA
"Anticlea","Melanthiaceae","Liliales",0,0,1,11,1,0
"Antidaphne","Santalaceae","Santalales",1,0,0,9,1,1
"Antidesma","Phyllanthaceae","Malpighiales",19,0,0,102,19,1
"Antigonon","Polygonaceae","Caryophyllales",2,0,0,3,2,1
"Antigramma","Aspleniaceae","Polypodiales",0,0,0,2,0,NA
"Antillanthus","Asteraceae","Asterales",0,0,0,17,0,NA
"Antillia","Asteraceae","Asterales",0,0,0,1,0,NA
"Antimima","Aizoaceae","Caryophyllales",0,0,0,106,0,NA
"Antinoria","Poaceae","Poales",0,0,0,2,0,NA
"Antiotrema","Boraginaceae","UnknownOrder-Boraginaceae",0,0,0,1,0,NA
"Antiphiona","Asteraceae","Asterales",2,0,0,2,2,1
"Antiphytum","Boraginaceae","UnknownOrder-Boraginaceae",1,0,0,12,1,1
"Antirhea","Rubiaceae","Gentianales",1,0,0,38,1,1
"Antirrhinum","Plantaginaceae","Lamiales",0,0,1,21,1,0
"Antistrophe","Primulaceae","Ericales",0,0,0,6,0,NA
"Antithrixia","Asteraceae","Asterales",0,0,0,1,0,NA
"Antizoma","Menispermaceae","Ranunculales",1,0,0,3,1,1
"Antonia","Loganiaceae","Gentianales",1,0,0,1,1,1
"Antopetitia","Fabaceae","Fabales",0,0,0,1,0,NA
"Antrocaryon","Anacardiaceae","Sapindales",3,0,0,4,3,1
"Antrophyum","Pteridaceae","Polypodiales",0,0,0,27,0,NA
"Anubias","Araceae","Alismatales",0,0,1,8,1,0
"Anulocaulis","Nyctaginaceae","Caryophyllales",0,0,3,4,3,0
"Anura","Asteraceae","Asterales",0,0,0,1,0,NA
"Anvillea","Asteraceae","Asterales",1,0,0,2,1,1
"Anychia","Caryophyllaceae","Caryophyllales",0,0,0,1,0,NA
"Aoranthe","Rubiaceae","Gentianales",2,0,0,5,2,1
"Aosa","Loasaceae","Cornales",0,0,1,7,1,0
"Aotus","Fabaceae","Fabales",1,0,0,14,1,1
"Apacheria","Crossosomataceae","Crossosomatales",0,0,0,1,0,NA
"Apalatoa","Fabaceae","Fabales",0,0,0,5,0,NA
"Apalochlamys","Asteraceae","Asterales",0,0,1,1,1,0
"Apalophlebia","Polypodiaceae","Polypodiales",0,0,0,1,0,NA
"Apargia","Asteraceae","Asterales",0,0,0,3,0,NA
"Aparisthmium","Euphorbiaceae","Malpighiales",1,0,0,1,1,1
"Apassalus","Acanthaceae","Lamiales",0,0,0,4,0,NA
"Apatesia","Aizoaceae","Caryophyllales",0,0,0,3,0,NA
"Apatophyllum","Celastraceae","Celastrales",0,0,0,5,0,NA
"Apeiba","Malvaceae","Malvales",7,0,0,10,7,1
"Apera","Poaceae","Poales",0,0,2,5,2,0
"Apetahia","Campanulaceae","Asterales",0,0,0,4,0,NA
"Aphaenandra","Rubiaceae","Gentianales",0,0,0,1,0,NA
"Aphanactis","Asteraceae","Asterales",0,0,1,11,1,0
"Aphanamixis","Meliaceae","Sapindales",1,0,0,3,1,1
"Aphananthe","Cannabaceae","Rosales",3,0,0,4,3,1
"Aphandra","Arecaceae","Arecales",1,0,0,1,1,1
"Aphanelytrum","Poaceae","Poales",0,0,0,2,0,NA
"Aphanes","Rosaceae","Rosales",0,0,1,11,1,0
"Aphanisma","Amaranthaceae","Caryophyllales",0,0,1,1,1,0
"Aphanocalyx","Fabaceae","Fabales",1,0,0,15,1,1
"Aphanocarpus","Rubiaceae","Gentianales",0,0,0,1,0,NA
"Aphanopetalum","Aphanopetalaceae","Saxifragales",1,0,0,2,1,1
"Aphanopleura","Apiaceae","Apiales",0,0,0,5,0,NA
"Aphanosperma","Acanthaceae","Lamiales",0,0,0,1,0,NA
"Aphanostephus","Asteraceae","Asterales",0,0,0,8,0,NA
"Aphelandra","Acanthaceae","Lamiales",1,0,0,196,1,1
"Aphelandrella","Acanthaceae","Lamiales",0,0,0,1,0,NA
"Aphelia","Centrolepidaceae","Poales",0,0,3,6,3,0
"Aphloia","Aphloiaceae","Crossosomatales",1,0,0,2,1,1
"Aphragmus","Brassicaceae","Brassicales",0,0,0,14,0,NA
"Aphyllanthes","Asparagaceae","Asparagales",0,0,1,1,1,0
"Aphyllocladus","Asteraceae","Asterales",0,0,0,5,0,NA
"Aphyllodium","Fabaceae","Fabales",0,0,0,3,0,NA
"Aphyllorchis","Orchidaceae","Asparagales",0,0,0,22,0,NA
"Apiastrum","Apiaceae","Apiales",0,0,0,1,0,NA
"Apinagia","Podostemaceae","Malpighiales",0,0,0,53,0,NA
"Apiopetalum","Apiaceae","Apiales",1,0,0,2,1,1
"Apios","Fabaceae","Fabales",0,0,2,8,2,0
"Apium","Apiaceae","Apiales",0,0,5,17,5,0
"Aplanodes","Brassicaceae","Brassicales",0,0,0,2,0,NA
"Aplectrum","Orchidaceae","Asparagales",0,0,1,1,1,0
"Apluda","Poaceae","Poales",0,0,1,1,1,0
"Apoballis","Araceae","Alismatales",0,0,0,12,0,NA
"Apocaulon","Rutaceae","Sapindales",0,0,0,1,0,NA
"Apochiton","Poaceae","Poales",0,0,0,1,0,NA
"Apoclada","Poaceae","Poales",0,0,0,1,0,NA
"Apocopis","Poaceae","Poales",0,0,0,16,0,NA
"Apocynum","Apocynaceae","Gentianales",0,1,2,7,2,0
"Apodanthera","Cucurbitaceae","Cucurbitales",0,0,1,35,1,0
"Apodanthes","Apodanthaceae","UnknownOrder-Apodanthaceae",0,0,5,5,5,0
"Apodasmia","Restionaceae","Poales",0,0,3,3,3,0
"Apodicarpum","Apiaceae","Apiales",0,0,0,1,0,NA
"Apodiscus","Phyllanthaceae","Malpighiales",1,0,0,1,1,1
"Apodocephala","Asteraceae","Asterales",1,0,0,9,1,1
"Apodolirion","Amaryllidaceae","Asparagales",0,0,1,6,1,0
"Apodostigma","Celastraceae","Celastrales",1,0,0,1,1,1
"Apodytes","Icacinaceae","UnknownOrder-Icacinaceae",3,0,0,8,3,1
"Apogon","Asteraceae","Asterales",0,0,0,1,0,NA
"Apollonias","Lauraceae","Laurales",1,0,0,2,1,1
"Apomuria","Rubiaceae","Gentianales",0,0,0,12,0,NA
"Aponogeton","Aponogetonaceae","Alismatales",0,0,4,57,4,0
"Apophyllum","Capparaceae","Brassicales",1,0,0,1,1,1
"Apoplanesia","Fabaceae","Fabales",2,0,0,2,2,1
"Apopyros","Asteraceae","Asterales",0,0,0,2,0,NA
"Aporocactus","Cactaceae","Caryophyllales",0,0,0,1,0,NA
"Aporosa","Phyllanthaceae","Malpighiales",18,0,0,82,18,1
"Aporostylis","Orchidaceae","Asparagales",0,0,1,1,1,0
"Aporrhiza","Sapindaceae","Sapindales",2,0,0,7,2,1
"Aposeris","Asteraceae","Asterales",0,0,1,1,1,0
"Apostasia","Orchidaceae","Asparagales",0,0,3,8,3,0
"Apostates","Asteraceae","Asterales",0,0,0,1,0,NA
"Appendicula","Orchidaceae","Asparagales",0,0,1,136,1,0
"Appendicularia","Melastomataceae","Myrtales",0,0,0,1,0,NA
"Appertiella","Hydrocharitaceae","Alismatales",0,0,0,1,0,NA
"Appunia","Rubiaceae","Gentianales",1,0,0,14,1,1
"Aptandra","Olacaceae","Santalales",3,0,0,4,3,1
"Apteria","Burmanniaceae","Dioscoreales",0,0,0,1,0,NA
"Apterosperma","Theaceae","Ericales",1,0,0,1,1,1
"Aptosimum","Scrophulariaceae","Lamiales",0,0,1,24,1,0
"Apuleia","Fabaceae","Fabales",2,0,0,3,2,1
"Apurimacia","Fabaceae","Fabales",1,0,0,6,1,1
"Aquilaria","Thymelaeaceae","Malvales",3,0,0,22,3,1
"Aquilegia","Ranunculaceae","Ranunculales",0,0,9,102,9,0
"Arabidella","Brassicaceae","Brassicales",0,0,0,7,0,NA
"Arabidopsis","Brassicaceae","Brassicales",0,0,4,11,4,0
"Arabis","Brassicaceae","Brassicales",0,0,9,110,9,0
"Aracamunia","Orchidaceae","Asparagales",0,0,0,1,0,NA
"Arachis","Fabaceae","Fabales",0,0,1,81,1,0
"Arachniodes","Dryopteridaceae","Polypodiales",0,0,0,142,0,NA
"Arachnis","Orchidaceae","Asparagales",0,0,0,12,0,NA
"Arachnitis","Corsiaceae","Liliales",0,0,1,1,1,0
"Arachnocalyx","Ericaceae","Ericales",0,0,0,2,0,NA
"Arachnothryx","Rubiaceae","Gentianales",2,0,0,107,2,1
"Aracium","Asteraceae","Asterales",0,0,1,2,1,0
"Araeococcus","Bromeliaceae","Poales",0,0,4,9,4,0
"Arafoe","Apiaceae","Apiales",0,0,0,1,0,NA
"Aragallus","Fabaceae","Fabales",0,0,0,9,0,NA
"Aragoa","Plantaginaceae","Lamiales",0,0,0,23,0,NA
"Araiostegia","Davalliaceae","Polypodiales",0,0,0,16,0,NA
"Araiostegiella","Davalliaceae","Polypodiales",0,0,0,4,0,NA
"Aralia","Araliaceae","Apiales",10,0,3,74,13,0.769230769230769
"Aralidium","Torricelliaceae","Apiales",1,0,0,1,1,1
"Araliopsis","Rutaceae","Sapindales",0,0,0,2,0,NA
"Arapatiella","Fabaceae","Fabales",1,0,0,2,1,1
"Araracuara","Rhamnaceae","Rosales",0,0,0,1,0,NA
"Aratitiyopea","Xyridaceae","Poales",0,0,1,1,1,0
"Araucaria","Araucariaceae","Araucariales",19,0,0,19,19,1
"Araujia","Apocynaceae","Gentianales",0,2,0,9,0,NA
"Arbelaezaster","Asteraceae","Asterales",0,0,0,1,0,NA
"Arberella","Poaceae","Poales",0,0,0,7,0,NA
"Arboa","Passifloraceae","Malpighiales",0,0,0,2,0,NA
"Arbutus","Ericaceae","Ericales",7,0,0,11,7,1
"Arcangelisia","Menispermaceae","Ranunculales",1,0,0,3,1,1
"Arceuthobium","Santalaceae","Santalales",1,0,0,39,1,1
"Archakebia","Lardizabalaceae","Ranunculales",0,1,0,1,0,NA
"Archangiopteris","Marattiaceae","Marattiales",0,0,7,7,7,0
"Archboldiodendron","Pentaphylacaceae","Ericales",1,0,0,1,1,1
"Archeria","Ericaceae","Ericales",2,0,0,6,2,1
"Archiatriplex","Amaranthaceae","Caryophyllales",0,0,0,1,0,NA
"Archibaccharis","Asteraceae","Asterales",0,0,0,37,0,NA
"Archiboehmeria","Urticaceae","Rosales",0,0,0,1,0,NA
"Archidendron","Fabaceae","Fabales",13,0,0,98,13,1
"Archidendropsis","Fabaceae","Fabales",9,0,0,13,9,1
"Archihyoscyamus","Solanaceae","Solanales",0,0,0,1,0,NA
"Archiphysalis","Solanaceae","Solanales",0,0,0,2,0,NA
"Archirhodomyrtus","Myrtaceae","Myrtales",1,0,0,5,1,1
"Archivea","Orchidaceae","Asparagales",0,0,0,1,0,NA
"Archontophoenix","Arecaceae","Arecales",3,0,0,6,3,1
"Archytaea","Bonnetiaceae","Malpighiales",0,0,0,2,0,NA
"Arcoa","Fabaceae","Fabales",1,0,0,1,1,1
"Arctagrostis","Poaceae","Poales",0,0,1,2,1,0
"Arctanthemum","Asteraceae","Asterales",0,0,0,2,0,NA
"Arcteranthis","Ranunculaceae","Ranunculales",0,0,0,1,0,NA
"Arctium","Asteraceae","Asterales",0,0,4,19,4,0
"Arctodupontia","Poaceae","Poales",0,0,0,1,0,NA
"Arctogeron","Asteraceae","Asterales",0,0,0,1,0,NA
"Arctomecon","Papaveraceae","Ranunculales",0,0,0,4,0,NA
"Arctophila","Poaceae","Poales",0,0,0,1,0,NA
"Arctopoa","Poaceae","Poales",0,0,0,1,0,NA
"Arctopus","Apiaceae","Apiales",0,0,1,3,1,0
"Arctostaphylos","Ericaceae","Ericales",55,0,0,75,55,1
"Arctotheca","Asteraceae","Asterales",0,0,1,5,1,0
"Arctotis","Asteraceae","Asterales",0,0,8,70,8,0
"Arctous","Ericaceae","Ericales",1,0,0,3,1,1
"Arcuatopterus","Apiaceae","Apiales",0,0,0,5,0,NA
"Arcyosperma","Brassicaceae","Brassicales",0,0,0,1,0,NA
"Arcypteris","Tectariaceae","Polypodiales",0,0,0,1,0,NA
"Arcytophyllum","Rubiaceae","Gentianales",1,0,0,18,1,1
"Ardisia","Primulaceae","Ericales",28,0,1,789,29,0.96551724137931
"Ardisiandra","Primulaceae","Ericales",0,0,1,3,1,0
"Areca","Arecaceae","Arecales",3,0,0,45,3,1
"Aremonia","Rosaceae","Rosales",0,0,0,1,0,NA
"Arenaria","Caryophyllaceae","Caryophyllales",0,0,3,272,3,0
"Arenga","Arecaceae","Arecales",6,0,0,25,6,1
"Arenifera","Aizoaceae","Caryophyllales",0,0,0,5,0,NA
"Arethusa","Orchidaceae","Asparagales",0,0,1,1,1,0
"Aretiastrum","Caprifoliaceae","Dipsacales",0,0,0,4,0,NA
"Arfeuillea","Sapindaceae","Sapindales",1,0,0,1,1,1
"Argania","Sapotaceae","Ericales",1,0,0,1,1,1
"Argemone","Papaveraceae","Ranunculales",2,0,2,32,4,0.5
"Argentipallium","Asteraceae","Asterales",0,1,0,6,0,NA
"Argocoffeopsis","Rubiaceae","Gentianales",0,0,0,10,0,NA
"Argomuellera","Euphorbiaceae","Malpighiales",1,0,0,11,1,1
"Argophyllum","Argophyllaceae","Asterales",2,0,0,15,2,1
"Argostemma","Rubiaceae","Gentianales",0,0,1,163,1,0
"Argylia","Bignoniaceae","Lamiales",0,0,2,13,2,0
"Argyranthemum","Asteraceae","Asterales",0,0,0,24,0,NA
"Argyrautia","Asteraceae","Asterales",0,0,0,1,0,NA
"Argyreia","Convolvulaceae","Solanales",0,3,0,28,0,NA
"Argyrochosma","Pteridaceae","Polypodiales",0,0,0,16,0,NA
"Argyrocytisus","Fabaceae","Fabales",1,0,0,1,1,1
"Argyroderma","Aizoaceae","Caryophyllales",0,0,0,12,0,NA
"Argyroglottis","Asteraceae","Asterales",0,0,0,1,0,NA
"Argyrolobium","Fabaceae","Fabales",0,0,2,97,2,0
"Argyrotegium","Asteraceae","Asterales",0,0,1,4,1,0
"Argyroxiphium","Asteraceae","Asterales",0,0,0,6,0,NA
"Argythamnia","Euphorbiaceae","Malpighiales",2,0,0,23,2,1
"Arida","Asteraceae","Asterales",0,0,0,9,0,NA
"Aridarum","Araceae","Alismatales",0,0,0,10,0,NA
"Arillastrum","Myrtaceae","Myrtales",1,0,0,1,1,1
"Ariocarpus","Cactaceae","Caryophyllales",0,0,0,7,0,NA
"Ariopsis","Araceae","Alismatales",0,0,1,2,1,0
"Aripuana","Gentianaceae","Gentianales",0,0,0,1,0,NA
"Arisaema","Araceae","Alismatales",0,0,17,180,17,0
"Arisarum","Araceae","Alismatales",0,0,3,4,3,0
"Aristea","Iridaceae","Asparagales",0,0,36,56,36,0
"Aristeguietia","Asteraceae","Asterales",0,0,0,19,0,NA
"Aristida","Poaceae","Poales",0,0,35,301,35,0
"Aristocapsa","Polygonaceae","Caryophyllales",0,0,0,1,0,NA
"Aristogeitonia","Picrodendraceae","Malpighiales",1,0,0,7,1,1
"Aristolochia","Aristolochiaceae","Piperales",14,8,19,485,33,0.424242424242424
"Aristotelia","Elaeocarpaceae","Oxalidales",4,0,0,8,4,1
"Arjona","Schoepfiaceae","Santalales",0,0,0,6,0,NA
"Armatocereus","Cactaceae","Caryophyllales",1,0,0,6,1,1
"Armeniaca","Rosaceae","Rosales",0,0,0,1,0,NA
"Armenoprunus","Rosaceae","Rosales",0,0,0,1,0,NA
"Armeria","Plumbaginaceae","Caryophyllales",0,0,2,95,2,0
"Armodorum","Orchidaceae","Asparagales",0,0,0,4,0,NA
"Armoracia","Brassicaceae","Brassicales",0,0,1,3,1,0
"Arnaldoa","Asteraceae","Asterales",0,0,0,3,0,NA
"Arnebia","Boraginaceae","UnknownOrder-Boraginaceae",0,0,1,39,1,0
"Arnhemia","Thymelaeaceae","Malvales",0,0,0,1,0,NA
"Arnica","Asteraceae","Asterales",0,0,3,33,3,0
"Arnicastrum","Asteraceae","Asterales",0,0,0,2,0,NA
"Arnicratea","Celastraceae","Celastrales",0,0,0,3,0,NA
"Arnocrinum","Xanthorrhoeaceae","Asparagales",0,0,0,3,0,NA
"Arnoglossum","Asteraceae","Asterales",0,0,0,8,0,NA
"Arnoseris","Asteraceae","Asterales",0,0,1,1,1,0
"Arnottia","Orchidaceae","Asparagales",0,0,0,4,0,NA
"Aronia","Rosaceae","Rosales",2,0,0,4,2,1
"Arophyton","Araceae","Alismatales",0,0,0,7,0,NA
"Arpophyllum","Orchidaceae","Asparagales",0,0,1,3,1,0
"Arrabidaea","Bignoniaceae","Lamiales",1,0,0,1,1,1
"Arracacia","Apiaceae","Apiales",0,0,1,41,1,0
"Arrhenatherum","Poaceae","Poales",0,0,1,9,1,0
"Arrhenechthites","Asteraceae","Asterales",0,0,0,7,0,NA
"Arrojadoa","Cactaceae","Caryophyllales",0,0,0,7,0,NA
"Arrojadocharis","Asteraceae","Asterales",0,0,0,2,0,NA
"Arrowsmithia","Asteraceae","Asterales",0,0,0,1,0,NA
"Artabotrys","Annonaceae","Magnoliales",10,0,0,102,10,1
"Artanema","Linderniaceae","Lamiales",0,0,0,5,0,NA
"Artanthe","Piperaceae","Piperales",0,0,0,4,0,NA
"Artedia","Apiaceae","Apiales",0,0,0,1,0,NA
"Artemisia","Asteraceae","Asterales",23,0,26,481,49,0.469387755102041
"Artemisiella","Asteraceae","Asterales",0,0,0,1,0,NA
"Artemisiopsis","Asteraceae","Asterales",0,0,0,1,0,NA
"Arthraerua","Amaranthaceae","Caryophyllales",1,0,0,1,1,1
"Arthragrostis","Poaceae","Poales",0,0,0,3,0,NA
"Arthraxon","Poaceae","Poales",0,0,2,23,2,0
"Arthrocarpum","Fabaceae","Fabales",0,0,0,2,0,NA
"Arthrocereus","Cactaceae","Caryophyllales",0,0,0,4,0,NA
"Arthrochilus","Orchidaceae","Asparagales",0,0,0,15,0,NA
"Arthroclianthus","Fabaceae","Fabales",0,0,0,1,0,NA
"Arthrocnemum","Amaranthaceae","Caryophyllales",1,0,0,3,1,1
"Arthromeris","Polypodiaceae","Polypodiales",0,0,0,18,0,NA
"Arthrophytum","Amaranthaceae","Caryophyllales",0,0,0,8,0,NA
"Arthropodium","Asparagaceae","Asparagales",0,0,3,9,3,0
"Arthropogon","Poaceae","Poales",0,0,1,4,1,0
"Arthropteris","Tectariaceae","Polypodiales",0,0,3,8,3,0
"Arthrostemma","Melastomataceae","Myrtales",0,0,1,5,1,0
"Arthrostylidium","Poaceae","Poales",0,0,0,32,0,NA
"Arthrostylis","Cyperaceae","Poales",0,0,1,1,1,0
"Artia","Apocynaceae","Gentianales",1,0,0,5,1,1
"Artocarpus","Moraceae","Rosales",25,0,0,64,25,1
"Artorima","Orchidaceae","Asparagales",0,0,1,1,1,0
"Arum","Araceae","Alismatales",0,0,13,30,13,0
"Aruncus","Rosaceae","Rosales",0,0,1,2,1,0
"Arundina","Orchidaceae","Asparagales",0,0,1,2,1,0
"Arundinaria","Poaceae","Poales",1,0,0,9,1,1
"Arundinella","Poaceae","Poales",0,0,4,49,4,0
"Arundo","Poaceae","Poales",0,0,1,5,1,0
"Arundoclaytonia","Poaceae","Poales",0,0,0,2,0,NA
"Arytera","Sapindaceae","Sapindales",5,0,0,27,5,1
"Asanthus","Asteraceae","Asterales",0,0,0,3,0,NA
"Asarca","Orchidaceae","Asparagales",0,0,0,1,0,NA
"Asarina","Plantaginaceae","Lamiales",0,0,1,1,1,0
"Asarum","Aristolochiaceae","Piperales",1,0,9,121,10,0.1
"Ascaricida","Asteraceae","Asterales",0,0,0,1,0,NA
"Ascarina","Chloranthaceae","Chloranthales",6,0,0,12,6,1
"Aschersoniodoxa","Brassicaceae","Brassicales",0,0,0,4,0,NA
"Asciadium","Apiaceae","Apiales",0,0,0,1,0,NA
"Ascidieria","Orchidaceae","Asparagales",0,0,0,8,0,NA
"Ascidiogyne","Asteraceae","Asterales",0,0,0,2,0,NA
"Asclepias","Apocynaceae","Gentianales",1,0,11,215,12,0.0833333333333333
"Ascocentropsis","Orchidaceae","Asparagales",0,0,1,1,1,0
"Ascocentrum","Orchidaceae","Asparagales",0,0,1,13,1,0
"Ascochilopsis","Orchidaceae","Asparagales",0,0,0,2,0,NA
"Ascochilus","Orchidaceae","Asparagales",0,0,1,6,1,0
"Ascoglossum","Orchidaceae","Asparagales",0,0,0,1,0,NA
"Ascogrammitis","Polypodiaceae","Polypodiales",0,0,0,12,0,NA
"Ascolepis","Cyperaceae","Poales",0,0,3,23,3,0
"Ascotheca","Acanthaceae","Lamiales",0,0,0,1,0,NA
"Ascyrum","Hypericaceae","Malpighiales",0,0,0,1,0,NA
"Asepalum","Orobanchaceae","Lamiales",1,0,0,1,1,1
"Ashtonia","Phyllanthaceae","Malpighiales",0,0,0,2,0,NA
"Asimina","Annonaceae","Magnoliales",6,0,0,11,6,1
"Askellia","Asteraceae","Asterales",0,0,0,11,0,NA
"Asketanthera","Apocynaceae","Gentianales",0,0,0,5,0,NA
"Askidiosperma","Restionaceae","Poales",0,0,10,12,10,0
"Aspalathoides","Fabaceae","Fabales",0,0,0,1,0,NA
"Aspalathus","Fabaceae","Fabales",1,0,0,269,1,1
"Asparagus","Asparagaceae","Asparagales",9,0,24,211,33,0.272727272727273
"Aspasia","Orchidaceae","Asparagales",0,0,1,7,1,0
"Asperuginoides","Brassicaceae","Brassicales",0,0,0,1,0,NA
"Asperugo","Boraginaceae","UnknownOrder-Boraginaceae",0,0,1,1,1,0
"Asperula","Rubiaceae","Gentianales",0,0,13,194,13,0
"Asphalthium","Fabaceae","Fabales",0,0,0,1,0,NA
"Asphodeline","Xanthorrhoeaceae","Asparagales",0,0,3,17,3,0
"Asphodelus","Xanthorrhoeaceae","Asparagales",0,0,5,19,5,0
"Aspicarpa","Malpighiaceae","Malpighiales",2,0,0,10,2,1
"Aspidistra","Asparagaceae","Asparagales",0,0,5,98,5,0
"Aspidium","Tectariaceae","Polypodiales",0,0,0,33,0,NA
"Aspidocarya","Menispermaceae","Ranunculales",0,0,0,1,0,NA
"Aspidoglossum","Apocynaceae","Gentianales",0,0,1,36,1,0
"Aspidogyne","Orchidaceae","Asparagales",0,0,0,46,0,NA
"Aspidonepsis","Apocynaceae","Gentianales",0,0,0,5,0,NA
"Aspidopterys","Malpighiaceae","Malpighiales",2,0,0,25,2,1
"Aspidosperma","Apocynaceae","Gentianales",29,0,1,66,30,0.966666666666667
"Aspidostemon","Lauraceae","Laurales",3,0,0,29,3,1
"Aspidotis","Pteridaceae","Polypodiales",0,0,0,5,0,NA
"Aspilia","Asteraceae","Asterales",0,0,1,107,1,0
"Asplenidictyum","Aspleniaceae","Polypodiales",0,0,0,1,0,NA
"Aspleniopsis","Pteridaceae","Polypodiales",0,0,0,3,0,NA
"Asplenium","Aspleniaceae","Polypodiales",0,0,99,459,99,0
"Asplenosorus","Aspleniaceae","Polypodiales",0,0,0,4,0,NA
"Asplundia","Cyclanthaceae","Pandanales",0,0,1,100,1,0
"Asplundianthus","Asteraceae","Asterales",0,0,0,11,0,NA
"Asta","Brassicaceae","Brassicales",0,0,0,2,0,NA
"Astartea","Myrtaceae","Myrtales",6,0,0,9,6,1
"Astelia","Asteliaceae","Asparagales",0,0,12,26,12,0
"Astephanus","Apocynaceae","Gentianales",0,0,0,3,0,NA
"Aster","Asteraceae","Asterales",0,0,9,234,9,0
"Asteranthe","Annonaceae","Magnoliales",1,0,0,2,1,1
"Asteranthera","Gesneriaceae","Lamiales",0,0,1,1,1,0
"Asteranthos","Lecythidaceae","Ericales",1,0,0,1,1,1
"Asteridea","Asteraceae","Asterales",0,0,3,10,3,0
"Asteriscium","Apiaceae",NA,0,0,0,1,0,NA
"Asteriscium","Asteraceae","Asterales",0,0,1,8,1,0
"Asteriscus","Asteraceae","Asterales",3,3,2,10,5,0.6
"Asterogyne","Arecaceae","Arecales",5,0,0,5,5,1
"Asterohyptis","Lamiaceae","Lamiales",1,0,0,4,1,1
"Asterolasia","Rutaceae","Sapindales",0,0,0,16,0,NA
"Asteromyrtus","Myrtaceae","Myrtales",3,0,0,7,3,1
"Asteropeia","Asteropeiaceae","Caryophyllales",5,0,0,8,5,1
"Asteropsis","Asteraceae","Asterales",0,0,0,2,0,NA
"Asteropyrum","Ranunculaceae","Ranunculales",0,0,1,2,1,0
"Asterostemma","Apocynaceae","Gentianales",0,0,0,1,0,NA
"Asterostigma","Araceae","Alismatales",0,0,6,8,6,0
"Asterothamnus","Asteraceae","Asterales",0,0,0,7,0,NA
"Asterotrichion","Malvaceae","Malvales",1,0,0,1,1,1
"Asthenochloa","Poaceae","Poales",0,0,0,1,0,NA
"Astianthus","Bignoniaceae","Lamiales",1,0,0,1,1,1
"Astiella","Rubiaceae","Gentianales",0,0,0,1,0,NA
"Astilbe","Saxifragaceae","Saxifragales",0,0,5,25,5,0
"Astilboides","Saxifragaceae","Saxifragales",0,0,1,1,1,0
"Astiria","Malvaceae","Malvales",0,0,0,1,0,NA
"Astomaea","Apiaceae","Apiales",0,0,0,2,0,NA
"Astonia","Alismataceae","Alismatales",0,0,0,1,0,NA
"Astracantha","Fabaceae","Fabales",0,1,0,243,0,NA
"Astraea","Euphorbiaceae","Malpighiales",0,0,1,8,1,0
"Astragalus","Fabaceae","Fabales",1,1,37,2455,38,0.0263157894736842
"Astranthium","Asteraceae","Asterales",0,0,0,12,0,NA
"Astrantia","Apiaceae","Apiales",0,0,2,11,2,0
"Astrebla","Poaceae","Poales",0,0,3,4,3,0
"Astrephia","Caprifoliaceae","Dipsacales",0,0,0,1,0,NA
"Astridia","Aizoaceae","Caryophyllales",0,0,0,9,0,NA
"Astripomoea","Convolvulaceae","Solanales",0,1,0,4,0,NA
"Astrocaryum","Arecaceae","Arecales",15,0,0,38,15,1
"Astrocasia","Phyllanthaceae","Malpighiales",3,0,0,6,3,1
"Astrococcus","Euphorbiaceae","Malpighiales",1,0,0,1,1,1
"Astrodaucus","Apiaceae","Apiales",0,0,0,3,0,NA
"Astrolepis","Pteridaceae","Polypodiales",0,0,6,7,6,0
"Astroloba","Xanthorrhoeaceae","Asparagales",0,0,4,7,4,0
"Astroloma","Ericaceae","Ericales",2,0,0,20,2,1
"Astronia","Melastomataceae","Myrtales",0,0,0,1,0,NA
"Astronium","Anacardiaceae","Sapindales",7,0,0,12,7,1
"Astrophytum","Cactaceae","Caryophyllales",1,0,0,6,1,1
"Astrothalamus","Urticaceae","Rosales",0,0,0,1,0,NA
"Astrotheca","Clusiaceae","Malpighiales",0,0,0,1,0,NA
"Astrotricha","Araliaceae","Apiales",3,0,1,20,4,0.75
"Astrotrichilia","Meliaceae","Sapindales",2,0,0,12,2,1
"Astroworthia","Xanthorrhoeaceae","Asparagales",0,0,1,1,1,0
"Astus","Myrtaceae","Myrtales",1,0,0,4,1,1
"Astydamia","Apiaceae","Apiales",0,0,0,1,0,NA
"Astyposanthes","Fabaceae","Fabales",0,0,0,1,0,NA
"Asyneuma","Campanulaceae","Asterales",0,0,3,30,3,0
"Asystasia","Acanthaceae","Lamiales",0,0,1,54,1,0
"Asystasiella","Acanthaceae","Lamiales",0,0,0,4,0,NA
"Atalantia","Rutaceae","Sapindales",1,0,0,19,1,1
"Atalaya","Sapindaceae","Sapindales",7,0,0,15,7,1
"Atalopteris","Dryopteridaceae","Polypodiales",0,0,0,1,0,NA
"Atamisquea","Capparaceae","Brassicales",1,0,0,1,1,1
"Atelanthera","Brassicaceae","Brassicales",0,0,0,1,0,NA
"Ateleia","Fabaceae","Fabales",1,0,0,25,1,1
"Atelophragma","Fabaceae","Fabales",0,0,0,3,0,NA
"Atemnosiphon","Thymelaeaceae","Malvales",0,0,0,1,0,NA
"Athamanta","Apiaceae","Apiales",0,0,1,11,1,0
"Athanasia","Asteraceae","Asterales",0,0,2,39,2,0
"Athenaea","Solanaceae","Solanales",0,0,0,12,0,NA
"Atherandra","Apocynaceae","Gentianales",0,0,0,1,0,NA
"Atherolepis","Apocynaceae","Gentianales",0,0,0,2,0,NA
"Atherosperma","Atherospermataceae","Laurales",1,0,0,5,1,1
"Atherotoma","Asteraceae","Asterales",0,0,0,1,0,NA
"Athertonia","Proteaceae","Proteales",1,0,0,1,1,1
"Athrixia","Asteraceae","Asterales",0,0,0,15,0,NA
"Athroisma","Asteraceae","Asterales",0,0,1,11,1,0
"Athroostachys","Poaceae","Poales",0,0,0,1,0,NA
"Athrotaxis","Cupressaceae","Cupressales",2,0,0,3,2,1
"Athyana","Sapindaceae","Sapindales",1,0,0,1,1,1
"Athyriopsis","Athyriaceae","Polypodiales",0,0,0,13,0,NA
"Athyrium","Athyriaceae","Polypodiales",0,0,5,216,5,0
"Athysanus","Brassicaceae","Brassicales",0,0,0,1,0,NA
"Atkinsonia","Loranthaceae","Santalales",1,0,0,1,1,1
"Atossa","Fabaceae","Fabales",0,0,0,2,0,NA
"Atractantha","Poaceae","Poales",0,0,0,5,0,NA
"Atractocarpus","Rubiaceae","Gentianales",7,0,0,29,7,1
"Atractogyne","Rubiaceae","Gentianales",0,0,0,2,0,NA
"Atractylis","Asteraceae","Asterales",0,0,2,31,2,0
"Atractylodes","Asteraceae","Asterales",0,0,4,8,4,0
"Atraphaxis","Polygonaceae","Caryophyllales",2,0,0,32,2,1
"Atrichantha","Asteraceae","Asterales",0,0,0,1,0,NA
"Atrichodendron","Solanaceae","Solanales",0,0,0,1,0,NA
"Atrichoseris","Asteraceae","Asterales",0,0,0,1,0,NA
"Atriplex","Amaranthaceae","Caryophyllales",26,1,18,258,44,0.590909090909091
"Atropa","Solanaceae","Solanales",0,0,0,4,0,NA
"Atropanthe","Solanaceae","Solanales",0,0,0,2,0,NA
"Atroxima","Polygalaceae","Fabales",0,0,0,2,0,NA
"Attalea","Arecaceae","Arecales",23,0,0,72,23,1
"Attilaea","Anacardiaceae","Sapindales",0,0,0,1,0,NA
"Atuna","Chrysobalanaceae","Malpighiales",3,0,0,8,3,1
"Atylosia","Fabaceae","Fabales",0,0,0,1,0,NA
"Aubletiana","Euphorbiaceae","Malpighiales",1,0,0,2,1,1
"Aubregrinia","Sapotaceae","Ericales",1,0,0,1,1,1
"Aubrevillea","Fabaceae","Fabales",0,0,0,2,0,NA
"Aubrieta","Brassicaceae","Brassicales",0,0,2,17,2,0
"Aucklandia","Asteraceae","Asterales",0,0,0,1,0,NA
"Aucoumea","Burseraceae","Sapindales",1,0,0,1,1,1
"Aucuba","Garryaceae","Garryales",3,0,0,10,3,1
"Audouinia","Bruniaceae","Bruniales",1,0,0,5,1,1
"Auerodendron","Rhamnaceae","Rosales",0,0,0,10,0,NA
"Augea","Zygophyllaceae","Zygophyllales",0,0,1,1,1,0
"Augouardia","Fabaceae","Fabales",1,0,0,1,1,1
"Augusta","Rubiaceae","Gentianales",0,0,0,4,0,NA
"Aulacocalyx","Rubiaceae","Gentianales",1,0,0,11,1,1
"Aulacospermum","Apiaceae","Apiales",0,0,0,24,0,NA
"Aulandra","Sapotaceae","Ericales",0,0,0,3,0,NA
"Aulax","Proteaceae","Proteales",3,0,0,3,3,1
"Aulonemia","Poaceae","Poales",0,0,0,45,0,NA
"Aulosepalum","Orchidaceae","Asparagales",0,0,0,7,0,NA
"Aulotandra","Zingiberaceae","Zingiberales",0,0,0,6,0,NA
"Auranticarpa","Pittosporaceae","Apiales",1,0,0,6,1,1
"Aureliana","Solanaceae","Solanales",0,0,0,7,0,NA
"Aureolaria","Orobanchaceae","Lamiales",0,0,1,8,1,0
"Aurinia","Brassicaceae","Brassicales",0,0,0,10,0,NA
"Australina","Urticaceae","Rosales",0,0,0,2,0,NA
"Austrobaileya","Austrobaileyaceae","Austrobaileyales",1,0,0,1,1,1
"Austrobrickellia","Asteraceae","Asterales",0,0,0,3,0,NA
"Austrobryonia","Cucurbitaceae","Cucurbitales",0,0,0,4,0,NA
"Austrobuxus","Picrodendraceae","Malpighiales",9,0,0,22,9,1
"Austrocactus","Cactaceae","Caryophyllales",1,0,0,5,1,1
"Austrocedrus","Cupressaceae","Cupressales",1,0,0,1,1,1
"Austrochloris","Poaceae","Poales",0,0,0,1,0,NA
"Austrocritonia","Asteraceae","Asterales",0,0,0,4,0,NA
"Austrocylindropuntia","Cactaceae","Caryophyllales",2,0,0,11,2,1
"Austrocynoglossum","Boraginaceae","UnknownOrder-Boraginaceae",0,0,0,1,0,NA
"Austrodolichos","Fabaceae","Fabales",0,0,0,1,0,NA
"Austroeupatorium","Asteraceae","Asterales",0,0,0,16,0,NA
"Austrofestuca","Poaceae","Poales",0,0,1,4,1,0
"Austrolycopodium","Lycopodiaceae","Lycopodiales",0,0,3,3,3,0
"Austromatthaea","Monimiaceae","Laurales",1,0,0,1,1,1
"Austromuellera","Proteaceae","Proteales",2,0,0,2,2,1
"Austromyrtus","Myrtaceae","Myrtales",1,0,0,8,1,1
"Austropeucedanum","Apiaceae","Apiales",0,0,0,1,0,NA
"Austrosteenisia","Fabaceae","Fabales",2,0,0,3,2,1
"Austrosynotis","Asteraceae","Asterales",0,0,0,1,0,NA
"Austrotaxus","Taxaceae","Cupressales",1,0,0,1,1,1
"Autana","Podostemaceae","Malpighiales",0,0,0,1,0,NA
"Autranella","Sapotaceae","Ericales",1,0,0,1,1,1
"Autumnalia","Apiaceae","Apiales",0,0,0,2,0,NA
"Auxopus","Orchidaceae","Asparagales",0,0,0,4,0,NA
"Avellanita","Euphorbiaceae","Malpighiales",0,0,0,1,0,NA
"Avellara","Asteraceae","Asterales",0,0,0,1,0,NA
"Avena","Poaceae","Poales",0,0,7,22,7,0
"Averrhoa","Oxalidaceae","Oxalidales",2,0,0,5,2,1
"Averrhoidium","Sapindaceae","Sapindales",0,0,0,4,0,NA
"Avicennia","Acanthaceae","Lamiales",5,0,0,8,5,1
"Axinaea","Melastomataceae","Myrtales",0,0,0,26,0,NA
"Axinandra","Penaeaceae","Myrtales",2,0,0,4,2,1
"Axiniphyllum","Asteraceae","Asterales",0,0,0,6,0,NA
"Axonopus","Poaceae","Poales",0,0,4,89,4,0
"Axyris","Amaranthaceae","Caryophyllales",0,0,2,6,2,0
"Ayapana","Asteraceae","Asterales",0,0,0,17,0,NA
"Ayapanopsis","Asteraceae","Asterales",0,0,0,20,0,NA
"Ayenia","Malvaceae","Malvales",4,0,0,81,4,1
"Ayensua","Bromeliaceae","Poales",0,0,0,1,0,NA
"Aylacophora","Asteraceae","Asterales",0,0,0,1,0,NA
"Aynia","Asteraceae","Asterales",0,0,0,1,0,NA
"Azadirachta","Meliaceae","Sapindales",2,0,0,2,2,1
"Azalea","Ericaceae","Ericales",0,0,0,1,0,NA
"Azanza","Malvaceae","Malvales",1,0,0,2,1,1
"Azara","Salicaceae","Malpighiales",6,0,0,12,6,1
"Azilia","Apiaceae","Apiales",0,0,0,1,0,NA
"Azima","Salvadoraceae","Brassicales",2,0,0,3,2,1
"Azolla","Salviniaceae","Salviniales",0,0,5,7,5,0
"Azorella","Apiaceae","Apiales",0,0,6,29,6,0
"Azorina","Campanulaceae","Asterales",0,0,0,1,0,NA
"Aztecaster","Asteraceae","Asterales",0,0,0,2,0,NA
"Aztekium","Cactaceae","Caryophyllales",1,0,0,2,1,1
"Babiana","Iridaceae","Asparagales",0,0,18,93,18,0
"Babingtonia","Myrtaceae","Myrtales",2,0,0,2,2,1
"Baccaurea","Phyllanthaceae","Malpighiales",14,0,0,53,14,1
"Baccharidastrum","Asteraceae","Asterales",0,0,0,1,0,NA
"Baccharis","Asteraceae","Asterales",21,0,0,430,21,1
"Baccharoides","Asteraceae","Asterales",0,0,0,23,0,NA
"Bachmannia","Capparaceae","Brassicales",0,0,0,1,0,NA
"Backebergia","Cactaceae","Caryophyllales",0,0,0,1,0,NA
"Backhousia","Myrtaceae","Myrtales",5,0,0,9,5,1
"Bacopa","Plantaginaceae","Lamiales",0,0,2,68,2,0
"Bactris","Arecaceae","Arecales",61,0,0,79,61,1
"Badiera","Polygalaceae","Fabales",0,0,0,16,0,NA
"Badilloa","Asteraceae","Asterales",0,0,0,10,0,NA
"Badula","Primulaceae","Ericales",0,0,0,17,0,NA
"Badusa","Rubiaceae","Gentianales",0,0,0,3,0,NA
"Baeckea","Myrtaceae","Myrtales",20,0,0,47,20,1
"Baeolepis","Apocynaceae","Gentianales",0,0,0,1,0,NA
"Baeometra","Colchicaceae","Liliales",0,0,1,1,1,0
"Baeriopsis","Asteraceae","Asterales",0,0,0,1,0,NA
"Bafodeya","Chrysobalanaceae","Malpighiales",0,0,0,1,0,NA
"Bafutia","Asteraceae","Asterales",0,0,0,1,0,NA
"Bagassa","Moraceae","Rosales",1,0,0,1,1,1
"Baharuia","Apocynaceae","Gentianales",0,0,0,1,0,NA
"Bahia","Asteraceae","Asterales",1,0,1,13,2,0.5
"Bahianthus","Asteraceae","Asterales",0,0,0,1,0,NA
"Bahiella","Apocynaceae","Gentianales",0,0,0,2,0,NA
"Bahiopsis","Asteraceae","Asterales",4,0,0,10,4,1
"Baijiania","Cucurbitaceae","Cucurbitales",0,0,1,3,1,0
"Baikiaea","Fabaceae","Fabales",3,0,0,7,3,1
"Baileya","Asteraceae","Asterales",0,0,0,3,0,NA
"Baileyoxylon","Achariaceae","Malpighiales",0,0,0,1,0,NA
"Baillaudea","Convolvulaceae","Solanales",0,0,0,1,0,NA
"Baillonella","Sapotaceae","Ericales",1,0,0,1,1,1
"Baillonia","Verbenaceae","Lamiales",0,0,0,1,0,NA
"Baimashania","Brassicaceae","Brassicales",0,0,1,2,1,0
"Baissea","Apocynaceae","Gentianales",3,1,0,23,3,1
"Bajacalia","Asteraceae","Asterales",0,0,0,3,0,NA
"Bakerella","Loranthaceae","Santalales",0,0,0,16,0,NA
"Bakeridesia","Malvaceae","Malvales",0,0,0,26,0,NA
"Bakerolimon","Plumbaginaceae","Caryophyllales",0,0,0,1,0,NA
"Bakerophyton","Fabaceae","Fabales",0,0,0,2,0,NA
"Bakoa","Araceae","Alismatales",0,0,0,2,0,NA
"Balaka","Arecaceae","Arecales",1,0,0,9,1,1
"Balakata","Euphorbiaceae","Malpighiales",2,0,0,2,2,1
"Balanites","Zygophyllaceae","Zygophyllales",4,0,0,10,4,1
"Balanophora","Balanophoraceae","Santalales",0,0,1,19,1,0
"Balanops","Balanopaceae","Malpighiales",4,0,0,9,4,1
"Balantium","Dicksoniaceae","Cyatheales",0,0,0,3,0,NA
"Balaustion","Myrtaceae","Myrtales",1,0,0,1,1,1
"Balbisia","Vivianiaceae","Geraniales",1,0,0,10,1,1
"Baldellia","Alismataceae","Alismatales",0,0,2,3,2,0
"Balduina","Asteraceae","Asterales",0,0,0,3,0,NA
"Balfourodendron","Rutaceae","Sapindales",1,0,0,2,1,1
"Balgoya","Polygalaceae","Fabales",0,0,0,1,0,NA
"Baliospermum","Euphorbiaceae","Malpighiales",0,1,0,5,0,NA
"Balizia","Fabaceae","Fabales",1,0,0,2,1,1
"Ballantinia","Brassicaceae","Brassicales",0,0,0,1,0,NA
"Ballochia","Acanthaceae","Lamiales",0,0,0,3,0,NA
"Ballota","Lamiaceae","Lamiales",2,0,2,30,4,0.5
"Ballyanthus","Apocynaceae","Gentianales",0,0,0,1,0,NA
"Balmea","Rubiaceae","Gentianales",0,0,0,1,0,NA
"Baloghia","Euphorbiaceae","Malpighiales",10,0,0,15,10,1
"Balonga","Annonaceae","Magnoliales",0,0,0,1,0,NA
"Baloskion","Restionaceae","Poales",0,0,8,8,8,0
"Balsamocarpon","Fabaceae","Fabales",1,0,0,1,1,1
"Balsamocitrus","Rutaceae","Sapindales",0,0,0,3,0,NA
"Balsamorhiza","Asteraceae","Asterales",0,0,0,15,0,NA
"Balsas","Sapindaceae","Sapindales",0,0,0,1,0,NA
"Balthasaria","Pentaphylacaceae","Ericales",1,0,0,2,1,1
"Baltimora","Asteraceae","Asterales",0,0,1,2,1,0
"Bambekea","Cucurbitaceae","Cucurbitales",0,0,1,2,1,0
"Bambusa","Poaceae","Poales",8,0,0,137,8,1
"Bamiania","Plumbaginaceae","Caryophyllales",0,0,0,1,0,NA
"Bampsia","Linderniaceae","Lamiales",0,0,0,2,0,NA
"Banara","Salicaceae","Malpighiales",22,0,0,35,22,1
"Banisteriopsis","Malpighiaceae","Malpighiales",9,0,0,60,9,1
"Banksia","Proteaceae","Proteales",76,0,0,84,76,1
"Baolia","Amaranthaceae","Caryophyllales",0,0,0,1,0,NA
"Baphia","Fabaceae","Fabales",7,0,0,48,7,1
"Baphiastrum","Fabaceae","Fabales",0,0,0,8,0,NA
"Baphiopsis","Fabaceae","Fabales",0,0,0,1,0,NA
"Baptisia","Fabaceae","Fabales",0,0,2,28,2,0
"Baptorhachis","Poaceae","Poales",0,0,0,1,0,NA
"Barathranthus","Loranthaceae","Santalales",0,0,0,4,0,NA
"Barbacenia","Velloziaceae","Pandanales",0,0,0,109,0,NA
"Barbaceniopsis","Velloziaceae","Pandanales",0,0,0,4,0,NA
"Barbamine","Brassicaceae","Brassicales",0,0,0,3,0,NA
"Barbarea","Brassicaceae","Brassicales",0,0,3,29,3,0
"Barberetta","Haemodoraceae","Commelinales",0,0,0,1,0,NA
"Barbeuia","Barbeuiaceae","Caryophyllales",0,0,0,1,0,NA
"Barbeya","Barbeyaceae","Rosales",1,0,0,1,1,1
"Barbieria","Fabaceae","Fabales",0,0,0,1,0,NA
"Barbosella","Orchidaceae","Asparagales",0,0,1,19,1,0
"Barcella","Arecaceae","Arecales",1,0,0,1,1,1
"Barclaya","Nymphaeaceae","Nymphaeales",0,0,1,2,1,0
"Barjonia","Apocynaceae","Gentianales",0,0,0,7,0,NA
"Barkeria","Orchidaceae","Asparagales",0,0,2,17,2,0
"Barkerwebbia","Arecaceae","Arecales",0,0,0,1,0,NA
"Barkhausia","Asteraceae","Asterales",0,0,0,2,0,NA
"Barkleyanthus","Asteraceae","Asterales",0,0,0,1,0,NA
"Barklya","Fabaceae","Fabales",0,0,0,1,0,NA
"Barleria","Acanthaceae","Lamiales",2,0,0,253,2,1
"Barleriola","Acanthaceae","Lamiales",0,0,0,4,0,NA
"Barnadesia","Asteraceae","Asterales",1,0,0,20,1,1
"Barnardia","Asparagaceae","Asparagales",0,0,1,2,1,0
"Barnebya","Malpighiaceae","Malpighiales",1,0,0,2,1,1
"Barnebydendron","Fabaceae","Fabales",0,0,0,1,0,NA
"Barnebyella","Fabaceae","Fabales",0,0,0,1,0,NA
"Barneoudia","Ranunculaceae","Ranunculales",0,0,0,3,0,NA
"Barnhartia","Polygalaceae","Fabales",0,0,0,1,0,NA
"Barongia","Myrtaceae","Myrtales",1,0,0,1,1,1
"Baroniella","Apocynaceae","Gentianales",0,0,0,9,0,NA
"Barringtonia","Lecythidaceae","Ericales",16,0,0,64,16,1
"Barroetea","Asteraceae","Asterales",0,0,0,6,0,NA
"Barrosoa","Asteraceae","Asterales",0,0,0,12,0,NA
"Barteria","Passifloraceae","Malpighiales",2,0,0,4,2,1
"Barthea","Melastomataceae","Myrtales",0,0,0,1,0,NA
"Barthlottia","Scrophulariaceae","Lamiales",0,0,1,1,1,0
"Bartholina","Orchidaceae","Asparagales",0,0,1,2,1,0
"Bartholomaea","Salicaceae","Malpighiales",1,0,0,3,1,1
"Bartlettia","Asteraceae","Asterales",0,0,0,1,0,NA
"Bartlettina","Asteraceae","Asterales",0,0,0,38,0,NA
"Bartonia","Gentianaceae","Gentianales",0,0,1,3,1,0
"Bartsia","Orobanchaceae","Lamiales",0,0,1,50,1,0
"Baryxylum","Fabaceae","Fabales",0,0,0,1,0,NA
"Basananthe","Passifloraceae","Malpighiales",0,0,0,37,0,NA
"Basedowia","Asteraceae","Asterales",0,0,0,1,0,NA
"Basella","Basellaceae","Caryophyllales",0,1,0,5,0,NA
"Baseonema","Apocynaceae","Gentianales",0,0,0,1,0,NA
"Basilicum","Lamiaceae","Lamiales",0,0,0,1,0,NA
"Basiloxylon","Malvaceae","Malvales",0,0,0,1,0,NA
"Basiphyllaea","Orchidaceae","Asparagales",0,0,2,7,2,0
"Basisperma","Myrtaceae","Myrtales",0,0,0,1,0,NA
"Basistemon","Plantaginaceae","Lamiales",0,0,0,7,0,NA
"Baskervilla","Orchidaceae","Asparagales",0,0,0,10,0,NA
"Bassecoia","Caprifoliaceae","Dipsacales",0,0,0,2,0,NA
"Basselinia","Arecaceae","Arecales",2,0,0,14,2,1
"Bassia","Amaranthaceae","Caryophyllales",2,0,3,22,5,0.4
"Bastardia","Malvaceae","Malvales",0,0,0,7,0,NA
"Bastardiastrum","Malvaceae","Malvales",6,0,0,8,6,1
"Bastardiopsis","Malvaceae","Malvales",1,0,0,6,1,1
"Batatas","Convolvulaceae","Solanales",0,0,0,1,0,NA
"Batemannia","Orchidaceae","Asparagales",0,0,0,5,0,NA
"Batesanthus","Apocynaceae","Gentianales",0,0,0,4,0,NA
"Batesia","Fabaceae","Fabales",1,0,0,1,1,1
"Batesimalva","Malvaceae","Malvales",0,0,0,5,0,NA
"Bathiorhamnus","Rhamnaceae","Rosales",0,0,0,7,0,NA
"Bathmium","Tectariaceae","Polypodiales",0,0,0,2,0,NA
"Bathysa","Rubiaceae","Gentianales",0,0,0,10,0,NA
"Batidea","Rosaceae","Rosales",0,0,0,1,0,NA
"Batidophaca","Fabaceae","Fabales",0,0,0,1,0,NA
"Batis","Bataceae","Brassicales",1,0,0,2,1,1
"Batocarpus","Moraceae","Rosales",3,0,0,3,3,1
"Batopedina","Rubiaceae","Gentianales",0,1,0,3,0,NA
"Batopilasia","Asteraceae","Asterales",0,0,0,1,0,NA
"Batrachium","Ranunculaceae","Ranunculales",0,0,0,4,0,NA
"Baudouinia","Fabaceae","Fabales",0,0,0,6,0,NA
"Bauera","Cunoniaceae","Oxalidales",3,0,0,3,3,1
"Bauhinia","Fabaceae","Fabales",25,0,0,361,25,1
"Baumia","Orobanchaceae","Lamiales",0,0,0,1,0,NA
"Baxteria","Dasypogonaceae","UnknownOrder-Dasypogonaceae",0,0,0,1,0,NA
"Bayabusua","Cucurbitaceae","Cucurbitales",0,0,0,1,0,NA
"Baynesia","Apocynaceae","Gentianales",0,0,0,1,0,NA
"Bdallophytum","Cytinaceae","Malvales",0,0,1,3,1,0
"Beadlea","Orchidaceae","Asparagales",0,0,0,1,0,NA
"Beaucarnea","Asparagaceae","Asparagales",3,0,0,9,3,1
"Beaufortia","Myrtaceae","Myrtales",15,0,0,20,15,1
"Beaumontia","Apocynaceae","Gentianales",0,1,0,9,0,NA
"Beauprea","Proteaceae","Proteales",12,0,0,13,12,1
"Beaupreopsis","Proteaceae","Proteales",1,0,0,1,1,1
"Beautempsia","Capparaceae","Brassicales",0,0,0,1,0,NA
"Bebbia","Asteraceae","Asterales",1,0,0,2,1,1
"Beccariella","Sapotaceae","Ericales",5,0,0,17,5,1
"Beccarinda","Gesneriaceae","Lamiales",0,0,0,9,0,NA
"Beccariophoenix","Arecaceae","Arecales",1,0,0,2,1,1
"Bechium","Asteraceae","Asterales",0,0,0,2,0,NA
"Beckmannia","Poaceae","Poales",0,0,1,2,1,0
"Beckwithia","Ranunculaceae","Ranunculales",0,0,0,3,0,NA
"Beclardia","Orchidaceae","Asparagales",0,0,1,2,1,0
"Becquerelia","Cyperaceae","Poales",0,0,1,7,1,0
"Bedfordia","Asteraceae","Asterales",2,0,0,3,2,1
"Beesia","Ranunculaceae","Ranunculales",0,0,1,2,1,0
"Begonia","Begoniaceae","Cucurbitales",2,3,29,1600,31,0.0645161290322581
"Beguea","Sapindaceae","Sapindales",0,0,0,1,0,NA
"Behaimia","Fabaceae","Fabales",0,0,0,1,0,NA
"Behnia","Asparagaceae","Asparagales",0,0,0,1,0,NA
"Behuria","Melastomataceae","Myrtales",0,0,0,11,0,NA
"Beilschmiedia","Lauraceae","Laurales",63,0,0,287,63,1
"Beirnaertia","Menispermaceae","Ranunculales",1,0,0,1,1,1
"Beiselia","Burseraceae","Sapindales",1,0,0,1,1,1
"Bejaranoa","Asteraceae","Asterales",0,0,0,2,0,NA
"Bejaria","Ericaceae","Ericales",2,0,0,15,2,1
"Belairia","Fabaceae","Fabales",0,0,0,2,0,NA
"Belemia","Nyctaginaceae","Caryophyllales",0,0,1,1,1,0
"Belencita","Capparaceae","Brassicales",0,0,0,1,0,NA
"Bellendena","Proteaceae","Proteales",1,0,0,1,1,1
"Bellevalia","Asparagaceae","Asparagales",0,0,6,65,6,0
"Bellida","Asteraceae","Asterales",0,0,1,1,1,0
"Bellidastrum","Asteraceae","Asterales",0,0,0,1,0,NA
"Bellis","Asteraceae","Asterales",0,0,1,14,1,0
"Bellium","Asteraceae","Asterales",0,0,0,4,0,NA
"Bellizinca","Rubiaceae","Gentianales",0,0,0,1,0,NA
"Belloa","Asteraceae","Asterales",0,0,0,11,0,NA
"Bellonia","Gesneriaceae","Lamiales",0,0,0,2,0,NA
"Bellucia","Melastomataceae","Myrtales",3,0,0,17,3,1
"Belmontia","Gentianaceae","Gentianales",0,0,0,1,0,NA
"Beloglottis","Orchidaceae","Asparagales",0,0,0,7,0,NA
"Belonanthus","Caprifoliaceae","Dipsacales",0,0,0,6,0,NA
"Belonophora","Rubiaceae","Gentianales",0,0,0,5,0,NA
"Beloperone","Acanthaceae","Lamiales",0,0,0,1,0,NA
"Belosynapsis","Commelinaceae","Commelinales",0,0,1,6,1,0
"Belvisia","Polypodiaceae","Polypodiales",0,0,0,9,0,NA
"Bembicia","Salicaceae","Malpighiales",1,0,0,1,1,1
"Benguellia","Lamiaceae","Lamiales",0,0,0,1,0,NA
"Benincasa","Cucurbitaceae","Cucurbitales",0,0,1,1,1,0
"Benitoa","Asteraceae","Asterales",0,0,0,1,0,NA
"Benjaminia","Plantaginaceae","Lamiales",0,0,0,1,0,NA
"Benkara","Rubiaceae","Gentianales",0,0,0,20,0,NA
"Bennettiodendron","Salicaceae","Malpighiales",1,0,0,7,1,1
"Benoicanthus","Acanthaceae","Lamiales",0,0,0,2,0,NA
"Benoistia","Euphorbiaceae","Malpighiales",0,0,0,3,0,NA
"Bensoniella","Saxifragaceae","Saxifragales",0,0,1,1,1,0
"Bensteinia","Orchidaceae","Asparagales",0,0,0,1,0,NA
"Benthamia","Boraginaceae",NA,0,0,0,4,0,NA
"Benthamia","Orchidaceae","Asparagales",0,0,0,29,0,NA
"Benthamiella","Solanaceae","Solanales",0,0,0,13,0,NA
"Benthamina","Loranthaceae","Santalales",1,0,0,1,1,1
"Bentinckia","Arecaceae","Arecales",1,0,0,2,1,1
"Bentleya","Pittosporaceae","Apiales",1,0,0,1,1,1
"Benzingia","Orchidaceae","Asparagales",0,0,6,9,6,0
"Benzonia","Rubiaceae","Gentianales",0,0,0,1,0,NA
"Bequaertia","Celastraceae","Celastrales",0,0,0,1,0,NA
"Berardia","Asteraceae","Asterales",0,0,0,1,0,NA
"Berberidopsis","Berberidopsidaceae","Berberidopsidales",1,0,0,2,1,1
"Berberis","Berberidaceae","Ranunculales",20,0,0,580,20,1
"Berchemia","Rhamnaceae","Rosales",4,0,0,48,4,1
"Berchemiella","Rhamnaceae","Rosales",1,0,0,4,1,1
"Berendtiella","Phrymaceae","Lamiales",0,0,0,3,0,NA
"Berenice","Campanulaceae","Asterales",0,0,0,1,0,NA
"Bergenia","Saxifragaceae","Saxifragales",0,0,1,10,1,0
"Bergeranthus","Aizoaceae","Caryophyllales",0,0,0,10,0,NA
"Bergerocactus","Cactaceae","Caryophyllales",0,0,0,1,0,NA
"Bergeronia","Fabaceae","Fabales",0,0,0,1,0,NA
"Berghesia","Rubiaceae","Gentianales",0,0,0,1,0,NA
"Bergia","Elatinaceae","Malpighiales",1,0,2,29,3,0.333333333333333
"Berhautia","Loranthaceae","Santalales",0,0,0,1,0,NA
"Berkheya","Asteraceae","Asterales",0,0,3,80,3,0
"Berlandiera","Asteraceae","Asterales",0,0,0,8,0,NA
"Berlinia","Fabaceae","Fabales",5,0,0,18,5,1
"Berlinianche","Apodanthaceae","UnknownOrder-Apodanthaceae",0,0,2,2,2,0
"Bernardia","Euphorbiaceae","Malpighiales",3,0,0,73,3,1
"Berneuxia","Diapensiaceae","Ericales",0,0,1,1,1,0
"Bernoullia","Malvaceae","Malvales",1,0,0,3,1,1
"Berresfordia","Aizoaceae","Caryophyllales",0,0,0,1,0,NA
"Berroa","Asteraceae","Asterales",0,0,0,1,0,NA
"Berrya","Malvaceae","Malvales",2,0,0,6,2,1
"Bersama","Melianthaceae","Geraniales",3,0,0,8,3,1
"Berteroa","Brassicaceae","Brassicales",0,0,1,5,1,0
"Berteroella","Brassicaceae","Brassicales",0,0,0,1,0,NA
"Bertholletia","Lecythidaceae","Ericales",1,0,0,1,1,1
"Bertiera","Rubiaceae","Gentianales",2,0,0,57,2,1
"Bertolonia","Melastomataceae","Myrtales",0,0,2,9,2,0
"Bertya","Euphorbiaceae","Malpighiales",6,0,0,28,6,1
"Berula","Apiaceae","Apiales",0,0,1,5,1,0
"Berylsimpsonia","Asteraceae","Asterales",0,0,0,2,0,NA
"Berzelia","Bruniaceae","Bruniales",10,0,0,16,10,1
"Beschorneria","Asparagaceae","Asparagales",0,0,0,8,0,NA
"Besleria","Gesneriaceae","Lamiales",3,0,1,167,4,0.75
"Bessera","Asparagaceae","Asparagales",0,0,2,3,2,0
"Beta","Amaranthaceae","Caryophyllales",0,0,4,9,4,0
"Bethencourtia","Asteraceae","Asterales",0,0,0,1,0,NA
"Betonica","Lamiaceae","Lamiales",0,0,0,1,0,NA
"Betula","Betulaceae","Fagales",38,0,0,119,38,1
"Bewsia","Poaceae","Poales",0,0,0,1,0,NA
"Beyeria","Euphorbiaceae","Malpighiales",4,0,0,24,4,1
"Bhesa","Centroplacaceae","Malpighiales",2,0,0,7,2,1
"Bhidea","Poaceae","Poales",0,0,0,3,0,NA
"Bhutanthera","Orchidaceae","Asparagales",0,0,0,5,0,NA
"Bia","Euphorbiaceae","Malpighiales",0,0,0,5,0,NA
"Biarum","Araceae","Alismatales",0,0,0,21,0,NA
"Bicuiba","Myristicaceae","Magnoliales",1,0,0,1,1,1
"Bidens","Asteraceae","Asterales",2,0,13,249,15,0.133333333333333
"Biebersteinia","Biebersteiniaceae","Sapindales",0,0,1,5,1,0
"Bienertia","Amaranthaceae","Caryophyllales",0,0,1,3,1,0
"Biermannia","Orchidaceae","Asparagales",0,0,0,11,0,NA
"Bifora","Apiaceae","Apiales",0,0,2,3,2,0
"Bifrenaria","Orchidaceae","Asparagales",0,0,5,22,5,0
"Bigelowia","Asteraceae","Asterales",0,0,0,5,0,NA
"Bignonia","Bignoniaceae","Lamiales",6,0,0,27,6,1
"Bijlia","Aizoaceae","Caryophyllales",0,0,0,3,0,NA
"Bikinia","Fabaceae","Fabales",0,0,0,10,0,NA
"Bikkia","Rubiaceae","Gentianales",0,0,0,10,0,NA
"Bilacunaria","Apiaceae","Apiales",0,0,0,4,0,NA
"Billardiera","Pittosporaceae","Apiales",14,0,0,24,14,1
"Billbergia","Bromeliaceae","Poales",0,0,4,66,4,0
"Billburttia","Apiaceae","Apiales",0,0,0,2,0,NA
"Billia","Sapindaceae","Sapindales",2,0,0,2,2,1
"Billieturnera","Malvaceae","Malvales",0,0,0,1,0,NA
"Binaria","Fabaceae","Fabales",0,0,0,7,0,NA
"Biondia","Apocynaceae","Gentianales",0,0,0,13,0,NA
"Bionia","Fabaceae","Fabales",0,0,0,4,0,NA
"Biophytum","Oxalidaceae","Oxalidales",0,0,0,83,0,NA
"Biotia","Asteraceae","Asterales",0,0,0,1,0,NA
"Bipinnula","Orchidaceae","Asparagales",0,0,0,10,0,NA
"Bisboeckelera","Cyperaceae","Poales",0,0,0,4,0,NA
"Bischofia","Phyllanthaceae","Malpighiales",2,0,0,2,2,1
"Biscutella","Brassicaceae","Brassicales",0,0,2,51,2,0
"Bisglaziovia","Melastomataceae","Myrtales",0,0,0,1,0,NA
"Bisgoeppertia","Gentianaceae","Gentianales",0,0,0,3,0,NA
"Bishopalea","Asteraceae","Asterales",0,0,0,1,0,NA
"Bishopanthus","Asteraceae","Asterales",0,0,0,1,0,NA
"Bishopiella","Asteraceae","Asterales",0,0,0,1,0,NA
"Bishovia","Asteraceae","Asterales",0,0,0,2,0,NA
"Bismarckia","Arecaceae","Arecales",1,0,0,1,1,1
"Bistorta","Polygonaceae","Caryophyllales",0,0,0,1,0,NA
"Biswarea","Cucurbitaceae","Cucurbitales",0,0,0,1,0,NA
"Bituminaria","Fabaceae","Fabales",0,0,0,4,0,NA
"Bivinia","Salicaceae","Malpighiales",0,0,0,1,0,NA
"Bivonaea","Brassicaceae","Brassicales",0,0,0,1,0,NA
"Bixa","Bixaceae","Malvales",5,0,0,5,5,1
"Bizonula","Sapindaceae","Sapindales",0,0,0,1,0,NA
"Blachia","Euphorbiaceae","Malpighiales",1,0,0,11,1,1
"Blackallia","Rhamnaceae","Rosales",0,0,0,1,0,NA
"Blackstonia","Gentianaceae","Gentianales",0,0,1,4,1,0
"Blainvillea","Asteraceae","Asterales",0,0,1,10,1,0
"Blakea","Melastomataceae","Myrtales",4,0,0,81,4,1
"Blakeanthus","Asteraceae","Asterales",0,0,0,2,0,NA
"Blakiella","Asteraceae","Asterales",0,0,0,1,0,NA
"Blanchetia","Asteraceae","Asterales",0,0,0,1,0,NA
"Blanchetiastrum","Malvaceae","Malvales",0,0,0,1,0,NA
"Blanchetiodendron","Fabaceae","Fabales",0,0,0,1,0,NA
"Blancoa","Haemodoraceae","Commelinales",0,0,0,1,0,NA
"Blandfordia","Blandfordiaceae","Asparagales",0,0,4,4,4,0
"Blastemanthus","Ochnaceae","Malpighiales",0,0,0,2,0,NA
"Blastus","Melastomataceae","Myrtales",1,0,0,9,1,1
"Bleasdalea","Proteaceae","Proteales",3,0,0,5,3,1
"Blechnidium","Blechnaceae","Polypodiales",0,0,0,1,0,NA
"Blechnopsis","Blechnaceae","Polypodiales",0,0,0,2,0,NA
"Blechnum","Blechnaceae","Polypodiales",0,0,14,142,14,0
"Blechum","Acanthaceae","Lamiales",0,0,2,13,2,0
"Bleekrodea","Moraceae","Rosales",1,0,0,4,1,1
"Blennodia","Brassicaceae","Brassicales",0,0,0,2,0,NA
"Blennosperma","Asteraceae","Asterales",0,0,1,4,1,0
"Blennospora","Asteraceae","Asterales",0,0,1,3,1,0
"Blepharandra","Malpighiaceae","Malpighiales",1,0,0,6,1,1
"Blepharidachne","Poaceae","Poales",0,0,0,4,0,NA
"Blepharidium","Rubiaceae","Gentianales",1,0,0,1,1,1
"Blephariglottis","Orchidaceae","Asparagales",0,0,0,1,0,NA
"Blepharipappus","Asteraceae","Asterales",0,0,0,3,0,NA
"Blepharis","Acanthaceae","Lamiales",0,0,0,126,0,NA
"Blepharispermum","Asteraceae","Asterales",1,0,0,16,1,1
"Blepharistemma","Rhizophoraceae","Malpighiales",1,0,0,1,1,1
"Blepharizonia","Asteraceae","Asterales",0,0,0,2,0,NA
"Blepharocalyx","Myrtaceae","Myrtales",2,0,0,4,2,1
"Blepharocarya","Anacardiaceae","Sapindales",2,0,0,2,2,1
"Blepharodon","Apocynaceae","Gentianales",0,0,0,29,0,NA
"Blepharoneuron","Poaceae","Poales",0,0,0,2,0,NA
"Blephilia","Lamiaceae","Lamiales",0,0,2,3,2,0
"Bletia","Orchidaceae","Asparagales",0,0,3,40,3,0
"Bletilla","Orchidaceae","Asparagales",0,0,1,5,1,0
"Blighia","Sapindaceae","Sapindales",3,0,0,6,3,1
"Blighiopsis","Sapindaceae","Sapindales",0,0,0,1,0,NA
"Blinkworthia","Convolvulaceae","Solanales",0,0,0,1,0,NA
"Blomia","Sapindaceae","Sapindales",0,0,0,1,0,NA
"Bloomeria","Asparagaceae","Asparagales",0,0,1,3,1,0
"Blossfeldia","Cactaceae","Caryophyllales",1,0,0,1,1,1
"Blotiella","Dennstaedtiaceae","Polypodiales",0,0,0,12,0,NA
"Blumea","Asteraceae","Asterales",0,0,6,107,6,0
"Blumenbachia","Loasaceae","Cornales",0,0,2,8,2,0
"Blumeodendron","Euphorbiaceae","Malpighiales",3,0,0,5,3,1
"Blumeopsis","Asteraceae","Asterales",0,0,0,1,0,NA
"Blutaparon","Amaranthaceae","Caryophyllales",0,0,1,4,1,0
"Blysmus","Cyperaceae","Poales",0,0,3,4,3,0
"Blyttia","Apocynaceae","Gentianales",0,0,0,2,0,NA
"Blyxa","Hydrocharitaceae","Alismatales",0,0,3,12,3,0
"Bobartia","Iridaceae","Asparagales",0,0,15,15,15,0
"Bobea","Rubiaceae","Gentianales",1,0,0,6,1,1
"Bobgunnia","Fabaceae","Fabales",2,0,0,2,2,1
"Bocagea","Annonaceae","Magnoliales",0,0,0,2,0,NA
"Bocageopsis","Annonaceae","Magnoliales",2,0,0,4,2,1
"Bocconia","Papaveraceae","Ranunculales",4,0,0,11,4,1
"Bocoa","Fabaceae","Fabales",3,0,0,8,3,1
"Bocquillonia","Euphorbiaceae","Malpighiales",5,0,0,14,5,1
"Boea","Gesneriaceae","Lamiales",0,0,1,17,1,0
"Boeberastrum","Asteraceae","Asterales",0,0,0,3,0,NA
"Boeberoides","Asteraceae","Asterales",0,0,0,1,0,NA
"Boechera","Brassicaceae","Brassicales",0,0,2,110,2,0
"Boehmeria","Urticaceae","Rosales",5,2,1,96,6,0.833333333333333
"Boeica","Gesneriaceae","Lamiales",0,0,0,14,0,NA
"Boelckea","Scrophulariaceae","Lamiales",0,0,0,1,0,NA
"Boenninghausenia","Rutaceae","Sapindales",0,0,0,2,0,NA
"Boerhavia","Nyctaginaceae","Caryophyllales",1,0,13,105,14,0.0714285714285714
"Boerlagella","Sapotaceae","Ericales",0,0,0,1,0,NA
"Boesenbergia","Zingiberaceae","Zingiberales",0,0,0,68,0,NA
"Bognera","Araceae","Alismatales",0,0,1,1,1,0
"Bogoria","Orchidaceae","Asparagales",0,0,0,4,0,NA
"Boholia","Rubiaceae","Gentianales",0,0,0,1,0,NA
"Boisduvalia","Onagraceae","Myrtales",0,0,0,6,0,NA
"Boissiera","Poaceae","Poales",0,0,0,1,0,NA
"Bolandia","Asteraceae","Asterales",0,0,0,2,0,NA
"Bolandra","Saxifragaceae","Saxifragales",0,0,1,2,1,0
"Bolanosa","Asteraceae","Asterales",0,0,0,1,0,NA
"Bolanthus","Caryophyllaceae","Caryophyllales",0,0,0,18,0,NA
"Bolax","Apiaceae","Apiales",0,0,1,2,1,0
"Bolbitis","Dryopteridaceae","Polypodiales",0,0,4,56,4,0
"Bolbosaponaria","Caryophyllaceae","Caryophyllales",0,0,0,6,0,NA
"Bolboschoenoplectus","Cyperaceae","Poales",0,0,0,1,0,NA
"Bolboschoenus","Cyperaceae","Poales",0,0,8,16,8,0
"Bolbostemma","Cucurbitaceae","Cucurbitales",0,0,1,2,1,0
"Boleum","Brassicaceae","Brassicales",0,0,0,1,0,NA
"Bolocephalus","Asteraceae","Asterales",0,0,0,1,0,NA
"Boltonia","Asteraceae","Asterales",0,0,0,6,0,NA
"Bolusanthus","Fabaceae","Fabales",1,0,0,1,1,1
"Bolusia","Fabaceae","Fabales",0,0,0,6,0,NA
"Bolusiella","Orchidaceae","Asparagales",0,0,2,6,2,0
"Bomarea","Alstroemeriaceae","Liliales",0,0,9,124,9,0
"Bombax","Malvaceae","Malvales",6,0,0,9,6,1
"Bombycidendron","Malvaceae","Malvales",0,0,0,2,0,NA
"Bombycilaena","Asteraceae","Asterales",0,0,0,2,0,NA
"Bommeria","Pteridaceae","Polypodiales",0,0,0,5,0,NA
"Bonamia","Convolvulaceae","Solanales",1,2,0,46,1,1
"Bonania","Euphorbiaceae","Malpighiales",1,0,0,7,1,1
"Bonannia","Apiaceae","Apiales",0,0,0,1,0,NA
"Bonanox","Convolvulaceae","Solanales",0,0,0,1,0,NA
"Bonatea","Orchidaceae","Asparagales",0,0,1,14,1,0
"Bonaveria","Fabaceae","Fabales",0,0,0,1,0,NA
"Bonellia","Primulaceae","Ericales",3,0,0,20,3,1
"Bonetiella","Anacardiaceae","Sapindales",1,0,0,1,1,1
"Bongardia","Berberidaceae","Ranunculales",0,0,1,2,1,0
"Bonia","Poaceae","Poales",0,0,0,5,0,NA
"Boniniella","Aspleniaceae","Polypodiales",0,0,0,1,0,NA
"Boniodendron","Sapindaceae","Sapindales",1,0,0,2,1,1
"Bonnetia","Bonnetiaceae","Malpighiales",5,0,0,33,5,1
"Bonplandia","Polemoniaceae","Ericales",0,0,0,2,0,NA
"Bontia","Scrophulariaceae","Lamiales",0,0,1,1,1,0
"Bonyunia","Loganiaceae","Gentianales",1,0,0,10,1,1
"Boophone","Amaryllidaceae","Asparagales",0,0,1,2,1,0
"Boopis","Calyceraceae","Asterales",0,0,2,18,2,0
"Boquila","Lardizabalaceae","Ranunculales",1,0,0,1,1,1
"Borago","Boraginaceae","UnknownOrder-Boraginaceae",0,0,1,5,1,0
"Borassodendron","Arecaceae","Arecales",1,0,0,2,1,1
"Borassus","Arecaceae","Arecales",1,0,0,5,1,1
"Borbonia","Fabaceae","Fabales",0,0,0,1,0,NA
"Bordasia","Malvaceae","Malvales",0,0,0,1,0,NA
"Boreava","Brassicaceae","Brassicales",0,0,0,2,0,NA
"Borismene","Menispermaceae","Ranunculales",0,1,0,1,0,NA
"Borneacanthus","Acanthaceae","Lamiales",0,0,0,6,0,NA
"Borneodendron","Euphorbiaceae","Malpighiales",1,0,0,1,1,1
"Borneosicyos","Cucurbitaceae","Cucurbitales",0,0,0,1,0,NA
"Bornmuellera","Brassicaceae","Brassicales",0,0,0,8,0,NA
"Borodinia","Brassicaceae","Brassicales",0,0,0,1,0,NA
"Boronella","Rutaceae","Sapindales",0,0,0,4,0,NA
"Boronia","Rutaceae","Sapindales",5,0,0,149,5,1
"Borrichia","Asteraceae","Asterales",1,0,0,4,1,1
"Borthwickia","Capparaceae","Brassicales",0,0,0,1,0,NA
"Borya","Boryaceae","Asparagales",2,0,0,11,2,1
"Boschia","Malvaceae","Malvales",1,0,0,6,1,1
"Boschniakia","Orobanchaceae","Lamiales",0,0,0,3,0,NA
"Boscia","Capparaceae","Brassicales",4,0,0,32,4,1
"Bosea","Amaranthaceae","Caryophyllales",1,0,0,3,1,1
"Bosistoa","Rutaceae","Sapindales",2,0,0,7,2,1
"Bosqueiopsis","Moraceae","Rosales",0,0,0,1,0,NA
"Bossera","Euphorbiaceae","Malpighiales",0,0,0,1,0,NA
"Bossiaea","Fabaceae","Fabales",6,0,0,48,6,1
"Bostrychanthera","Lamiaceae","Lamiales",0,0,0,2,0,NA
"Boswellia","Burseraceae","Sapindales",3,0,0,28,3,1
"Bothriochloa","Poaceae","Poales",0,0,6,34,6,0
"Bothriocline","Asteraceae","Asterales",0,0,0,61,0,NA
"Bothriospermum","Boraginaceae","UnknownOrder-Boraginaceae",0,0,3,7,3,0
"Bothriospora","Rubiaceae","Gentianales",1,0,0,1,1,1
"Botor","Fabaceae","Fabales",0,0,0,1,0,NA
"Botryarrhena","Rubiaceae","Gentianales",1,0,0,2,1,1
"Botrychium","Ophioglossaceae","Ophioglossales",0,0,7,56,7,0
"Botryophora","Euphorbiaceae","Malpighiales",1,0,0,1,1,1
"Botrypus","Ophioglossaceae","Ophioglossales",0,0,0,6,0,NA
"Botschantzevia","Brassicaceae","Brassicales",0,0,0,1,0,NA
"Bottegoa","Sapindaceae","Sapindales",1,0,0,1,1,1
"Bouchardatia","Rutaceae","Sapindales",0,0,0,2,0,NA
"Bouchea","Verbenaceae","Lamiales",0,0,0,18,0,NA
"Bouchetia","Solanaceae","Solanales",0,0,0,4,0,NA
"Bouea","Anacardiaceae","Sapindales",2,0,0,3,2,1
"Bougainvillea","Nyctaginaceae","Caryophyllales",4,0,0,18,4,1
"Bougueria","Plantaginaceae","Lamiales",0,0,0,1,0,NA
"Bournea","Gesneriaceae","Lamiales",0,0,0,2,0,NA
"Bourreria","Boraginaceae","UnknownOrder-Boraginaceae",6,0,0,56,6,1
"Bousigonia","Apocynaceae","Gentianales",0,0,0,3,0,NA
"Bouteloua","Poaceae","Poales",0,0,2,28,2,0
"Boutiquea","Annonaceae","Magnoliales",0,0,0,1,0,NA
"Boutonia","Acanthaceae","Lamiales",0,0,0,1,0,NA
"Bouvardia","Rubiaceae","Gentianales",2,0,0,52,2,1
"Bouzetia","Rutaceae","Sapindales",0,0,0,1,0,NA
"Bowdichia","Fabaceae","Fabales",2,0,0,2,2,1
"Bowenia","Zamiaceae","Cycadales",1,0,0,2,1,1
"Bowiea","Asparagaceae","Asparagales",0,0,1,1,1,0
"Bowkeria","Stilbaceae","Lamiales",1,0,0,3,1,1
"Bowlesia","Apiaceae","Apiales",0,0,2,16,2,0
"Bowringia","Fabaceae","Fabales",0,0,0,2,0,NA
"Boyania","Melastomataceae","Myrtales",0,0,0,1,0,NA
"Boykinia","Saxifragaceae","Saxifragales",0,0,5,10,5,0
"Brabejum","Proteaceae","Proteales",1,0,0,1,1,1
"Brachanthemum","Asteraceae","Asterales",0,0,0,10,0,NA
"Brachiaria","Poaceae","Poales",0,0,12,125,12,0
"Brachionidium","Orchidaceae","Asparagales",0,0,1,75,1,0
"Brachionostylum","Asteraceae","Asterales",0,0,0,1,0,NA
"Brachistus","Solanaceae","Solanales",0,0,0,6,0,NA
"Brachyachne","Poaceae","Poales",0,0,0,10,0,NA
"Brachyactis","Asteraceae","Asterales",0,0,0,2,0,NA
"Brachybotrys","Boraginaceae","UnknownOrder-Boraginaceae",0,0,0,1,0,NA
"Brachycarpaea","Brassicaceae","Brassicales",0,0,0,1,0,NA
"Brachycereus","Cactaceae","Caryophyllales",0,0,0,1,0,NA
"Brachychiton","Malvaceae","Malvales",9,0,0,38,9,1
"Brachychloa","Poaceae","Poales",0,0,0,2,0,NA
"Brachyclados","Asteraceae","Asterales",1,0,0,3,1,1
"Brachycome","Asteraceae","Asterales",0,0,0,1,0,NA
"Brachycorythis","Orchidaceae","Asparagales",0,0,0,36,0,NA
"Brachycylix","Fabaceae","Fabales",1,0,0,1,1,1
"Brachyelytrum","Poaceae","Poales",0,0,1,3,1,0
"Brachyglottis","Asteraceae","Asterales",4,0,0,38,4,1
"Brachylaena","Asteraceae","Asterales",4,0,0,14,4,1
"Brachylobus","Brassicaceae","Brassicales",0,0,0,1,0,NA
"Brachyloma","Ericaceae","Ericales",2,0,0,11,2,1
"Brachylophon","Malpighiaceae","Malpighiales",0,0,0,2,0,NA
"Brachynema","Olacaceae","Santalales",1,0,0,2,1,1
"Brachyotum","Melastomataceae","Myrtales",0,0,0,54,0,NA
"Brachypeza","Orchidaceae","Asparagales",0,0,2,7,2,0
"Brachyphragma","Fabaceae","Fabales",0,0,0,1,0,NA
"Brachypodium","Poaceae","Poales",0,0,5,22,5,0
"Brachyscias","Apiaceae","Apiales",0,0,0,1,0,NA
"Brachyscome","Asteraceae","Asterales",0,0,6,78,6,0
"Brachysema","Fabaceae","Fabales",0,0,0,11,0,NA
"Brachysiphon","Penaeaceae","Myrtales",5,0,0,5,5,1
"Brachysola","Lamiaceae","Lamiales",0,0,0,2,0,NA
"Brachystegia","Fabaceae","Fabales",16,0,0,35,16,1
"Brachystele","Orchidaceae","Asparagales",0,0,0,22,0,NA
"Brachystelma","Apocynaceae","Gentianales",0,0,1,156,1,0
"Brachystemma","Caryophyllaceae","Caryophyllales",0,0,0,1,0,NA
"Brachystephanus","Acanthaceae","Lamiales",0,0,0,22,0,NA
"Brachythrix","Asteraceae","Asterales",0,0,0,7,0,NA
"Brachytome","Rubiaceae","Gentianales",0,0,0,8,0,NA
"Bracisepalum","Orchidaceae","Asparagales",0,0,1,2,1,0
"Brackenridgea","Ochnaceae","Malpighiales",2,0,0,10,2,1
"Bradburia","Asteraceae","Asterales",0,0,0,2,0,NA
"Bradburya","Fabaceae","Fabales",0,0,0,4,0,NA
"Bradea","Rubiaceae","Gentianales",0,0,0,5,0,NA
"Bradlea","Fabaceae","Fabales",0,0,0,2,0,NA
"Braemia","Orchidaceae","Asparagales",0,0,1,1,1,0
"Bragaia","Cactaceae","Caryophyllales",0,0,0,1,0,NA
"Brahea","Arecaceae","Arecales",9,0,0,11,9,1
"Brainea","Blechnaceae","Polypodiales",0,0,0,1,0,NA
"Brandegea","Cucurbitaceae","Cucurbitales",0,0,1,1,1,0
"Brandella","Boraginaceae","UnknownOrder-Boraginaceae",0,0,0,1,0,NA
"Brandisia","Paulowniaceae","Lamiales",1,0,0,11,1,1
"Brandzeia","Fabaceae","Fabales",0,0,0,1,0,NA
"Brasenia","Cabombaceae","Nymphaeales",0,0,1,1,1,0
"Brasilettia","Fabaceae","Fabales",0,0,0,3,0,NA
"Brasilia","Asteraceae","Asterales",0,0,0,1,0,NA
"Brasilicactus","Cactaceae","Caryophyllales",0,0,0,1,0,NA
"Brasilicereus","Cactaceae","Caryophyllales",0,0,0,2,0,NA
"Brasiliocroton","Euphorbiaceae","Malpighiales",1,0,0,1,1,1
"Brasiliopuntia","Cactaceae","Caryophyllales",1,0,0,1,1,1
"Brasiliorchis","Orchidaceae","Asparagales",0,0,7,15,7,0
"Brassaiopsis","Araliaceae","Apiales",13,0,0,48,13,1
"Brassavola","Orchidaceae","Asparagales",0,0,4,23,4,0
"Brassia","Orchidaceae","Asparagales",0,0,3,63,3,0
"Brassiantha","Celastraceae","Celastrales",0,0,0,1,0,NA
"Brassica","Brassicaceae","Brassicales",0,0,11,39,11,0
"Brassiophoenix","Arecaceae","Arecales",1,0,0,2,1,1
"Brassocattleya","Orchidaceae","Asparagales",0,0,0,5,0,NA
"Braunsia","Aizoaceae","Caryophyllales",0,0,0,5,0,NA
"Bravaisia","Acanthaceae","Lamiales",1,0,0,3,1,1
"Braya","Brassicaceae","Brassicales",0,0,2,11,2,0
"Brayopsis","Brassicaceae","Brassicales",0,0,0,6,0,NA
"Brazoria","Lamiaceae","Lamiales",0,0,1,3,1,0
"Brazzeia","Lecythidaceae","Ericales",0,0,0,3,0,NA
"Brebissonia","Onagraceae","Myrtales",0,0,0,1,0,NA
"Bredemeyera","Polygalaceae","Fabales",0,0,0,23,0,NA
"Bredia","Melastomataceae","Myrtales",0,0,0,12,0,NA
"Breea","Asteraceae","Asterales",0,0,0,2,0,NA
"Bremeria","Rubiaceae","Gentianales",0,0,0,18,0,NA
"Brenandendron","Asteraceae","Asterales",0,0,0,3,0,NA
"Brenania","Rubiaceae","Gentianales",0,0,0,2,0,NA
"Brenaniodendron","Fabaceae","Fabales",0,0,0,1,0,NA
"Brenierea","Fabaceae","Fabales",0,0,0,1,0,NA
"Breonadia","Rubiaceae","Gentianales",1,0,0,1,1,1
"Breonia","Rubiaceae","Gentianales",6,0,0,20,6,1
"Bretschneidera","Akaniaceae","Brassicales",1,0,0,1,1,1
"Breviea","Sapotaceae","Ericales",1,0,0,1,1,1
"Brewcaria","Bromeliaceae","Poales",0,0,0,6,0,NA
"Breweria","Convolvulaceae","Solanales",0,0,0,5,0,NA
"Breweriopsis","Convolvulaceae","Solanales",0,0,0,1,0,NA
"Brexia","Celastraceae","Celastrales",1,0,0,4,1,1
"Brexiella","Celastraceae","Celastrales",0,0,0,2,0,NA
"Breynia","Phyllanthaceae","Malpighiales",7,0,0,38,7,1
"Brianhuntleya","Aizoaceae","Caryophyllales",0,0,0,1,0,NA
"Brickellia","Asteraceae","Asterales",13,0,2,112,15,0.866666666666667
"Brickelliastrum","Asteraceae","Asterales",0,0,0,1,0,NA
"Bridelia","Phyllanthaceae","Malpighiales",20,0,0,49,20,1
"Bridgesia","Cactaceae","Caryophyllales",0,0,0,1,0,NA
"Bridgesia","Sapindaceae",NA,1,0,0,1,1,1
"Briggsia","Gesneriaceae","Lamiales",0,0,0,22,0,NA
"Briggsiopsis","Gesneriaceae","Lamiales",0,0,0,1,0,NA
"Brighamia","Campanulaceae","Asterales",1,0,0,2,1,1
"Brillantaisia","Acanthaceae","Lamiales",0,0,1,16,1,0
"Brimeura","Asparagaceae","Asparagales",0,0,1,3,1,0
"Brintonia","Asteraceae","Asterales",0,0,0,1,0,NA
"Briquetia","Malvaceae","Malvales",0,0,0,5,0,NA
"Britoa","Myrtaceae","Myrtales",0,0,0,1,0,NA
"Briza","Poaceae","Poales",0,0,5,22,5,0
"Brocchia","Asteraceae","Asterales",0,0,0,1,0,NA
"Brocchinia","Bromeliaceae","Poales",1,0,5,21,6,0.166666666666667
"Brochoneura","Myristicaceae","Magnoliales",1,0,0,5,1,1
"Brodiaea","Amaryllidaceae",NA,0,0,0,1,0,NA
"Brodiaea","Asparagaceae","Asparagales",0,0,10,20,10,0
"Brodriguesia","Fabaceae","Fabales",0,0,0,1,0,NA
"Bromelia","Bromeliaceae","Poales",0,0,4,61,4,0
"Bromheadia","Orchidaceae","Asparagales",0,0,0,30,0,NA
"Bromofestuca","Poaceae","Poales",0,0,0,1,0,NA
"Bromopsis","Poaceae","Poales",0,0,0,2,0,NA
"Bromuniola","Poaceae","Poales",0,0,1,1,1,0
"Bromus","Poaceae","Poales",0,0,39,169,39,0
"Brongniartia","Fabaceae","Fabales",2,0,0,58,2,1
"Bronwenia","Malpighiaceae","Malpighiales",1,0,0,10,1,1
"Brookea","Plantaginaceae","Lamiales",0,0,0,4,0,NA
"Brosimum","Moraceae","Rosales",11,0,0,15,11,1
"Broughtonia","Orchidaceae","Asparagales",0,0,4,7,4,0
"Broussaisia","Hydrangeaceae","Cornales",1,0,0,1,1,1
"Broussonetia","Moraceae","Rosales",6,0,0,11,6,1
"Browallia","Solanaceae","Solanales",0,0,1,7,1,0
"Brownea","Fabaceae","Fabales",5,0,0,32,5,1
"Browneopsis","Fabaceae","Fabales",0,0,0,4,0,NA
"Browningia","Cactaceae","Caryophyllales",0,0,0,11,0,NA
"Brownleea","Orchidaceae","Asparagales",0,0,1,7,1,0
"Brownlowia","Malvaceae","Malvales",4,0,0,31,4,1
"Brucea","Simaroubaceae","Sapindales",5,0,0,10,5,1
"Brugmansia","Solanaceae","Solanales",2,0,0,11,2,1
"Bruguiera","Rhizophoraceae","Malpighiales",6,0,0,6,6,1
"Bruguieria","Rhizophoraceae","Malpighiales",0,0,0,1,0,NA
"Bruinsmia","Styracaceae","Ericales",2,0,0,2,2,1
"Brunellia","Brunelliaceae","Oxalidales",8,0,0,60,8,1
"Brunfelsia","Solanaceae","Solanales",5,0,0,47,5,1
"Brunia","Bruniaceae","Bruniales",5,0,0,37,5,1
"Brunnera","Boraginaceae","UnknownOrder-Boraginaceae",0,0,0,3,0,NA
"Brunnichia","Polygonaceae","Caryophyllales",1,0,0,1,1,1
"Brunonia","Goodeniaceae","Asterales",0,0,1,1,1,0
"Brunoniella","Acanthaceae","Lamiales",0,0,2,6,2,0
"Brunsvigia","Amaryllidaceae","Asparagales",0,0,3,18,3,0
"Bruxanelia","Rubiaceae","Gentianales",0,0,0,1,0,NA
"Brya","Fabaceae","Fabales",1,0,0,6,1,1
"Bryanthus","Ericaceae","Ericales",0,0,0,1,0,NA
"Bryantiella","Polemoniaceae","Ericales",0,0,0,2,0,NA
"Bryaspis","Fabaceae","Fabales",0,0,0,3,0,NA
"Brylkinia","Poaceae","Poales",0,0,0,1,0,NA
"Bryobium","Orchidaceae","Asparagales",0,0,0,8,0,NA
"Bryocarpum","Primulaceae","Ericales",0,0,1,1,1,0
"Bryodes","Plantaginaceae","Lamiales",0,0,0,1,0,NA
"Bryodesma","Selaginellaceae","Selaginellales",0,0,0,15,0,NA
"Bryomorphe","Asteraceae","Asterales",0,0,1,1,1,0
"Bryonia","Cucurbitaceae","Cucurbitales",0,0,1,9,1,0
"Bryophyllum","Crassulaceae","Saxifragales",0,0,1,46,1,0
"Bubbia","Winteraceae","Canellales",0,0,0,1,0,NA
"Bucephalandra","Araceae","Alismatales",0,0,0,2,0,NA
"Buchanania","Anacardiaceae","Sapindales",10,0,0,27,10,1
"Buchenavia","Combretaceae","Myrtales",13,0,0,30,13,1
"Buchenroedera","Fabaceae","Fabales",0,0,0,11,0,NA
"Buchholzia","Capparaceae","Brassicales",0,0,0,2,0,NA
"Buchloe","Poaceae","Poales",0,0,1,1,1,0
"Buchlomimus","Poaceae","Poales",0,0,0,1,0,NA
"Buchnera","Orobanchaceae","Lamiales",0,0,1,138,1,0
"Buchnerodendron","Achariaceae","Malpighiales",1,0,0,2,1,1
"Buchtienia","Orchidaceae","Asparagales",0,0,0,3,0,NA
"Bucida","Combretaceae","Myrtales",2,0,0,6,2,1
"Buckinghamia","Proteaceae","Proteales",1,0,0,2,1,1
"Buckleya","Santalaceae","Santalales",1,0,0,4,1,1
"Buckollia","Apocynaceae","Gentianales",0,0,0,2,0,NA
"Bucquetia","Melastomataceae","Myrtales",0,0,0,3,0,NA
"Budawangia","Ericaceae","Ericales",1,0,0,1,1,1
"Buddleja","Scrophulariaceae","Lamiales",10,0,2,141,12,0.833333333333333
"Buergersiochloa","Poaceae","Poales",0,0,1,1,1,0
"Buesia","Hymenophyllaceae","Hymenophyllales",0,0,0,1,0,NA
"Bufonia","Caryophyllaceae","Caryophyllales",0,0,0,32,0,NA
"Buforrestia","Commelinaceae","Commelinales",0,0,1,3,1,0
"Buglossoides","Boraginaceae","UnknownOrder-Boraginaceae",0,0,2,11,2,0
"Bukiniczia","Plumbaginaceae","Caryophyllales",0,0,0,1,0,NA
"Bulbine","Xanthorrhoeaceae","Asparagales",0,0,14,78,14,0
"Bulbinella","Xanthorrhoeaceae","Asparagales",0,0,6,24,6,0
"Bulbophyllum","Orchidaceae","Asparagales",0,0,6,1884,6,0
"Bulbostylis","Asteraceae",NA,0,0,0,1,0,NA
"Bulbostylis","Cyperaceae","Poales",0,0,18,217,18,0
"Bulleyia","Orchidaceae","Asparagales",0,0,0,1,0,NA
"Bullockia","Rubiaceae","Gentianales",3,0,0,6,3,1
"Bulnesia","Zygophyllaceae","Zygophyllales",3,0,0,10,3,1
"Bunchosia","Malpighiaceae","Malpighiales",13,0,0,80,13,1
"Bungarimba","Rubiaceae","Gentianales",0,0,0,4,0,NA
"Bungea","Orobanchaceae","Lamiales",0,0,0,2,0,NA
"Bunias","Brassicaceae","Brassicales",0,0,1,3,1,0
"Bunium","Apiaceae","Apiales",0,0,1,50,1,0
"Buphthalmum","Asteraceae","Asterales",0,0,1,2,1,0
"Bupleurum","Apiaceae","Apiales",2,0,5,208,7,0.285714285714286
"Burasaia","Menispermaceae","Ranunculales",1,0,0,4,1,1
"Burbidgea","Zingiberaceae","Zingiberales",0,0,0,5,0,NA
"Burchardia","Colchicaceae","Liliales",0,0,4,6,4,0
"Burchellia","Rubiaceae","Gentianales",1,0,0,1,1,1
"Burckella","Sapotaceae","Ericales",8,0,0,13,8,1
"Burdachia","Malpighiaceae","Malpighiales",3,0,0,3,3,1
"Burkartia","Asteraceae","Asterales",0,0,0,1,0,NA
"Burkea","Fabaceae","Fabales",1,0,0,2,1,1
"Burkillanthus","Rutaceae","Sapindales",1,0,0,1,1,1
"Burkilliodendron","Fabaceae","Fabales",0,0,0,1,0,NA
"Burmannia","Burmanniaceae","Dioscoreales",0,0,18,56,18,0
"Burmeistera","Campanulaceae","Asterales",0,1,1,103,1,0
"Burnatia","Alismataceae","Alismatales",0,0,1,1,1,0
"Burnettia","Orchidaceae","Asparagales",0,0,0,1,0,NA
"Burretiodendron","Malvaceae","Malvales",2,0,0,7,2,1
"Burretiokentia","Arecaceae","Arecales",1,0,0,5,1,1
"Bursaria","Pittosporaceae","Apiales",3,0,0,7,3,1
"Bursera","Burseraceae","Sapindales",23,0,0,120,23,1
"Burtonia","Fabaceae","Fabales",0,0,0,1,0,NA
"Burttdavya","Rubiaceae","Gentianales",1,0,0,1,1,1
"Burttia","Connaraceae","Oxalidales",0,0,0,1,0,NA
"Bussea","Fabaceae","Fabales",1,0,0,7,1,1
"Butea","Fabaceae","Fabales",1,0,0,4,1,1
"Butia","Arecaceae","Arecales",7,0,0,20,7,1
"Butomopsis","Alismataceae","Alismatales",0,0,1,1,1,0
"Butomus","Butomaceae","Alismatales",0,0,1,2,1,0
"Buttonia","Orobanchaceae","Lamiales",0,0,0,3,0,NA
"Butumia","Podostemaceae","Malpighiales",0,0,0,1,0,NA
"Butyagrus","Arecaceae","Arecales",0,0,0,1,0,NA
"Buxus","Buxaceae","Buxales",17,0,0,104,17,1
"Byblis","Byblidaceae","Lamiales",0,0,1,7,1,0
"Byrsanthus","Salicaceae","Malpighiales",0,0,0,1,0,NA
"Byrsonima","Malpighiaceae","Malpighiales",20,0,0,157,20,1
"Byrsophyllum","Rubiaceae","Gentianales",0,0,0,2,0,NA
"Byrsopteris","Dryopteridaceae","Polypodiales",0,0,0,1,0,NA
"Bystropogon","Lamiaceae","Lamiales",0,0,0,11,0,NA
"Bythophyton","Plantaginaceae","Lamiales",0,0,0,1,0,NA
"Byttneria","Malvaceae","Malvales",7,0,0,139,7,1
"Caatinganthus","Asteraceae","Asterales",0,0,0,2,0,NA
"Cabobanthus","Asteraceae","Asterales",0,0,0,2,0,NA
"Cabomba","Cabombaceae","Nymphaeales",0,0,1,5,1,0
"Cabralea","Meliaceae","Sapindales",2,0,0,2,2,1
"Cabreriella","Asteraceae","Asterales",0,0,0,2,0,NA
"Cacalia","Asteraceae","Asterales",0,0,0,7,0,NA
"Cacaliopsis","Asteraceae","Asterales",0,0,0,1,0,NA
"Caccinia","Boraginaceae","UnknownOrder-Boraginaceae",0,0,0,5,0,NA
"Cachrys","Apiaceae","Apiales",0,0,0,6,0,NA
"Cacosmia","Asteraceae","Asterales",1,0,0,3,1,1
"Cactus","Cactaceae","Caryophyllales",0,0,0,14,0,NA
"Cadaba","Capparaceae","Brassicales",1,0,0,29,1,1
"Cadellia","Surianaceae","Fabales",1,0,0,1,1,1
"Cadia","Fabaceae","Fabales",3,0,0,7,3,1
"Cadiscus","Asteraceae","Asterales",0,0,0,1,0,NA
"Caelospermum","Rubiaceae","Gentianales",0,0,0,1,0,NA
"Caenopteris","Aspleniaceae","Polypodiales",0,0,0,3,0,NA
"Caesalpinia","Fabaceae","Fabales",24,0,0,162,24,1
"Caesia","Xanthorrhoeaceae","Asparagales",0,0,4,13,4,0
"Caesulia","Asteraceae","Asterales",0,0,1,1,1,0
"Cailliea","Fabaceae","Fabales",0,0,0,2,0,NA
"Caiophora","Loasaceae","Cornales",0,0,1,43,1,0
"Cajanus","Fabaceae","Fabales",1,1,0,32,1,1
"Cakile","Brassicaceae","Brassicales",0,0,2,7,2,0
"Calacanthus","Acanthaceae","Lamiales",0,0,0,1,0,NA
"Caladenia","Orchidaceae","Asparagales",0,0,8,285,8,0
"Caladium","Araceae","Alismatales",0,0,7,14,7,0
"Calais","Asteraceae","Asterales",0,0,0,1,0,NA
"Calamagrostis","Poaceae","Poales",0,0,23,291,23,0
"Calamaria","Isoëtaceae","Isoetales",0,0,7,7,7,0
"Calamistrum","Marsileaceae","Salviniales",0,0,0,1,0,NA
"Calammophila","Poaceae","Poales",0,0,0,1,0,NA
"Calamophyllum","Aizoaceae","Caryophyllales",0,0,0,3,0,NA
"Calamovilfa","Poaceae","Poales",0,0,2,5,2,0
"Calamus","Arecaceae","Arecales",26,0,0,380,26,1
"Calandrinia","Portulacaceae","Caryophyllales",0,0,20,104,20,0
"Calanthe","Orchidaceae","Asparagales",0,0,5,220,5,0
"Calanthea","Capparaceae","Brassicales",0,0,0,2,0,NA
"Calantica","Salicaceae","Malpighiales",0,0,0,7,0,NA
"Calanticaria","Asteraceae","Asterales",0,0,0,4,0,NA
"Calassodia","Orchidaceae","Asparagales",0,0,0,1,0,NA
"Calathea","Marantaceae","Zingiberales",0,0,27,287,27,0
"Calathodes","Ranunculaceae","Ranunculales",0,0,0,4,0,NA
"Calathostelma","Apocynaceae","Gentianales",0,0,0,1,0,NA
"Calatola","Icacinaceae","UnknownOrder-Icacinaceae",3,0,0,5,3,1
"Calaunia","Moraceae","Rosales",0,0,0,1,0,NA
"Calcareoboea","Gesneriaceae","Lamiales",0,0,0,2,0,NA
"Calceolaria","Calceolariaceae","Lamiales",19,3,16,277,35,0.542857142857143
"Calcicola","Malpighiaceae","Malpighiales",0,0,0,2,0,NA
"Calciphilopteris","Pteridaceae","Polypodiales",0,0,4,4,4,0
"Calcitrapa","Asteraceae","Asterales",0,0,0,1,0,NA
"Caldcluvia","Cunoniaceae","Oxalidales",7,0,0,11,7,1
"Calderonella","Poaceae","Poales",0,0,1,1,1,0
"Caldesia","Alismataceae","Alismatales",0,0,2,5,2,0
"Calea","Asteraceae","Asterales",0,0,2,152,2,0
"Caleana","Orchidaceae","Asparagales",0,0,1,1,1,0
"Calectasia","Dasypogonaceae","UnknownOrder-Dasypogonaceae",2,0,0,11,2,1
"Calendula","Asteraceae","Asterales",0,0,2,12,2,0
"Calepina","Brassicaceae","Brassicales",0,0,0,1,0,NA
"Calibanus","Asparagaceae","Asparagales",0,0,0,2,0,NA
"Calibrachoa","Solanaceae","Solanales",0,0,0,28,0,NA
"Calicharis","Amaryllidaceae","Asparagales",0,0,0,1,0,NA
"Calicorema","Amaranthaceae","Caryophyllales",1,0,0,2,1,1
"Calicotome","Fabaceae","Fabales",2,0,0,5,2,1
"California","Geraniaceae","Geraniales",0,0,1,1,1,0
"Calimeris","Asteraceae","Asterales",0,0,0,2,0,NA
"Caliphruria","Amaryllidaceae","Asparagales",0,0,1,4,1,0
"Calispepla","Fabaceae","Fabales",0,0,0,1,0,NA
"Calla","Araceae","Alismatales",0,0,1,1,1,0
"Callaeum","Malpighiaceae","Malpighiales",1,0,0,11,1,1
"Callerya","Fabaceae","Fabales",2,0,0,33,2,1
"Calliandra","Fabaceae","Fabales",14,0,0,172,14,1
"Calliandropsis","Fabaceae","Fabales",1,0,0,1,1,1
"Callianthemoides","Ranunculaceae","Ranunculales",0,0,0,1,0,NA
"Callianthemum","Ranunculaceae","Ranunculales",0,0,0,15,0,NA
"Callicarpa","Lamiaceae","Lamiales",15,0,0,172,15,1
"Callicephalus","Asteraceae","Asterales",0,0,1,1,1,0
"Callichilia","Apocynaceae","Gentianales",0,0,0,6,0,NA
"Callichlamys","Bignoniaceae","Lamiales",1,0,0,1,1,1
"Callicoma","Cunoniaceae","Oxalidales",1,0,0,1,1,1
"Calligonum","Polygonaceae","Caryophyllales",5,0,0,158,5,1
"Callilepis","Asteraceae","Asterales",0,0,0,5,0,NA
"Callipeltis","Rubiaceae","Gentianales",0,0,2,3,2,0
"Callipteris","Athyriaceae","Polypodiales",0,0,0,14,0,NA
"Callirhoe","Malvaceae","Malvales",0,0,1,9,1,0
"Callisia","Commelinaceae","Commelinales",0,0,6,20,6,0
"Callista","Orchidaceae","Asparagales",0,0,0,4,0,NA
"Callistachys","Fabaceae","Fabales",0,0,0,7,0,NA
"Callistemon","Myrtaceae","Myrtales",32,0,0,37,32,1
"Callistephus","Asteraceae","Asterales",0,0,1,2,1,0
"Callisthene","Vochysiaceae","Myrtales",2,0,0,7,2,1
"Callitriche","Plantaginaceae","Lamiales",0,0,22,63,22,0
"Callitris","Cupressaceae","Cupressales",12,0,0,15,12,1
"Callitropsis","Cupressaceae","Cupressales",0,0,0,1,0,NA
"Callopsis","Araceae","Alismatales",0,0,0,1,0,NA
"Callostylis","Orchidaceae","Asparagales",0,0,0,5,0,NA
"Calluna","Ericaceae","Ericales",1,0,0,1,1,1
"Calocedrus","Cupressaceae","Cupressales",2,0,0,4,2,1
"Calocephalus","Asteraceae","Asterales",0,1,1,9,1,0
"Calochilus","Orchidaceae","Asparagales",0,0,2,27,2,0
"Calochlaena","Dicksoniaceae","Cyatheales",1,0,0,5,1,1
"Calochone","Rubiaceae","Gentianales",1,0,0,2,1,1
"Calochortus","Liliaceae","Liliales",0,0,25,74,25,0
"Calocrater","Apocynaceae","Gentianales",0,0,0,1,0,NA
"Calodecaryia","Meliaceae","Sapindales",1,0,0,2,1,1
"Calodendrum","Rutaceae","Sapindales",1,0,0,2,1,1
"Calomeria","Asteraceae","Asterales",0,0,1,2,1,0
"Caloncoba","Achariaceae","Malpighiales",2,0,0,10,2,1
"Calonema","Orchidaceae","Asparagales",0,0,0,1,0,NA
"Calopappus","Asteraceae","Asterales",0,0,0,1,0,NA
"Calophaca","Fabaceae","Fabales",0,0,0,9,0,NA
"Calophyllum","Clusiaceae","Malpighiales",42,0,0,179,42,1
"Calophysa","Melastomataceae","Myrtales",0,0,0,1,0,NA
"Calopogon","Orchidaceae","Asparagales",0,0,1,5,1,0
"Calopogonium","Fabaceae","Fabales",0,0,2,9,2,0
"Calopteryx","Ericaceae","Ericales",0,0,0,2,0,NA
"Calorophus","Restionaceae","Poales",0,0,1,2,1,0
"Calostemma","Amaryllidaceae","Asparagales",0,0,0,3,0,NA
"Calostephane","Asteraceae","Asterales",0,1,1,6,1,0
"Calostigma","Apocynaceae","Gentianales",0,0,0,5,0,NA
"Calotesta","Asteraceae","Asterales",0,0,0,1,0,NA
"Calothamnus","Myrtaceae","Myrtales",23,0,0,43,23,1
"Calotis","Asteraceae","Asterales",0,0,5,27,5,0
"Calotropis","Apocynaceae","Gentianales",2,0,0,3,2,1
"Calpocalyx","Fabaceae","Fabales",4,0,0,11,4,1
"Calpurnia","Fabaceae","Fabales",5,0,0,7,5,1
"Caltha","Ranunculaceae","Ranunculales",0,0,1,6,1,0
"Caluera","Orchidaceae","Asparagales",0,0,0,3,0,NA
"Calvoa","Melastomataceae","Myrtales",0,1,0,9,0,NA
"Calycacanthus","Acanthaceae","Lamiales",0,0,0,1,0,NA
"Calycadenia","Asteraceae","Asterales",0,0,0,10,0,NA
"Calycanthus","Calycanthaceae","Laurales",3,0,0,4,3,1
"Calycera","Calyceraceae","Asterales",0,0,0,15,0,NA
"Calycobolus","Convolvulaceae","Solanales",0,2,0,10,0,NA
"Calycocarpum","Menispermaceae","Ranunculales",0,0,1,1,1,0
"Calycogonium","Melastomataceae","Myrtales",2,0,0,10,2,1
"Calycolpus","Myrtaceae","Myrtales",2,0,0,16,2,1
"Calycomorphum","Fabaceae","Fabales",0,0,0,1,0,NA
"Calycopeplus","Euphorbiaceae","Malpighiales",4,0,0,5,4,1
"Calycophyllum","Rubiaceae","Gentianales",4,0,0,11,4,1
"Calycophysum","Cucurbitaceae","Cucurbitales",0,0,1,5,1,0
"Calycorectes","Myrtaceae","Myrtales",2,0,0,29,2,1
"Calycoseris","Asteraceae","Asterales",0,0,0,2,0,NA
"Calycosia","Rubiaceae","Gentianales",0,0,0,8,0,NA
"Calycosiphonia","Rubiaceae","Gentianales",0,0,0,3,0,NA
"Calyculogygas","Malvaceae","Malvales",0,0,0,1,0,NA
"Calydorea","Iridaceae","Asparagales",0,0,3,20,3,0
"Calylophus","Onagraceae","Myrtales",0,0,0,7,0,NA
"Calymmanthera","Orchidaceae","Asparagales",0,0,0,5,0,NA
"Calymmanthium","Cactaceae","Caryophyllales",1,0,0,2,1,1
"Calymmatium","Brassicaceae","Brassicales",0,0,0,2,0,NA
"Calymmodon","Polypodiaceae","Polypodiales",0,0,0,5,0,NA
"Calypso","Orchidaceae","Asparagales",0,0,1,1,1,0
"Calyptocarpus","Asteraceae","Asterales",0,0,1,5,1,0
"Calyptochloa","Poaceae","Poales",0,0,0,1,0,NA
"Calyptostylis","Malpighiaceae","Malpighiales",0,0,0,1,0,NA
"Calyptraemalva","Malvaceae","Malvales",0,0,0,1,0,NA
"Calyptranthera","Apocynaceae","Gentianales",0,0,0,10,0,NA
"Calyptranthes","Myrtaceae","Myrtales",19,0,0,268,19,1
"Calyptrocalyx","Arecaceae","Arecales",0,0,0,26,0,NA
"Calyptrocarya","Cyperaceae","Poales",0,0,0,8,0,NA
"Calyptrochilum","Orchidaceae","Asparagales",0,0,1,2,1,0
"Calyptrogenia","Myrtaceae","Myrtales",0,0,0,6,0,NA
"Calyptrogyne","Arecaceae","Arecales",3,0,0,18,3,1
"Calyptronoma","Arecaceae","Arecales",3,0,0,3,3,1
"Calyptrosciadium","Apiaceae","Apiales",0,0,0,2,0,NA
"Calyptrotheca","Didiereaceae","Caryophyllales",1,0,0,2,1,1
"Calystegia","Convolvulaceae","Solanales",0,1,2,25,2,0
"Calytrix","Myrtaceae","Myrtales",25,0,0,79,25,1
"Camarea","Malpighiaceae","Malpighiales",0,0,0,9,0,NA
"Camaridium","Orchidaceae","Asparagales",0,0,48,82,48,0
"Camarotea","Acanthaceae","Lamiales",0,0,0,2,0,NA
"Camassia","Asparagaceae","Asparagales",0,0,4,6,4,0
"Cambessedesia","Melastomataceae","Myrtales",1,0,0,21,1,1
"Camchaya","Asteraceae","Asterales",0,0,0,7,0,NA
"Camelina","Brassicaceae","Brassicales",0,0,3,8,3,0
"Camelinopsis","Brassicaceae","Brassicales",0,0,0,1,0,NA
"Camellia","Theaceae","Ericales",36,0,0,250,36,1
"Cameraria","Apocynaceae","Gentianales",1,0,0,7,1,1
"Camissonia","Onagraceae","Myrtales",0,0,0,23,0,NA
"Camissoniopsis","Onagraceae","Myrtales",0,0,0,14,0,NA
"Camoensia","Fabaceae","Fabales",0,0,0,2,0,NA
"Camonea","Convolvulaceae","Solanales",0,0,0,1,0,NA
"Campanula","Campanulaceae","Asterales",0,0,54,440,54,0
"Campanulorchis","Orchidaceae","Asparagales",0,0,0,5,0,NA
"Campbellia","Orobanchaceae","Lamiales",0,0,0,1,0,NA
"Campeiostachys","Poaceae","Poales",0,0,0,3,0,NA
"Campestigma","Apocynaceae","Gentianales",0,0,0,1,0,NA
"Camphora","Lauraceae","Laurales",0,0,0,1,0,NA
"Camphorosma","Amaranthaceae","Caryophyllales",0,0,0,6,0,NA
"Campnosperma","Anacardiaceae","Sapindales",4,0,0,15,4,1
"Campomanesia","Myrtaceae","Myrtales",10,0,0,38,10,1
"Campovassouria","Asteraceae","Asterales",0,0,0,2,0,NA
"Campsiandra","Fabaceae","Fabales",2,0,0,18,2,1
"Campsidium","Bignoniaceae","Lamiales",1,0,0,1,1,1
"Campsis","Bignoniaceae","Lamiales",2,0,0,2,2,1
"Camptacra","Asteraceae","Asterales",0,0,0,3,0,NA
"Camptandra","Zingiberaceae","Zingiberales",0,0,0,4,0,NA
"Campteria","Pteridaceae","Polypodiales",0,0,0,1,0,NA
"Camptocarpus","Apocynaceae","Gentianales",0,0,0,9,0,NA
"Camptolepis","Sapindaceae","Sapindales",1,0,0,4,1,1
"Camptoloma","Scrophulariaceae","Lamiales",0,0,0,3,0,NA
"Camptorrhiza","Colchicaceae","Liliales",0,0,0,2,0,NA
"Camptosema","Fabaceae","Fabales",0,0,0,18,0,NA
"Camptosorus","Aspleniaceae","Polypodiales",0,0,0,1,0,NA
"Camptostemon","Malvaceae","Malvales",2,0,0,3,2,1
"Camptostylus","Achariaceae","Malpighiales",1,0,0,3,1,1
"Camptotheca","Cornaceae","Cornales",1,0,0,2,1,1
"Camptouratea","Ochnaceae","Malpighiales",0,0,0,1,0,NA
"Campuloclinium","Asteraceae","Asterales",0,0,0,17,0,NA
"Campylanthera","Malvaceae","Malvales",0,0,0,1,0,NA
"Campylanthus","Plantaginaceae","Lamiales",1,0,0,18,1,1
"Campylocentrum","Orchidaceae","Asparagales",0,0,7,65,7,0
"Campyloneurum","Polypodiaceae","Polypodiales",0,0,0,52,0,NA
"Campylopetalum","Anacardiaceae","Sapindales",0,0,0,1,0,NA
"Campylosiphon","Burmanniaceae","Dioscoreales",0,0,0,2,0,NA
"Campylospermum","Ochnaceae","Malpighiales",0,0,0,15,0,NA
"Campylostachys","Stilbaceae","Lamiales",0,0,0,1,0,NA
"Campylostemon","Celastraceae","Celastrales",0,0,0,10,0,NA
"Campylotropis","Fabaceae","Fabales",2,0,0,41,2,1
"Campynema","Campynemataceae","Liliales",0,0,1,1,1,0
"Campynemanthe","Campynemataceae","Liliales",0,0,3,3,3,0
"Canacomyrica","Myricaceae","Fagales",1,0,0,1,1,1
"Canadanthus","Asteraceae","Asterales",0,0,0,1,0,NA
"Cananga","Annonaceae","Magnoliales",2,0,0,4,2,1
"Canarina","Campanulaceae","Asterales",0,0,1,3,1,0
"Canarium","Burseraceae","Sapindales",46,0,0,88,46,1
"Canastra","Poaceae","Poales",0,0,1,1,1,0
"Canavalia","Fabaceae","Fabales",0,0,2,70,2,0
"Canbya","Papaveraceae","Ranunculales",0,0,0,2,0,NA
"Cancrinia","Asteraceae","Asterales",0,0,0,12,0,NA
"Cancriniella","Asteraceae","Asterales",0,0,0,1,0,NA
"Candolleodendron","Fabaceae","Fabales",1,0,0,1,1,1
"Canella","Canellaceae","Canellales",1,0,0,1,1,1
"Canephora","Rubiaceae","Gentianales",0,0,0,5,0,NA
"Canistrum","Bromeliaceae","Poales",0,0,5,21,5,0
"Canna","Cannaceae","Zingiberales",0,0,7,12,7,0
"Cannabis","Cannabaceae","Rosales",0,0,1,1,1,0
"Cannaboides","Apiaceae","Apiales",0,0,0,2,0,NA
"Cannomois","Restionaceae","Poales",0,0,5,12,5,0
"Canotia","Celastraceae","Celastrales",1,0,0,2,1,1
"Canscora","Gentianaceae","Gentianales",0,0,0,11,0,NA
"Cansjera","Opiliaceae","Santalales",1,0,0,3,1,1
"Cantharospermum","Fabaceae","Fabales",0,0,0,3,0,NA
"Canthium","Rubiaceae","Gentianales",7,0,0,102,7,1
"Cantleya","Stemonuraceae","Aquifoliales",1,0,0,1,1,1
"Cantua","Polemoniaceae","Ericales",4,0,0,19,4,1
"Cantuffa","Fabaceae","Fabales",0,0,0,1,0,NA
"Caobangia","Polypodiaceae","Polypodiales",0,0,0,1,0,NA
"Capanemia","Orchidaceae","Asparagales",0,0,1,10,1,0
"Capelio","Asteraceae","Asterales",1,0,0,3,1,1
"Capeobolus","Cyperaceae","Poales",0,0,1,1,1,0
"Capeochloa","Poaceae","Poales",0,0,0,2,0,NA
"Caperonia","Euphorbiaceae","Malpighiales",0,0,2,34,2,0
"Capillipedium","Poaceae","Poales",0,0,1,17,1,0
"Capirona","Rubiaceae","Gentianales",1,0,0,1,1,1
"Capitanopsis","Lamiaceae","Lamiales",0,0,0,3,0,NA
"Capitularina","Cyperaceae","Poales",0,0,0,1,0,NA
"Capnoides","Papaveraceae","Ranunculales",0,0,0,1,0,NA
"Capnophyllum","Apiaceae","Apiales",0,0,1,4,1,0
"Capparicordis","Capparaceae","Brassicales",0,0,0,3,0,NA
"Capparidastrum","Capparaceae","Brassicales",2,0,0,22,2,1
"Capparis","Capparaceae","Brassicales",19,0,0,181,19,1
"Capraria","Scrophulariaceae","Lamiales",0,0,1,7,1,0
"Capsella","Brassicaceae","Brassicales",0,0,1,9,1,0
"Capsicum","Solanaceae","Solanales",0,0,4,40,4,0
"Capurodendron","Sapotaceae","Ericales",1,0,0,23,1,1
"Capuronia","Lythraceae","Myrtales",0,0,0,1,0,NA
"Capuronianthus","Meliaceae","Sapindales",1,0,0,2,1,1
"Caragana","Fabaceae","Fabales",10,0,0,90,10,1
"Caraipa","Calophyllaceae","Malpighiales",8,0,0,29,8,1
"Carallia","Rhizophoraceae","Malpighiales",2,0,0,13,2,1
"Caralluma","Apocynaceae","Gentianales",0,0,0,78,0,NA
"Carapa","Meliaceae","Sapindales",4,0,0,19,4,1
"Carapichea","Rubiaceae","Gentianales",2,0,0,6,2,1
"Cardamine","Brassicaceae","Brassicales",0,0,31,233,31,0
"Cardenasiodendron","Anacardiaceae","Sapindales",0,0,0,1,0,NA
"Cardiandra","Hydrangeaceae","Cornales",0,0,4,4,4,0
"Cardiochilos","Orchidaceae","Asparagales",0,0,0,1,0,NA
"Cardiochlamys","Convolvulaceae","Solanales",0,0,1,2,1,0
"Cardiocrinum","Liliaceae","Liliales",0,0,3,3,3,0
"Cardiomanes","Hymenophyllaceae","Hymenophyllales",0,0,0,1,0,NA
"Cardionema","Caryophyllaceae","Caryophyllales",0,0,0,6,0,NA
"Cardiopetalum","Annonaceae","Magnoliales",1,0,0,3,1,1
"Cardiopteris","Cardiopteridaceae","Aquifoliales",1,0,0,2,1,1
"Cardiospermum","Sapindaceae","Sapindales",1,0,1,17,2,0.5
"Cardopatium","Asteraceae","Asterales",0,0,1,2,1,0
"Carduncellus","Asteraceae","Asterales",0,0,0,4,0,NA
"Carduocirsium","Asteraceae","Asterales",0,0,0,3,0,NA
"Carduogalactites","Asteraceae","Asterales",0,0,0,1,0,NA
"Carduus","Asteraceae","Asterales",0,0,4,130,4,0
"Cardwellia","Proteaceae","Proteales",1,0,0,1,1,1
"Carex","Cyperaceae","Poales",0,0,497,2062,497,0
"Careya","Lecythidaceae","Ericales",1,0,0,3,1,1
"Caribea","Nyctaginaceae","Caryophyllales",0,0,0,1,0,NA
"Carica","Caricaceae","Brassicales",6,0,0,22,6,1
"Carinavalva","Brassicaceae","Brassicales",0,0,0,1,0,NA
"Cariniana","Lecythidaceae","Ericales",7,0,0,9,7,1
"Carissa","Apocynaceae","Gentianales",5,0,0,8,5,1
"Carissoa","Fabaceae","Fabales",0,0,0,1,0,NA
"Carlemannia","Carlemanniaceae","Lamiales",0,0,2,3,2,0
"Carlephyton","Araceae","Alismatales",0,0,0,3,0,NA
"Carlesia","Apiaceae","Apiales",0,0,0,1,0,NA
"Carlina","Asteraceae","Asterales",0,0,4,34,4,0
"Carlowrightia","Acanthaceae","Lamiales",1,0,0,26,1,1
"Carlquistia","Asteraceae","Asterales",0,0,0,1,0,NA
"Carludovica","Cyclanthaceae","Pandanales",0,0,1,4,1,0
"Carmichaelia","Fabaceae","Fabales",6,0,0,43,6,1
"Carminatia","Asteraceae","Asterales",0,0,0,3,0,NA
"Carnarvonia","Proteaceae","Proteales",1,0,0,1,1,1
"Carnegiea","Cactaceae","Caryophyllales",1,0,0,1,1,1
"Carnegieodoxa","Monimiaceae","Laurales",0,0,0,1,0,NA
"Carolus","Malpighiaceae","Malpighiales",0,0,0,6,0,NA
"Caropsis","Apiaceae","Apiales",0,0,0,1,0,NA
"Carpacoce","Rubiaceae","Gentianales",0,0,0,7,0,NA
"Carpanthea","Aizoaceae","Caryophyllales",0,0,1,2,1,0
"Carpentaria","Arecaceae","Arecales",1,0,0,1,1,1
"Carpenteria","Hydrangeaceae","Cornales",1,0,0,1,1,1
"Carpesium","Asteraceae","Asterales",0,0,2,24,2,0
"Carpha","Cyperaceae","Poales",0,0,3,15,3,0
"Carphalea","Rubiaceae","Gentianales",3,0,0,6,3,1
"Carphephorus","Asteraceae","Asterales",0,0,0,7,0,NA
"Carphochaete","Asteraceae","Asterales",0,0,0,6,0,NA
"Carpinus","Betulaceae","Fagales",14,0,0,42,14,1
"Carpobrotus","Aizoaceae","Caryophyllales",0,0,2,14,2,0
"Carpodetus","Rousseaceae","Asterales",2,0,0,11,2,1
"Carpodiptera","Malvaceae","Malvales",1,0,0,5,1,1
"Carpolobia","Polygalaceae","Fabales",1,0,0,5,1,1
"Carpotroche","Achariaceae","Malpighiales",1,0,0,12,1,1
"Carpoxylon","Arecaceae","Arecales",1,0,0,1,1,1
"Carramboa","Asteraceae","Asterales",0,0,0,7,0,NA
"Carrichtera","Brassicaceae","Brassicales",0,0,1,1,1,0
"Carrierea","Salicaceae","Malpighiales",1,0,0,4,1,1
"Carronia","Menispermaceae","Ranunculales",1,1,0,4,1,1
"Carruanthophyllum","Aizoaceae","Caryophyllales",0,0,0,1,0,NA
"Carruanthus","Aizoaceae","Caryophyllales",0,0,0,2,0,NA
"Carruthersia","Apocynaceae","Gentianales",0,0,0,4,0,NA
"Carterella","Rubiaceae","Gentianales",0,0,0,1,0,NA
"Carterothamnus","Asteraceae","Asterales",0,0,0,1,0,NA
"Carthamus","Asteraceae","Asterales",1,0,2,48,3,0.333333333333333
"Cartonema","Commelinaceae","Commelinales",0,0,2,7,2,0
"Carum","Apiaceae","Apiales",0,0,3,29,3,0
"Carvalhoa","Apocynaceae","Gentianales",1,0,0,2,1,1
"Carya","Juglandaceae","Fagales",12,0,0,27,12,1
"Caryocar","Caryocaraceae","Malpighiales",10,0,0,16,10,1
"Caryodaphnopsis","Lauraceae","Laurales",4,0,0,15,4,1
"Caryodendron","Euphorbiaceae","Malpighiales",2,0,0,4,2,1
"Caryomene","Menispermaceae","Ranunculales",0,1,0,5,0,NA
"Caryopteris","Lamiaceae","Lamiales",4,0,0,7,4,1
"Caryota","Arecaceae","Arecales",5,0,0,14,5,1
"Caryotophora","Aizoaceae","Caryophyllales",0,0,0,1,0,NA
"Casasia","Rubiaceae","Gentianales",1,0,0,10,1,1
"Cascabela","Apocynaceae","Gentianales",3,0,0,5,3,1
"Cascaronia","Fabaceae","Fabales",0,0,0,1,0,NA
"Casearia","Salicaceae","Malpighiales",91,0,0,217,91,1
"Casimirella","Icacinaceae","UnknownOrder-Icacinaceae",1,0,0,7,1,1
"Casimiroa","Rutaceae","Sapindales",2,0,0,10,2,1
"Casparia","Fabaceae","Fabales",0,0,0,1,0,NA
"Cassebeera","Pteridaceae","Polypodiales",0,0,0,2,0,NA
"Casselia","Verbenaceae","Lamiales",0,0,0,7,0,NA
"Cassia","Fabaceae","Fabales",19,0,0,90,19,1
"Cassine","Celastraceae","Celastrales",17,0,0,64,17,1
"Cassinia","Asteraceae","Asterales",6,0,1,37,7,0.857142857142857
"Cassinopsis","Icacinaceae","UnknownOrder-Icacinaceae",1,0,0,6,1,1
"Cassiope","Ericaceae","Ericales",3,0,0,17,3,1
"Cassipourea","Rhizophoraceae","Malpighiales",9,0,0,75,9,1
"Cassytha","Lauraceae","Laurales",0,0,6,19,6,0
"Castalis","Asteraceae","Asterales",0,0,0,1,0,NA
"Castanea","Fagaceae","Fagales",6,0,0,9,6,1
"Castanedia","Asteraceae","Asterales",0,0,0,1,0,NA
"Castanopsis","Fagaceae","Fagales",41,0,0,140,41,1
"Castanospermum","Fabaceae","Fabales",1,0,0,1,1,1
"Castanospora","Sapindaceae","Sapindales",1,0,0,1,1,1
"Castela","Simaroubaceae","Sapindales",7,0,0,17,7,1
"Castellanoa","Amaryllidaceae","Asparagales",0,0,0,2,0,NA
"Castellanosia","Cactaceae","Caryophyllales",1,0,0,1,1,1
"Castellia","Poaceae","Poales",0,0,0,1,0,NA
"Castelnavia","Podostemaceae","Malpighiales",0,0,0,11,0,NA
"Castilla","Moraceae","Rosales",2,0,0,3,2,1
"Castilleja","Orobanchaceae","Lamiales",0,1,2,204,2,0
"Castratella","Melastomataceae","Myrtales",0,0,1,2,1,0
"Castrilanthemum","Asteraceae","Asterales",0,0,0,1,0,NA
"Castroviejoa","Asteraceae","Asterales",0,0,0,2,0,NA
"Casuarina","Casuarinaceae","Fagales",10,0,0,14,10,1
"Catabrosa","Poaceae","Poales",0,0,1,2,1,0
"Catacolea","Restionaceae","Poales",0,0,0,1,0,NA
"Catadysia","Brassicaceae","Brassicales",0,0,0,1,0,NA
"Catalepidia","Proteaceae","Proteales",1,0,0,1,1,1
"Catalepis","Poaceae","Poales",0,0,0,1,0,NA
"Catalpa","Bignoniaceae","Lamiales",7,0,0,11,7,1
"Catamixis","Asteraceae","Asterales",0,0,0,1,0,NA
"Catananche","Asteraceae","Asterales",0,0,1,5,1,0
"Catanthera","Melastomataceae","Myrtales",0,0,0,11,0,NA
"Catapodium","Poaceae","Poales",0,0,1,4,1,0
"Catasetum","Orchidaceae","Asparagales",0,0,1,194,1,0
"Catatia","Asteraceae","Asterales",0,0,0,2,0,NA
"Catenulina","Brassicaceae","Brassicales",0,0,0,1,0,NA
"Catesbaea","Rubiaceae","Gentianales",2,0,0,17,2,1
"Catha","Celastraceae","Celastrales",2,0,0,3,2,1
"Catharanthus","Apocynaceae","Gentianales",0,0,1,8,1,0
"Cathariostachys","Poaceae","Poales",0,0,0,2,0,NA
"Cathaya","Pinaceae","Pinales",1,0,0,1,1,1
"Cathayanthe","Gesneriaceae","Lamiales",0,0,0,1,0,NA
"Cathedra","Olacaceae","Santalales",4,0,0,5,4,1
"Cathestecum","Poaceae","Poales",0,0,0,4,0,NA
"Cathormion","Fabaceae","Fabales",1,0,0,4,1,1
"Catocoryne","Melastomataceae","Myrtales",0,0,0,1,0,NA
"Catoferia","Lamiaceae","Lamiales",0,0,0,4,0,NA
"Catolesia","Asteraceae","Asterales",0,0,0,2,0,NA
"Catolobus","Brassicaceae","Brassicales",0,0,1,1,1,0
"Catophractes","Bignoniaceae","Lamiales",1,0,0,1,1,1
"Catopsis","Bromeliaceae","Poales",0,0,7,21,7,0
"Catostemma","Malvaceae","Malvales",6,0,0,15,6,1
"Cattleya","Orchidaceae","Asparagales",0,0,19,187,19,0
"Catunaregam","Rubiaceae","Gentianales",4,0,0,12,4,1
"Catyclia","Orchidaceae","Asparagales",0,0,0,1,0,NA
"Caucaea","Orchidaceae","Asparagales",0,0,3,9,3,0
"Caucalis","Apiaceae","Apiales",0,0,1,1,1,0
"Caucanthus","Malpighiaceae","Malpighiales",0,1,0,3,0,NA
"Caucasalia","Asteraceae","Asterales",0,0,0,4,0,NA
"Caulanthus","Brassicaceae","Brassicales",0,0,1,13,1,0
"Caularthron","Orchidaceae","Asparagales",0,0,1,4,1,0
"Caulinia","Fabaceae","Fabales",0,0,0,18,0,NA
"Caulokaempferia","Zingiberaceae","Zingiberales",0,0,0,30,0,NA
"Caulophyllum","Berberidaceae","Ranunculales",0,0,2,3,2,0
"Caulostramina","Brassicaceae","Brassicales",0,1,0,1,0,NA
"Caustis","Cyperaceae","Poales",0,0,4,5,4,0
"Cautleya","Zingiberaceae","Zingiberales",0,0,1,2,1,0
"Cavacoa","Euphorbiaceae","Malpighiales",2,0,0,3,2,1
"Cavalcantia","Asteraceae","Asterales",0,0,0,2,0,NA
"Cavanillesia","Malvaceae","Malvales",3,0,0,5,3,1
"Cavea","Asteraceae","Asterales",0,0,0,1,0,NA
"Cavendishia","Ericaceae","Ericales",29,0,0,113,29,1
"Caxamarca","Asteraceae","Asterales",0,0,0,1,0,NA
"Cayaponia","Cucurbitaceae","Cucurbitales",1,0,4,76,5,0.2
"Caylusea","Resedaceae","Brassicales",0,0,3,3,3,0
"Cayratia","Vitaceae","Vitales",3,0,0,67,3,1
"Ceanothus","Rhamnaceae","Rosales",44,0,0,62,44,1
"Cearanthes","Amaryllidaceae","Asparagales",0,0,0,1,0,NA
"Cebatha","Menispermaceae","Ranunculales",0,0,0,1,0,NA
"Cebipira","Fabaceae","Fabales",0,0,0,2,0,NA
"Cecarria","Loranthaceae","Santalales",0,0,0,1,0,NA
"Cecropia","Urticaceae","Rosales",21,0,0,65,21,1
"Cedrela","Meliaceae","Sapindales",8,0,0,17,8,1
"Cedrelinga","Fabaceae","Fabales",1,0,0,1,1,1
"Cedrelopsis","Meliaceae","Sapindales",1,0,0,8,1,1
"Cedronella","Lamiaceae","Lamiales",0,0,0,1,0,NA
"Cedrus","Pinaceae","Pinales",2,0,0,3,2,1
"Ceiba","Malvaceae","Malvales",12,0,0,21,12,1
"Celastrus","Celastraceae","Celastrales",3,0,0,38,3,1
"Celerina","Acanthaceae","Lamiales",0,0,0,1,0,NA
"Celianella","Phyllanthaceae","Malpighiales",0,0,0,1,0,NA
"Celiantha","Gentianaceae","Gentianales",0,0,0,3,0,NA
"Celmearia","Asteraceae","Asterales",0,0,0,1,0,NA
"Celmisia","Asteraceae","Asterales",0,0,4,79,4,0
"Celosia","Amaranthaceae","Caryophyllales",0,0,1,51,1,0
"Celtis","Cannabaceae","Rosales",24,0,0,72,24,1
"Cenarrhenes","Proteaceae","Proteales",1,0,0,1,1,1
"Cenchrus","Poaceae","Poales",0,0,11,23,11,0
"Cenocentrum","Malvaceae","Malvales",0,0,0,1,0,NA
"Cenolophium","Apiaceae","Apiales",0,0,0,1,0,NA
"Cenostigma","Fabaceae","Fabales",2,0,0,3,2,1
"Centaurea","Asteraceae","Asterales",0,0,22,734,22,0
"Centaurium","Gentianaceae","Gentianales",0,0,4,31,4,0
"Centaurodendron","Asteraceae","Asterales",0,0,0,2,0,NA
"Centauropsis","Asteraceae","Asterales",0,0,0,9,0,NA
"Centaurothamnus","Asteraceae","Asterales",0,0,0,1,0,NA
"Centauserratula","Asteraceae","Asterales",0,0,0,1,0,NA
"Centella","Apiaceae","Apiales",0,0,2,53,2,0
"Centema","Amaranthaceae","Caryophyllales",0,0,0,2,0,NA
"Centemopsis","Amaranthaceae","Caryophyllales",0,0,0,13,0,NA
"Centipeda","Asteraceae","Asterales",0,0,3,11,3,0
"Centotheca","Poaceae","Poales",0,0,1,3,1,0
"Centradenia","Melastomataceae","Myrtales",0,0,0,4,0,NA
"Centradeniastrum","Melastomataceae","Myrtales",0,0,0,2,0,NA
"Centranthera","Orobanchaceae","Lamiales",0,0,1,12,1,0
"Centranthus","Caprifoliaceae","Dipsacales",0,0,1,11,1,0
"Centrapalus","Asteraceae","Asterales",0,0,0,1,0,NA
"Centratherum","Asteraceae","Asterales",0,0,0,3,0,NA
"Centrilla","Acanthaceae","Lamiales",0,0,0,1,0,NA
"Centrochloa","Poaceae","Poales",0,0,0,1,0,NA
"Centroglossa","Orchidaceae","Asparagales",0,0,0,6,0,NA
"Centrolepis","Centrolepidaceae","Poales",0,0,9,26,9,0
"Centrolobium","Fabaceae","Fabales",5,0,0,7,5,1
"Centromadia","Asteraceae","Asterales",0,0,0,4,0,NA
"Centronia","Melastomataceae","Myrtales",0,0,0,12,0,NA
"Centroplacus","Centroplacaceae","Malpighiales",0,0,0,1,0,NA
"Centropodia","Poaceae","Poales",0,0,2,4,2,0
"Centropogon","Campanulaceae","Asterales",4,1,1,213,5,0.8
"Centrosema","Fabaceae","Fabales",0,0,1,49,1,0
"Centrostachys","Amaranthaceae","Caryophyllales",0,0,0,1,0,NA
"Centrostegia","Polygonaceae","Caryophyllales",0,0,0,1,0,NA
"Centrostigma","Orchidaceae","Asparagales",0,0,0,3,0,NA
"Cephalacanthus","Acanthaceae","Lamiales",0,0,0,1,0,NA
"Cephalanthera","Orchidaceae","Asparagales",0,0,4,25,4,0
"Cephalantheropsis","Orchidaceae","Asparagales",0,0,0,4,0,NA
"Cephalanthus","Rubiaceae","Gentianales",4,0,0,6,4,1
"Cephalaralia","Araliaceae","Apiales",1,0,0,1,1,1
"Cephalaria","Caprifoliaceae","Dipsacales",2,0,0,88,2,1
"Cephalipterum","Asteraceae","Asterales",0,0,1,1,1,0
"Cephalocarpus","Cyperaceae","Poales",0,0,0,4,0,NA
"Cephaloceraton","Isoëtaceae","Isoetales",0,0,1,1,1,0
"Cephalocereus","Cactaceae","Caryophyllales",0,0,0,5,0,NA
"Cephalocroton","Euphorbiaceae","Malpighiales",0,1,0,4,0,NA
"Cephalocrotonopsis","Euphorbiaceae","Malpighiales",0,0,0,1,0,NA
"Cephalohibiscus","Malvaceae","Malvales",0,0,0,1,0,NA
"Cephalomamillaria","Cactaceae","Caryophyllales",0,0,0,1,0,NA
"Cephalomanes","Hymenophyllaceae","Hymenophyllales",0,0,1,12,1,0
"Cephalomappa","Euphorbiaceae","Malpighiales",1,0,0,5,1,1
"Cephalopactis","Orchidaceae","Asparagales",0,0,0,2,0,NA
"Cephalopappus","Asteraceae","Asterales",0,0,0,1,0,NA
"Cephalopentandra","Cucurbitaceae","Cucurbitales",0,0,1,1,1,0
"Cephalophora","Asteraceae","Asterales",0,0,0,1,0,NA
"Cephalophyllum","Aizoaceae","Caryophyllales",0,0,0,37,0,NA
"Cephalopodum","Apiaceae","Apiales",0,0,0,3,0,NA
"Cephalorchis","Orchidaceae","Asparagales",0,0,0,1,0,NA
"Cephalorhizum","Plumbaginaceae","Caryophyllales",0,0,0,6,0,NA
"Cephalorrhynchus","Asteraceae","Asterales",0,0,0,4,0,NA
"Cephalosorus","Asteraceae","Asterales",0,0,1,1,1,0
"Cephalosphaera","Myristicaceae","Magnoliales",1,0,0,1,1,1
"Cephalostachyum","Poaceae","Poales",1,0,0,16,1,1
"Cephalostemon","Rapateaceae","Poales",0,0,0,5,0,NA
"Cephalotaxus","Taxaceae","Cupressales",1,0,0,8,1,1
"Cephalotomandra","Nyctaginaceae","Caryophyllales",0,0,0,2,0,NA
"Cephalotus","Cephalotaceae","Oxalidales",0,0,1,1,1,0
"Ceradenia","Polypodiaceae","Polypodiales",0,0,0,53,0,NA
"Ceraria","Didiereaceae","Caryophyllales",1,0,0,7,1,1
"Cerasiocarpum","Cucurbitaceae","Cucurbitales",0,0,0,1,0,NA
"Cerastium","Caryophyllaceae","Caryophyllales",0,0,16,205,16,0
"Cerasus","Rosaceae","Rosales",1,0,0,4,1,1
"Ceratandra","Orchidaceae","Asparagales",0,0,0,6,0,NA
"Ceratiola","Ericaceae","Ericales",1,0,0,1,1,1
"Ceratiosicyos","Achariaceae","Malpighiales",0,0,1,1,1,0
"Ceratocapnos","Papaveraceae","Ranunculales",0,0,0,3,0,NA
"Ceratocarpus","Amaranthaceae","Caryophyllales",0,0,1,1,1,0
"Ceratocaryum","Restionaceae","Poales",0,0,1,8,1,0
"Ceratocentron","Orchidaceae","Asparagales",0,0,1,1,1,0
"Ceratocephala","Ranunculaceae","Ranunculales",0,0,2,4,2,0
"Ceratocephalus","Ranunculaceae","Ranunculales",0,0,0,3,0,NA
"Ceratochilus","Orchidaceae","Asparagales",0,0,1,1,1,0
"Ceratochloa","Poaceae","Poales",0,0,0,1,0,NA
"Ceratocnemum","Brassicaceae","Brassicales",0,0,0,1,0,NA
"Ceratogyne","Asteraceae","Asterales",0,0,0,1,0,NA
"Ceratoides","Amaranthaceae","Caryophyllales",1,0,0,1,1,1
"Ceratolacis","Podostemaceae","Malpighiales",0,0,0,2,0,NA
"Ceratolimon","Plumbaginaceae","Caryophyllales",2,0,0,3,2,1
"Ceratolobus","Arecaceae","Arecales",0,0,0,6,0,NA
"Ceratonia","Fabaceae","Fabales",1,0,0,2,1,1
"Ceratopetalum","Cunoniaceae","Oxalidales",4,0,0,8,4,1
"Ceratophyllum","Ceratophyllaceae","Ceratophyllales",0,0,2,4,2,0
"Ceratopteris","Pteridaceae","Polypodiales",0,0,4,5,4,0
"Ceratopyxis","Rubiaceae","Gentianales",0,0,0,1,0,NA
"Ceratosanthes","Cucurbitaceae","Cucurbitales",0,0,1,12,1,0
"Ceratostema","Ericaceae","Ericales",4,0,0,36,4,1
"Ceratostigma","Plumbaginaceae","Caryophyllales",1,0,0,8,1,1
"Ceratostylis","Orchidaceae","Asparagales",0,0,0,147,0,NA
"Ceratotheca","Pedaliaceae","Lamiales",0,0,1,5,1,0
"Ceratozamia","Zamiaceae","Cycadales",15,0,0,25,15,1
"Cerbera","Apocynaceae","Gentianales",4,0,0,6,4,1
"Cerberiopsis","Apocynaceae","Gentianales",3,0,0,3,3,1
"Cercestis","Araceae","Alismatales",0,0,2,10,2,0
"Cercidiphyllum","Cercidiphyllaceae","Saxifragales",1,0,0,2,1,1
"Cercidium","Fabaceae","Fabales",3,0,0,5,3,1
"Cercis","Fabaceae","Fabales",4,0,0,10,4,1
"Cercocarpus","Rosaceae","Rosales",3,0,0,5,3,1
"Cerdia","Caryophyllaceae","Caryophyllales",0,0,0,1,0,NA
"Cereus","Cactaceae","Caryophyllales",2,0,0,48,2,1
"Cerinthe","Boraginaceae","UnknownOrder-Boraginaceae",0,0,1,6,1,0
"Cerinthodes","Boraginaceae","UnknownOrder-Boraginaceae",0,0,0,1,0,NA
"Ceriops","Rhizophoraceae","Malpighiales",3,0,0,5,3,1
"Ceriosperma","Brassicaceae","Brassicales",0,0,0,1,0,NA
"Ceriscoides","Rubiaceae","Gentianales",1,0,0,11,1,1
"Cerochlamys","Aizoaceae","Caryophyllales",0,0,0,4,0,NA
"Ceropegia","Apocynaceae","Gentianales",0,1,0,217,0,NA
"Ceropteris","Pteridaceae","Polypodiales",0,0,0,1,0,NA
"Cerosora","Pteridaceae","Polypodiales",0,0,0,2,0,NA
"Cerothamnus","Myricaceae","Fagales",0,0,0,1,0,NA
"Ceroxylon","Arecaceae","Arecales",10,0,0,12,10,1
"Ceruana","Asteraceae","Asterales",0,0,0,1,0,NA
"Cervantesia","Santalaceae","Santalales",2,0,0,2,2,1
"Cespedesia","Ochnaceae","Malpighiales",1,0,0,1,1,1
"Cestrum","Solanaceae","Solanales",6,0,0,247,6,1
"Ceterach","Aspleniaceae","Polypodiales",0,0,1,2,1,0
"Ceterachopsis","Aspleniaceae","Polypodiales",0,0,0,3,0,NA
"Ceuthocarpus","Rubiaceae","Gentianales",0,0,0,1,0,NA
"Ceuthostoma","Casuarinaceae","Fagales",2,0,0,2,2,1
"Cevallia","Loasaceae","Cornales",0,1,0,1,0,NA
"Chacoa","Asteraceae","Asterales",0,0,0,1,0,NA
"Chadsia","Fabaceae","Fabales",1,0,0,9,1,1
"Chaenactis","Asteraceae","Asterales",0,0,1,19,1,0
"Chaenomeles","Rosaceae","Rosales",5,0,0,6,5,1
"Chaenorhinum","Plantaginaceae","Lamiales",0,0,1,25,1,0
"Chaenostoma","Scrophulariaceae","Lamiales",0,0,4,46,4,0
"Chaerophyllopsis","Apiaceae","Apiales",0,0,0,1,0,NA
"Chaerophyllum","Apiaceae","Apiales",1,0,3,46,4,0.25
"Chaetacanthus","Acanthaceae","Lamiales",0,0,0,3,0,NA
"Chaetachme","Ulmaceae","Rosales",1,0,0,1,1,1
"Chaetadelpha","Asteraceae","Asterales",0,0,0,1,0,NA
"Chaetanthera","Asteraceae","Asterales",0,0,0,49,0,NA
"Chaetanthus","Restionaceae","Poales",0,0,1,3,1,0
"Chaetium","Poaceae","Poales",0,0,0,3,0,NA
"Chaetobromus","Poaceae","Poales",0,0,1,1,1,0
"Chaetocalyx","Fabaceae","Fabales",0,0,0,16,0,NA
"Chaetocarpus","Peraceae","Malpighiales",4,0,0,16,4,1
"Chaetocyperus","Cyperaceae","Poales",0,0,0,1,0,NA
"Chaetolepis","Melastomataceae","Myrtales",0,0,0,13,0,NA
"Chaetolimon","Plumbaginaceae","Caryophyllales",0,0,0,3,0,NA
"Chaetonychia","Caryophyllaceae","Caryophyllales",0,0,0,1,0,NA
"Chaetopappa","Asteraceae","Asterales",0,0,0,11,0,NA
"Chaetopoa","Poaceae","Poales",0,0,0,2,0,NA
"Chaetopogon","Poaceae","Poales",0,0,0,1,0,NA
"Chaetosciadium","Apiaceae","Apiales",0,0,0,1,0,NA
"Chaetoseris","Asteraceae","Asterales",0,0,0,23,0,NA
"Chaetostachydium","Rubiaceae","Gentianales",0,0,0,3,0,NA
"Chaetostoma","Melastomataceae","Myrtales",0,0,0,11,0,NA
"Chaetymenia","Asteraceae","Asterales",1,0,0,1,1,1
"Chaiturus","Lamiaceae","Lamiales",0,0,1,1,1,0
"Chalarothyrsus","Acanthaceae","Lamiales",0,0,0,1,0,NA
"Chalcanthus","Brassicaceae","Brassicales",0,0,1,1,1,0
"Chalema","Cucurbitaceae","Cucurbitales",0,0,1,1,1,0
"Chalepophyllum","Rubiaceae","Gentianales",0,0,0,2,0,NA
"Chamabainia","Urticaceae","Rosales",0,0,0,1,0,NA
"Chamaeangis","Orchidaceae","Asparagales",0,0,4,11,4,0
"Chamaeanthus","Orchidaceae","Asparagales",0,0,0,2,0,NA
"Chamaebatia","Rosaceae","Rosales",2,0,0,2,2,1
"Chamaebatiaria","Rosaceae","Rosales",1,0,0,1,1,1
"Chamaechaenactis","Asteraceae","Asterales",0,0,1,1,1,0
"Chamaeclitandra","Apocynaceae","Gentianales",0,0,0,1,0,NA
"Chamaecostus","Costaceae","Zingiberales",4,0,0,7,4,1
"Chamaecrista","Fabaceae","Fabales",4,1,4,330,8,0.5
"Chamaecyparis","Cupressaceae","Cupressales",3,0,0,5,3,1
"Chamaecytisus","Fabaceae","Fabales",1,0,0,14,1,1
"Chamaedaphne","Ericaceae","Ericales",1,0,0,1,1,1
"Chamaedorea","Arecaceae","Arecales",77,0,0,107,77,1
"Chamaefilix","Aspleniaceae","Polypodiales",0,0,0,2,0,NA
"Chamaefistula","Fabaceae","Fabales",0,0,0,4,0,NA
"Chamaegastrodia","Orchidaceae","Asparagales",0,0,0,3,0,NA
"Chamaegeron","Asteraceae","Asterales",0,0,0,4,0,NA
"Chamaele","Apiaceae","Apiales",0,0,1,1,1,0
"Chamaeleon","Asteraceae","Asterales",0,0,0,1,0,NA
"Chamaeleorchis","Orchidaceae","Asparagales",0,0,0,1,0,NA
"Chamaelirium","Melanthiaceae","Liliales",0,0,1,1,1,0
"Chamaemeles","Rosaceae","Rosales",0,0,0,1,0,NA
"Chamaemelum","Asteraceae","Asterales",0,0,1,4,1,0
"Chamaepentas","Rubiaceae","Gentianales",0,0,0,6,0,NA
"Chamaepericlymenum","Cornaceae","Cornales",0,0,0,1,0,NA
"Chamaepus","Asteraceae","Asterales",0,0,0,1,0,NA
"Chamaeranthemum","Acanthaceae","Lamiales",0,0,0,4,0,NA
"Chamaeraphis","Poaceae","Poales",0,0,0,1,0,NA
"Chamaerhodos","Rosaceae","Rosales",0,0,0,6,0,NA
"Chamaerops","Arecaceae","Arecales",1,0,0,1,1,1
"Chamaesaracha","Solanaceae","Solanales",0,0,0,13,0,NA
"Chamaesciadium","Apiaceae","Apiales",0,0,0,1,0,NA
"Chamaescilla","Asparagaceae","Asparagales",0,0,2,3,2,0
"Chamaesium","Apiaceae","Apiales",0,0,0,6,0,NA
"Chamaespartium","Fabaceae","Fabales",1,0,0,2,1,1
"Chamaesphacos","Lamiaceae","Lamiales",0,0,0,1,0,NA
"Chamaesyce","Euphorbiaceae","Malpighiales",0,0,0,2,0,NA
"Chamaexeros","Asparagaceae","Asparagales",0,0,0,4,0,NA
"Chamarea","Apiaceae","Apiales",0,0,0,5,0,NA
"Chambeyronia","Arecaceae","Arecales",1,0,0,2,1,1
"Chamelaucium","Myrtaceae","Myrtales",4,0,0,13,4,1
"Chamelophyton","Orchidaceae","Asparagales",0,0,0,1,0,NA
"Chamerion","Onagraceae","Myrtales",0,0,0,1,0,NA
"Chamguava","Myrtaceae","Myrtales",1,0,0,3,1,1
"Chamira","Brassicaceae","Brassicales",0,0,1,1,1,0
"Chamissoa","Amaranthaceae","Caryophyllales",0,0,0,2,0,NA
"Chamorchis","Orchidaceae","Asparagales",0,0,1,1,1,0
"Champereia","Opiliaceae","Santalales",1,0,0,1,1,1
"Championia","Gesneriaceae","Lamiales",0,0,0,1,0,NA
"Chandrasekharania","Poaceae","Poales",0,0,0,1,0,NA
"Changiostyrax","Styracaceae","Ericales",0,0,0,1,0,NA
"Changium","Apiaceae","Apiales",0,0,0,2,0,NA
"Changnienia","Orchidaceae","Asparagales",0,0,0,1,0,NA
"Chapelieria","Rubiaceae","Gentianales",0,0,0,1,0,NA
"Chapmannia","Fabaceae","Fabales",0,0,0,4,0,NA
"Chaptalia","Asteraceae","Asterales",0,0,1,68,1,0
"Charadranaetes","Asteraceae","Asterales",0,0,0,1,0,NA
"Charadrophila","Stilbaceae","Lamiales",0,0,0,1,0,NA
"Chardinia","Asteraceae","Asterales",0,0,1,1,1,0
"Charianthus","Melastomataceae","Myrtales",0,0,0,2,0,NA
"Charpentiera","Amaranthaceae","Caryophyllales",2,0,0,6,2,1
"Chartoloma","Brassicaceae","Brassicales",0,0,0,1,0,NA
"Chascanum","Verbenaceae","Lamiales",0,0,0,32,0,NA
"Chascolytrum","Poaceae","Poales",0,0,0,4,0,NA
"Chascotheca","Phyllanthaceae","Malpighiales",1,0,0,2,1,1
"Chaseella","Orchidaceae","Asparagales",0,0,0,1,0,NA
"Chasmanthe","Iridaceae","Asparagales",0,0,3,3,3,0
"Chasmanthera","Menispermaceae","Ranunculales",2,0,0,2,2,1
"Chasmanthium","Poaceae","Poales",0,0,3,5,3,0
"Chasmatophyllum","Aizoaceae","Caryophyllales",0,0,0,8,0,NA
"Chasmone","Fabaceae","Fabales",0,0,0,1,0,NA
"Chasmopodium","Poaceae","Poales",0,0,0,2,0,NA
"Chassalia","Rubiaceae","Gentianales",7,0,0,112,7,1
"Chaubardia","Orchidaceae","Asparagales",0,0,3,3,3,0
"Chaubardiella","Orchidaceae","Asparagales",0,0,4,8,4,0
"Chauliodon","Orchidaceae","Asparagales",0,0,0,1,0,NA
"Chaunanthus","Brassicaceae","Brassicales",0,0,0,4,0,NA
"Chaunochiton","Olacaceae","Santalales",3,0,0,3,3,1
"Chaunostoma","Lamiaceae","Lamiales",0,0,0,1,0,NA
"Chautemsia","Gesneriaceae","Lamiales",0,0,0,1,0,NA
"Chaydaia","Rhamnaceae","Rosales",0,0,0,2,0,NA
"Chazaliella","Rubiaceae","Gentianales",1,0,0,20,1,1
"Cheilanthes","Pteridaceae","Polypodiales",0,0,7,176,7,0
"Cheilanthopsis","Woodsiaceae","Polypodiales",0,0,0,1,0,NA
"Cheiloclinium","Celastraceae","Celastrales",3,0,0,15,3,1
"Cheilocostus","Costaceae","Zingiberales",1,1,0,5,1,1
"Cheilophyllum","Scrophulariaceae","Lamiales",0,0,0,8,0,NA
"Cheiloplecton","Pteridaceae","Polypodiales",0,0,0,1,0,NA
"Cheilosa","Euphorbiaceae","Malpighiales",1,0,0,1,1,1
"Cheilosoria","Pteridaceae","Polypodiales",0,0,0,7,0,NA
"Cheilotheca","Ericaceae","Ericales",0,0,0,3,0,NA
"Cheiradenia","Orchidaceae","Asparagales",0,0,0,1,0,NA
"Cheiranthera","Pittosporaceae","Apiales",2,0,0,10,2,1
"Cheiridopsis","Aizoaceae","Caryophyllales",0,0,0,35,0,NA
"Cheirinia","Brassicaceae","Brassicales",0,0,0,1,0,NA
"Cheirodendron","Araliaceae","Apiales",2,0,0,6,2,1
"Cheiroglossa","Ophioglossaceae","Ophioglossales",0,0,0,1,0,NA
"Cheirolaena","Malvaceae","Malvales",0,0,0,1,0,NA
"Cheirolophus","Asteraceae","Asterales",0,0,1,26,1,0
"Cheiropleuria","Dipteridaceae","Gleicheniales",0,0,0,1,0,NA
"Cheirostylis","Orchidaceae","Asparagales",0,0,0,54,0,NA
"Chelidonium","Papaveraceae","Ranunculales",0,0,1,2,1,0
"Chelonanthus","Gentianaceae","Gentianales",0,0,0,9,0,NA
"Chelone","Plantaginaceae","Lamiales",0,0,1,5,1,0
"Chelonistele","Orchidaceae","Asparagales",0,0,2,13,2,0
"Chelonopsis","Lamiaceae","Lamiales",0,0,0,16,0,NA
"Chelyocarpus","Arecaceae","Arecales",4,0,0,4,4,1
"Chengiopanax","Araliaceae","Apiales",1,0,0,2,1,1
"Chenolea","Amaranthaceae","Caryophyllales",0,0,0,1,0,NA
"Chenopodiopsis","Scrophulariaceae","Lamiales",0,0,1,3,1,0
"Chenopodium","Amaranthaceae","Caryophyllales",5,0,12,150,17,0.294117647058824
"Chersodoma","Asteraceae","Asterales",0,0,0,9,0,NA
"Chesneya","Fabaceae","Fabales",0,0,0,45,0,NA
"Chesniella","Fabaceae","Fabales",0,0,0,1,0,NA
"Chevalierella","Poaceae","Poales",0,0,0,1,0,NA
"Chevreulia","Asteraceae","Asterales",0,0,0,7,0,NA
"Cheyniana","Myrtaceae","Myrtales",0,0,0,2,0,NA
"Chiangiodendron","Achariaceae","Malpighiales",1,0,0,1,1,1
"Chiastophyllum","Crassulaceae","Saxifragales",0,0,0,1,0,NA
"Chichicaste","Loasaceae","Cornales",0,0,1,1,1,0
"Chidlowia","Fabaceae","Fabales",0,0,0,1,0,NA
"Chieniodendron","Annonaceae","Magnoliales",0,0,0,1,0,NA
"Chieniopteris","Blechnaceae","Polypodiales",0,0,0,1,0,NA
"Chihuahuana","Asteraceae","Asterales",0,0,0,1,0,NA
"Chikusichloa","Poaceae","Poales",0,0,1,3,1,0
"Chileranthemum","Acanthaceae","Lamiales",0,0,0,3,0,NA
"Chiliadenus","Asteraceae","Asterales",0,0,0,10,0,NA
"Chiliocephalum","Asteraceae","Asterales",0,0,0,2,0,NA
"Chiliophyllum","Asteraceae","Asterales",0,0,0,3,0,NA
"Chiliotrichiopsis","Asteraceae","Asterales",0,0,0,4,0,NA
"Chiliotrichum","Asteraceae","Asterales",2,0,0,4,2,1
"Chilocardamum","Brassicaceae","Brassicales",0,0,0,4,0,NA
"Chilocarpus","Apocynaceae","Gentianales",1,0,0,14,1,1
"Chiloglottis","Orchidaceae","Asparagales",0,0,1,24,1,0
"Chilopogon","Orchidaceae","Asparagales",0,0,0,2,0,NA
"Chilopsis","Bignoniaceae","Lamiales",1,0,0,1,1,1
"Chiloschista","Orchidaceae","Asparagales",0,0,1,20,1,0
"Chimantaea","Asteraceae","Asterales",0,0,0,9,0,NA
"Chimaphila","Ericaceae","Ericales",1,0,0,5,1,1
"Chimarrhis","Rubiaceae","Gentianales",7,0,0,15,7,1
"Chimborazoa","Sapindaceae","Sapindales",0,0,0,1,0,NA
"Chimonanthus","Calycanthaceae","Laurales",2,0,0,5,2,1
"Chimonobambusa","Poaceae","Poales",2,0,0,37,2,1
"Chimonocalamus","Poaceae","Poales",0,0,0,16,0,NA
"Chingia","Thelypteridaceae","Polypodiales",0,0,0,1,0,NA
"Chiococca","Rubiaceae","Gentianales",1,0,0,25,1,1
"Chionachne","Poaceae","Poales",0,0,1,9,1,0
"Chionanthus","Oleaceae","Lamiales",20,0,0,147,20,1
"Chione","Rubiaceae","Gentianales",0,0,0,1,0,NA
"Chionocharis","Boraginaceae","UnknownOrder-Boraginaceae",0,0,0,1,0,NA
"Chionochloa","Poaceae","Poales",0,0,22,25,22,0
"Chionographis","Melanthiaceae","Liliales",0,0,2,6,2,0
"Chionolaena","Asteraceae","Asterales",0,0,0,21,0,NA
"Chionopappus","Asteraceae","Asterales",0,0,0,1,0,NA
"Chionophila","Plantaginaceae","Lamiales",0,0,2,2,2,0
"Chionothrix","Amaranthaceae","Caryophyllales",0,0,0,2,0,NA
"Chiovendaea","Fabaceae","Fabales",0,0,0,1,0,NA
"Chiranthodendron","Malvaceae","Malvales",1,0,0,1,1,1
"Chirita","Gesneriaceae","Lamiales",0,0,0,2,0,NA
"Chironia","Gentianaceae","Gentianales",0,0,0,25,0,NA
"Chiropetalum","Euphorbiaceae","Malpighiales",0,0,0,23,0,NA
"Chisocheton","Meliaceae","Sapindales",9,0,0,50,9,1
"Chlaenandra","Menispermaceae","Ranunculales",0,0,0,1,0,NA
"Chlaenobolus","Asteraceae","Asterales",0,0,0,1,0,NA
"Chlaenosciadium","Apiaceae","Apiales",0,0,0,1,0,NA
"Chlamydacanthus","Acanthaceae","Lamiales",0,0,0,4,0,NA
"Chlamydocardia","Acanthaceae","Lamiales",0,0,0,3,0,NA
"Chlamydocarya","Icacinaceae","UnknownOrder-Icacinaceae",2,0,0,7,2,1
"Chlamydogramme","Tectariaceae","Polypodiales",0,0,0,1,0,NA
"Chlamydojatropha","Euphorbiaceae","Malpighiales",0,0,0,1,0,NA
"Chlamydophora","Asteraceae","Asterales",0,0,0,1,0,NA
"Chlamydophytum","Balanophoraceae","Santalales",0,0,0,1,0,NA
"Chlamydostachya","Acanthaceae","Lamiales",0,0,0,1,0,NA
"Chlamysperma","Asteraceae","Asterales",0,0,0,1,0,NA
"Chlidanthus","Amaryllidaceae","Asparagales",0,0,1,4,1,0
"Chloanthes","Lamiaceae","Lamiales",0,0,0,4,0,NA
"Chloracantha","Asteraceae","Asterales",0,0,0,1,0,NA
"Chloraea","Orchidaceae","Asparagales",0,0,1,53,1,0
"Chloranthus","Chloranthaceae","Chloranthales",1,0,7,14,8,0.125
"Chloris","Poaceae","Poales",0,0,8,63,8,0
"Chlorocalymma","Poaceae","Poales",0,0,0,1,0,NA
"Chlorocardium","Lauraceae","Laurales",2,0,0,2,2,1
"Chlorocarpa","Achariaceae","Malpighiales",0,0,0,1,0,NA
"Chlorocrambe","Brassicaceae","Brassicales",0,0,0,1,0,NA
"Chlorocyathus","Apocynaceae","Gentianales",0,0,0,2,0,NA
"Chlorogalum","Asparagaceae","Asparagales",0,0,3,5,3,0
"Chloroleucon","Fabaceae","Fabales",3,0,0,10,3,1
"Chlorophytum","Asparagaceae","Asparagales",0,0,15,196,15,0
"Chlorospatha","Araceae","Alismatales",0,0,0,28,0,NA
"Chloroxylon","Rutaceae","Sapindales",1,0,0,1,1,1
"Choerospondias","Anacardiaceae","Sapindales",1,0,0,1,1,1
"Choisya","Rutaceae","Sapindales",1,0,0,5,1,1
"Chomelia","Rubiaceae","Gentianales",5,0,0,79,5,1
"Chondrilla","Asteraceae","Asterales",0,0,2,41,2,0
"Chondrodendron","Menispermaceae","Ranunculales",1,0,0,6,1,1
"Chondropyxis","Asteraceae","Asterales",0,0,0,1,0,NA
"Chondrorhyncha","Orchidaceae","Asparagales",0,0,2,7,2,0
"Chondroscaphe","Orchidaceae","Asparagales",0,0,7,14,7,0
"Chondrostylis","Euphorbiaceae","Malpighiales",1,0,0,2,1,1
"Chondrosum","Poaceae","Poales",0,0,1,15,1,0
"Chonemorpha","Apocynaceae","Gentianales",0,1,0,10,0,NA
"Chonocentrum","Phyllanthaceae","Malpighiales",0,0,0,1,0,NA
"Chonopetalum","Sapindaceae","Sapindales",0,0,0,1,0,NA
"Chordifex","Restionaceae","Poales",0,0,10,20,10,0
"Chordospartium","Fabaceae","Fabales",0,0,0,2,0,NA
"Choretrum","Santalaceae","Santalales",0,0,0,6,0,NA
"Choriantha","Boraginaceae","UnknownOrder-Boraginaceae",0,0,0,1,0,NA
"Choricarpia","Myrtaceae","Myrtales",1,0,0,2,1,1
"Choriceras","Picrodendraceae","Malpighiales",1,0,0,2,1,1
"Chorigyne","Cyclanthaceae","Pandanales",0,0,2,7,2,0
"Chorilaena","Rutaceae","Sapindales",1,0,0,1,1,1
"Choriptera","Amaranthaceae","Caryophyllales",0,0,0,1,0,NA
"Chorisandrachne","Phyllanthaceae","Malpighiales",1,0,0,1,1,1
"Chorisepalum","Gentianaceae","Gentianales",0,0,0,5,0,NA
"Chorisiva","Asteraceae","Asterales",0,0,0,1,0,NA
"Chorisochora","Acanthaceae","Lamiales",0,0,0,3,0,NA
"Chorispora","Brassicaceae","Brassicales",0,0,1,13,1,0
"Choristemon","Ericaceae","Ericales",0,0,0,1,0,NA
"Choristosoria","Pteridaceae","Polypodiales",0,0,0,1,0,NA
"Choristylis","Iteaceae","Saxifragales",1,0,0,1,1,1
"Choritaenia","Apiaceae","Apiales",0,0,0,1,0,NA
"Chorizandra","Cyperaceae","Poales",0,0,3,5,3,0
"Chorizanthe","Polygonaceae","Caryophyllales",0,0,0,64,0,NA
"Chorizema","Fabaceae","Fabales",1,0,0,20,1,1
"Chortolirion","Xanthorrhoeaceae","Asparagales",0,0,1,3,1,0
"Chouxia","Sapindaceae","Sapindales",0,0,0,6,0,NA
"Chresta","Asteraceae","Asterales",0,0,0,14,0,NA
"Christella","Thelypteridaceae","Polypodiales",1,0,0,20,1,1
"Christensenia","Marattiaceae","Marattiales",0,0,2,2,2,0
"Christensonella","Orchidaceae","Asparagales",0,0,13,17,13,0
"Christensonia","Orchidaceae","Asparagales",0,0,1,1,1,0
"Christia","Fabaceae","Fabales",0,0,0,12,0,NA
"Christiana","Malvaceae","Malvales",1,0,0,5,1,1
"Christianella","Malpighiaceae","Malpighiales",0,0,0,5,0,NA
"Christiopteris","Polypodiaceae","Polypodiales",0,0,0,2,0,NA
"Christisonia","Orobanchaceae","Lamiales",0,0,0,20,0,NA
"Christolea","Brassicaceae","Brassicales",0,0,1,5,1,0
"Chroesthes","Acanthaceae","Lamiales",0,0,0,3,0,NA
"Chromolaena","Asteraceae","Asterales",1,0,1,175,2,0.5
"Chromolepis","Asteraceae","Asterales",0,0,1,1,1,0
"Chromolucuma","Sapotaceae","Ericales",2,0,0,2,2,1
"Chronanthos","Fabaceae","Fabales",0,0,0,3,0,NA
"Chroniochilus","Orchidaceae","Asparagales",0,0,0,5,0,NA
"Chronopappus","Asteraceae","Asterales",0,0,0,1,0,NA
"Chrozophora","Euphorbiaceae","Malpighiales",1,0,0,9,1,1
"Chrysactinia","Asteraceae","Asterales",0,0,0,6,0,NA
"Chrysactinium","Asteraceae","Asterales",0,0,0,7,0,NA
"Chrysanthellum","Asteraceae","Asterales",0,0,0,11,0,NA
"Chrysanthemoides","Asteraceae","Asterales",0,0,0,2,0,NA
"Chrysanthemum","Asteraceae","Asterales",0,0,3,42,3,0
"Chrysanthoglossum","Asteraceae","Asterales",0,0,0,2,0,NA
"Chrysitrix","Cyperaceae","Poales",0,0,1,4,1,0
"Chrysobalanus","Chrysobalanaceae","Malpighiales",1,0,0,3,1,1
"Chrysocephalum","Asteraceae","Asterales",0,0,2,9,2,0
"Chrysochamela","Brassicaceae","Brassicales",0,0,0,4,0,NA
"Chrysochlamys","Clusiaceae","Malpighiales",8,0,0,34,8,1
"Chrysochloa","Poaceae","Poales",0,0,0,4,0,NA
"Chrysochosma","Pteridaceae","Polypodiales",0,0,0,5,0,NA
"Chrysocoma","Asteraceae","Asterales",0,0,0,24,0,NA
"Chrysodium","Pteridaceae","Polypodiales",0,0,1,1,1,0
"Chrysoglossum","Orchidaceae","Asparagales",0,0,0,4,0,NA
"Chrysogonum","Asteraceae","Asterales",0,0,0,2,0,NA
"Chrysogrammitis","Polypodiaceae","Polypodiales",0,0,0,1,0,NA
"Chrysolaena","Asteraceae","Asterales",0,0,0,18,0,NA
"Chrysolepis","Fagaceae","Fagales",2,0,0,2,2,1
"Chrysoma","Asteraceae","Asterales",0,0,0,1,0,NA
"Chrysophthalmum","Asteraceae","Asterales",0,0,2,4,2,0
"Chrysophyllum","Sapotaceae","Ericales",52,0,0,89,52,1
"Chrysopogon","Poaceae","Poales",0,0,4,48,4,0
"Chrysopsis","Asteraceae","Asterales",0,0,0,12,0,NA
"Chrysopteris","Polypodiaceae","Polypodiales",0,0,0,1,0,NA
"Chrysosplenium","Saxifragaceae","Saxifragales",0,0,14,73,14,0
"Chrysothamnus","Asteraceae","Asterales",3,0,0,11,3,1
"Chrysothemis","Gesneriaceae","Lamiales",0,0,1,7,1,0
"Chthonocephalus","Asteraceae","Asterales",0,0,1,7,1,0
"Chuanminshen","Apiaceae","Apiales",0,0,0,1,0,NA
"Chucoa","Asteraceae","Asterales",0,0,0,2,0,NA
"Chukrasia","Meliaceae","Sapindales",1,0,0,1,1,1
"Chunia","Hamamelidaceae","Saxifragales",1,0,0,1,1,1
"Chuniophoenix","Arecaceae","Arecales",1,0,0,3,1,1
"Chuquiraga","Asteraceae","Asterales",5,0,0,23,5,1
"Chusquea","Poaceae","Poales",8,0,0,157,8,1
"Chusua","Orchidaceae","Asparagales",0,0,0,1,0,NA
"Chydenanthus","Lecythidaceae","Ericales",1,0,0,1,1,1
"Chylismia","Onagraceae","Myrtales",0,0,0,16,0,NA
"Chylismiella","Onagraceae","Myrtales",0,0,0,1,0,NA
"Chymsydia","Apiaceae","Apiales",0,0,0,2,0,NA
"Chysis","Orchidaceae","Asparagales",0,0,1,10,1,0
"Chytraculia","Myrtaceae","Myrtales",0,0,0,1,0,NA
"Chytranthus","Sapindaceae","Sapindales",6,0,0,35,6,1
"Chytroglossa","Orchidaceae","Asparagales",0,0,0,3,0,NA
"Cibirhiza","Apocynaceae","Gentianales",1,0,0,3,1,1
"Cibotium","Cibotiaceae","Cyatheales",3,0,0,8,3,1
"Cicendia","Gentianaceae","Gentianales",0,0,0,3,0,NA
"Cicer","Fabaceae","Fabales",0,0,7,44,7,0
"Cicerbita","Asteraceae","Asterales",0,0,0,16,0,NA
"Ciceronia","Asteraceae","Asterales",0,0,0,1,0,NA
"Cichorium","Asteraceae","Asterales",1,0,1,10,2,0.5
"Cicuta","Apiaceae","Apiales",0,0,1,5,1,0
"Cienfuegosia","Malvaceae","Malvales",3,0,0,31,3,1
"Ciliosemina","Rubiaceae","Gentianales",1,0,0,2,1,1
"Cimicifuga","Ranunculaceae","Ranunculales",0,0,0,1,0,NA
"Cinchona","Rubiaceae","Gentianales",5,0,0,25,5,1
"Cinchonopsis","Rubiaceae","Gentianales",1,0,0,1,1,1
"Cincinalis","Dennstaedtiaceae","Polypodiales",0,0,0,1,0,NA
"Cincinnobotrys","Melastomataceae","Myrtales",0,0,0,4,0,NA
"Cineraria","Asteraceae","Asterales",0,0,0,51,0,NA
"Cinna","Poaceae","Poales",0,0,2,4,2,0
"Cinnadenia","Lauraceae","Laurales",0,0,0,2,0,NA
"Cinnamodendron","Canellaceae","Canellales",5,0,0,10,5,1
"Cinnamomum","Lauraceae","Laurales",48,0,0,342,48,1
"Cinnamosma","Canellaceae","Canellales",2,0,0,3,2,1
"Cionosicyos","Cucurbitaceae","Cucurbitales",0,0,0,3,0,NA
"Cionosicys","Cucurbitaceae","Cucurbitales",0,0,0,1,0,NA
"Cionura","Apocynaceae","Gentianales",0,0,0,1,0,NA
"Cipadessa","Meliaceae","Sapindales",1,0,0,1,1,1
"Cipocereus","Cactaceae","Caryophyllales",0,0,0,5,0,NA
"Cipoia","Podostemaceae","Malpighiales",0,0,0,2,0,NA
"Cipura","Iridaceae","Asparagales",0,0,2,8,2,0
"Circaea","Onagraceae","Myrtales",0,0,3,15,3,0
"Circaeaster","Circaeasteraceae","Ranunculales",0,0,1,1,1,0
"Circandra","Aizoaceae","Caryophyllales",0,0,0,1,0,NA
"Cirrhaea","Orchidaceae","Asparagales",0,0,1,7,1,0
"Cirrhopetalum","Orchidaceae","Asparagales",0,0,0,1,0,NA
"Cirsiocarduus","Asteraceae","Asterales",0,0,0,6,0,NA
"Cirsium","Asteraceae","Asterales",1,0,16,481,17,0.0588235294117647
"Cischweinfia","Orchidaceae","Asparagales",0,0,1,11,1,0
"Cissampelopsis","Asteraceae","Asterales",0,0,0,11,0,NA
"Cissampelos","Menispermaceae","Ranunculales",1,5,0,21,1,1
"Cissarobryon","Vivianiaceae","Geraniales",0,0,0,1,0,NA
"Cissus","Vitaceae","Vitales",8,1,0,324,8,1
"Cistanche","Orobanchaceae","Lamiales",0,0,0,27,0,NA
"Cistanthe","Portulacaceae","Caryophyllales",0,0,13,38,13,0
"Cistus","Cistaceae","Malvales",13,0,0,52,13,1
"Cithareloma","Brassicaceae","Brassicales",0,0,0,2,0,NA
"Citharexylum","Verbenaceae","Lamiales",12,0,0,114,12,1
"Citriobatus","Pittosporaceae","Apiales",2,0,0,5,2,1
"Citronella","Cardiopteridaceae","Aquifoliales",7,0,0,22,7,1
"Citropsis","Rutaceae","Sapindales",1,0,0,10,1,1
"Citrullus","Cucurbitaceae","Cucurbitales",0,0,2,4,2,0
"Citrus","Rutaceae","Sapindales",6,0,0,33,6,1
"Cladanthus","Asteraceae","Asterales",0,0,0,5,0,NA
"Claderia","Orchidaceae","Asparagales",0,0,0,2,0,NA
"Cladium","Cyperaceae","Poales",0,0,2,5,2,0
"Cladoceras","Rubiaceae","Gentianales",0,0,0,1,0,NA
"Cladochaeta","Asteraceae","Asterales",0,0,0,1,0,NA
"Cladocolea","Loranthaceae","Santalales",1,0,0,36,1,1
"Cladogelonium","Euphorbiaceae","Malpighiales",0,0,0,1,0,NA
"Cladogynos","Euphorbiaceae","Malpighiales",0,0,0,1,0,NA
"Cladomyza","Santalaceae","Santalales",0,0,0,23,0,NA
"Cladopus","Podostemaceae","Malpighiales",0,0,1,10,1,0
"Cladoraphis","Poaceae","Poales",1,0,0,2,1,1
"Cladostemon","Capparaceae","Brassicales",1,0,0,1,1,1
"Cladostigma","Convolvulaceae","Solanales",0,0,0,1,0,NA
"Cladrastis","Fabaceae","Fabales",5,0,0,8,5,1
"Claoxylon","Euphorbiaceae","Malpighiales",6,0,0,114,6,1
"Claoxylopsis","Euphorbiaceae","Malpighiales",0,0,0,3,0,NA
"Clappertonia","Malvaceae","Malvales",0,0,0,3,0,NA
"Clappia","Asteraceae","Asterales",1,0,0,1,1,1
"Clara","Asparagaceae","Asparagales",0,0,0,3,0,NA
"Clarisia","Moraceae","Rosales",3,0,0,3,3,1
"Clarkeasia","Acanthaceae","Lamiales",0,0,0,1,0,NA
"Clarkella","Rubiaceae","Gentianales",0,0,0,1,0,NA
"Clarkia","Onagraceae","Myrtales",0,0,1,42,1,0
"Clastopus","Brassicaceae","Brassicales",0,0,0,2,0,NA
"Clathrotropis","Fabaceae","Fabales",3,0,0,6,3,1
"Clausena","Rutaceae","Sapindales",2,0,0,21,2,1
"Clausia","Brassicaceae","Brassicales",0,0,0,6,0,NA
"Clausospicula","Poaceae","Poales",0,0,0,1,0,NA
"Clavija","Primulaceae","Ericales",4,0,0,54,4,1
"Clavulium","Fabaceae","Fabales",0,0,0,1,0,NA
"Claytonia","Montiaceae","Caryophyllales",0,0,9,29,9,0
"Cleghornia","Apocynaceae","Gentianales",1,0,0,2,1,1
"Cleidiocarpon","Euphorbiaceae","Malpighiales",0,0,0,2,0,NA
"Cleidion","Euphorbiaceae","Malpighiales",10,0,0,32,10,1
"Cleisocentron","Orchidaceae","Asparagales",0,0,1,5,1,0
"Cleisomeria","Orchidaceae","Asparagales",0,0,1,2,1,0
"Cleisostoma","Orchidaceae","Asparagales",0,0,1,88,1,0
"Cleisostomopsis","Orchidaceae","Asparagales",0,0,0,2,0,NA
"Cleistachne","Poaceae","Poales",0,0,1,1,1,0
"Cleistanthus","Phyllanthaceae","Malpighiales",10,0,0,133,10,1
"Cleistes","Orchidaceae","Asparagales",0,0,2,66,2,0
"Cleistesiopsis","Orchidaceae","Asparagales",0,0,0,3,0,NA
"Cleistocactus","Cactaceae","Caryophyllales",1,0,0,43,1,1
"Cleistochlamys","Annonaceae","Magnoliales",1,0,0,1,1,1
"Cleistochloa","Poaceae","Poales",0,0,0,3,0,NA
"Cleistogenes","Poaceae","Poales",0,0,2,13,2,0
"Cleistopholis","Annonaceae","Magnoliales",3,0,0,3,3,1
"Clematepistephium","Orchidaceae","Asparagales",0,0,1,1,1,0
"Clematicissus","Vitaceae","Vitales",0,0,0,2,0,NA
"Clematis","Ranunculaceae","Ranunculales",16,2,2,373,18,0.888888888888889
"Clematoclethra","Actinidiaceae","Ericales",0,0,0,1,0,NA
"Cleobulia","Fabaceae","Fabales",0,0,1,4,1,0
"Cleome","Cleomaceae","Brassicales",2,0,11,206,13,0.153846153846154
"Cleomella","Cleomaceae","Brassicales",0,0,0,12,0,NA
"Cleonia","Lamiaceae","Lamiales",0,0,1,1,1,0
"Cleoserrata","Capparaceae","Brassicales",0,0,0,2,0,NA
"Cleretum","Aizoaceae","Caryophyllales",0,0,1,3,1,0
"Clermontia","Campanulaceae","Asterales",4,0,0,24,4,1
"Clerodendrum","Lamiaceae","Lamiales",22,0,1,308,23,0.956521739130435
"Clethra","Clethraceae","Ericales",19,0,0,80,19,1
"Cleyera","Pentaphylacaceae","Ericales",6,0,0,21,6,1
"Clianthus","Fabaceae","Fabales",1,0,0,1,1,1
"Clibadium","Asteraceae","Asterales",3,0,0,38,3,1
"Clidemia","Melastomataceae","Myrtales",13,0,0,173,13,1
"Cliffortia","Rosaceae","Rosales",0,0,0,105,0,NA
"Cliftonia","Cyrillaceae","Ericales",1,0,0,1,1,1
"Climacoptera","Amaranthaceae","Caryophyllales",0,0,1,43,1,0
"Clinacanthus","Acanthaceae","Lamiales",0,0,0,2,0,NA
"Clinanthus","Amaryllidaceae","Asparagales",0,0,1,22,1,0
"Clinomicromeria","Lamiaceae","Lamiales",0,0,0,1,0,NA
"Clinopodium","Lamiaceae","Lamiales",4,0,6,148,10,0.4
"Clinosperma","Arecaceae","Arecales",1,0,0,4,1,1
"Clinostigma","Arecaceae","Arecales",1,0,0,11,1,1
"Clintonia","Liliaceae","Liliales",0,0,5,5,5,0
"Cliococca","Linaceae","Malpighiales",0,0,0,1,0,NA
"Clistax","Acanthaceae","Lamiales",0,0,0,2,0,NA
"Clitandra","Apocynaceae","Gentianales",0,0,0,1,0,NA
"Clitoria","Fabaceae","Fabales",2,0,1,66,3,0.666666666666667
"Clitoriopsis","Fabaceae","Fabales",0,0,0,1,0,NA
"Clivia","Amaryllidaceae","Asparagales",0,0,3,7,3,0
"Cloezia","Myrtaceae","Myrtales",5,0,0,6,5,1
"Cloiselia","Asteraceae","Asterales",0,0,0,1,0,NA
"Clonodia","Malpighiaceae","Malpighiales",0,0,0,3,0,NA
"Clonostylis","Euphorbiaceae","Malpighiales",0,0,0,1,0,NA
"Clowesia","Orchidaceae","Asparagales",0,0,0,7,0,NA
"Clusia","Clusiaceae","Malpighiales",26,0,0,307,26,1
"Clusiella","Calophyllaceae","Malpighiales",1,0,0,9,1,1
"Clutia","Peraceae","Malpighiales",5,0,0,56,5,1
"Clymenia","Rutaceae","Sapindales",0,0,0,2,0,NA
"Clypeola","Brassicaceae","Brassicales",0,0,0,9,0,NA
"Cnemidaria","Cyatheaceae","Cyatheales",0,0,0,25,0,NA
"Cneoridium","Rutaceae","Sapindales",1,0,0,1,1,1
"Cneorum","Rutaceae","Sapindales",2,0,0,2,2,1
"Cnesmocarpon","Sapindaceae","Sapindales",1,0,0,4,1,1
"Cnesmone","Euphorbiaceae","Malpighiales",0,1,0,11,0,NA
"Cnestidium","Connaraceae","Oxalidales",1,0,0,4,1,1
"Cnestis","Connaraceae","Oxalidales",2,0,0,13,2,1
"Cnicothamnus","Asteraceae","Asterales",0,0,0,2,0,NA
"Cnicus","Asteraceae","Asterales",0,0,0,3,0,NA
"Cnidiocarpa","Apiaceae","Apiales",0,0,0,6,0,NA
"Cnidium","Apiaceae","Apiales",0,0,2,10,2,0
"Cnidoscolus","Euphorbiaceae","Malpighiales",7,0,1,94,8,0.875
"Coaxana","Apiaceae","Apiales",0,0,0,2,0,NA
"Cobaea","Polemoniaceae","Ericales",1,0,0,18,1,1
"Cobana","Iridaceae","Asparagales",0,0,1,1,1,0
"Cobresia","Cyperaceae","Poales",0,0,0,1,0,NA
"Coccineorchis","Orchidaceae","Asparagales",0,0,0,7,0,NA
"Coccinia","Cucurbitaceae","Cucurbitales",0,1,3,31,3,0
"Coccochondra","Rubiaceae","Gentianales",0,0,0,4,0,NA
"Coccocypselum","Rubiaceae","Gentianales",0,0,1,20,1,0
"Coccoloba","Polygonaceae","Caryophyllales",28,0,0,177,28,1
"Cocconerion","Euphorbiaceae","Malpighiales",1,0,0,2,1,1
"Coccosperma","Ericaceae","Ericales",0,0,0,3,0,NA
"Coccothrinax","Arecaceae","Arecales",14,0,0,53,14,1
"Cocculus","Menispermaceae","Ranunculales",2,3,0,9,2,1
"Cochleanthes","Orchidaceae","Asparagales",0,0,2,4,2,0
"Cochlearia","Brassicaceae","Brassicales",0,0,5,27,5,0
"Cochlianthus","Fabaceae","Fabales",0,0,0,2,0,NA
"Cochliasanthus","Fabaceae","Fabales",0,0,0,1,0,NA
"Cochlidium","Polypodiaceae","Polypodiales",0,0,0,15,0,NA
"Cochliostema","Commelinaceae","Commelinales",0,0,1,2,1,0
"Cochlospermum","Bixaceae","Malvales",6,0,0,13,6,1
"Cocos","Arecaceae","Arecales",1,0,0,1,1,1
"Codariocalyx","Fabaceae","Fabales",0,0,0,2,0,NA
"Coddia","Rubiaceae","Gentianales",1,0,0,1,1,1
"Codia","Cunoniaceae","Oxalidales",1,0,0,15,1,1
"Codiaeum","Euphorbiaceae","Malpighiales",3,0,0,17,3,1
"Codiocarpus","Stemonuraceae","Aquifoliales",0,0,0,2,0,NA
"Codon","Boraginaceae","UnknownOrder-Boraginaceae",0,0,1,2,1,0
"Codonacanthus","Acanthaceae","Lamiales",0,0,0,3,0,NA
"Codonanthe","Gesneriaceae","Lamiales",3,0,1,20,4,0.75
"Codonanthopsis","Gesneriaceae","Lamiales",0,0,0,4,0,NA
"Codonoboea","Gesneriaceae","Lamiales",0,0,0,81,0,NA
"Codonocarpus","Gyrostemonaceae","Brassicales",3,0,0,3,3,1
"Codonocephalum","Asteraceae","Asterales",0,0,0,1,0,NA
"Codonochlamys","Malvaceae","Malvales",0,0,0,2,0,NA
"Codonopsis","Campanulaceae","Asterales",0,0,6,53,6,0
"Codonorchis","Orchidaceae","Asparagales",0,0,1,2,1,0
"Codonosiphon","Orchidaceae","Asparagales",0,0,0,1,0,NA
"Codoriocalyx","Fabaceae","Fabales",0,0,0,1,0,NA
"Coelachne","Poaceae","Poales",0,0,0,12,0,NA
"Coelachyrum","Poaceae","Poales",0,0,0,6,0,NA
"Coelanthum","Molluginaceae","Caryophyllales",0,0,0,3,0,NA
"Coelia","Orchidaceae","Asparagales",0,0,2,5,2,0
"Coelidium","Fabaceae","Fabales",1,0,0,20,1,1
"Coeliopsis","Orchidaceae","Asparagales",0,0,1,1,1,0
"Coelocarpum","Verbenaceae","Lamiales",0,0,0,8,0,NA
"Coelocaryon","Myristicaceae","Magnoliales",3,0,0,4,3,1
"Coelogyne","Orchidaceae","Asparagales",0,0,47,200,47,0
"Coeloneurum","Solanaceae","Solanales",1,0,0,1,1,1
"Coelophragmus","Brassicaceae","Brassicales",0,0,0,1,0,NA
"Coelopyrena","Rubiaceae","Gentianales",0,0,0,1,0,NA
"Coelorachis","Poaceae","Poales",0,0,2,21,2,0
"Coelospermum","Rubiaceae","Gentianales",1,0,0,11,1,1
"Coelostegia","Malvaceae","Malvales",2,0,0,6,2,1
"Coespeletia","Asteraceae","Asterales",1,0,0,6,1,1
"Coffea","Rubiaceae","Gentianales",17,0,0,125,17,1
"Cogniauxia","Cucurbitaceae","Cucurbitales",0,0,1,2,1,0
"Cogswellia","Apiaceae","Apiales",0,0,0,1,0,NA
"Cohiba","Boraginaceae","UnknownOrder-Boraginaceae",0,0,0,1,0,NA
"Cohniella","Orchidaceae","Asparagales",0,0,0,2,0,NA
"Coilochilus","Orchidaceae","Asparagales",0,0,1,1,1,0
"Coilostigma","Ericaceae","Ericales",0,0,0,2,0,NA
"Coincya","Brassicaceae","Brassicales",0,0,2,6,2,0
"Coix","Poaceae","Poales",0,0,2,4,2,0
"Cojoba","Fabaceae","Fabales",3,0,0,20,3,1
"Cola","Malvaceae","Malvales",15,0,0,121,15,1
"Colanthelia","Poaceae","Poales",0,0,0,7,0,NA
"Colchicum","Colchicaceae","Liliales",0,0,9,103,9,0
"Coldenia","Boraginaceae","UnknownOrder-Boraginaceae",0,0,1,1,1,0
"Colea","Bignoniaceae","Lamiales",0,0,0,24,0,NA
"Coleactina","Rubiaceae","Gentianales",0,0,0,1,0,NA
"Coleanthera","Ericaceae","Ericales",0,0,0,3,0,NA
"Coleanthus","Poaceae","Poales",0,0,1,1,1,0
"Colebrookea","Lamiaceae","Lamiales",1,0,0,1,1,1
"Coleocarya","Restionaceae","Poales",0,0,1,1,1,0
"Coleocephalocereus","Cactaceae","Caryophyllales",0,0,0,9,0,NA
"Coleochloa","Cyperaceae","Poales",0,0,2,8,2,0
"Coleocoma","Asteraceae","Asterales",0,0,1,1,1,0
"Coleogyne","Rosaceae","Rosales",1,0,0,1,1,1
"Coleonema","Rutaceae","Sapindales",0,0,0,8,0,NA
"Coleosanthus","Asteraceae","Asterales",0,0,0,3,0,NA
"Coleostachys","Malpighiaceae","Malpighiales",1,0,0,1,1,1
"Coleostephus","Asteraceae","Asterales",0,0,0,3,0,NA
"Coleotrype","Commelinaceae","Commelinales",0,0,1,9,1,0
"Coleus","Lamiaceae","Lamiales",0,0,0,2,0,NA
"Colicodendron","Capparaceae","Brassicales",0,0,0,5,0,NA
"Colignonia","Nyctaginaceae","Caryophyllales",0,0,0,6,0,NA
"Collabium","Orchidaceae","Asparagales",0,0,1,14,1,0
"Collaea","Fabaceae","Fabales",0,0,0,9,0,NA
"Colleteria","Rubiaceae","Gentianales",1,0,0,2,1,1
"Colletia","Rhamnaceae","Rosales",2,0,0,5,2,1
"Colletoecema","Rubiaceae","Gentianales",0,0,0,3,0,NA
"Colletogyne","Araceae","Alismatales",0,0,0,1,0,NA
"Colliguaja","Euphorbiaceae","Malpighiales",3,0,0,5,3,1
"Collinsia","Plantaginaceae","Lamiales",0,0,2,19,2,0
"Collinsonia","Lamiaceae","Lamiales",0,0,1,11,1,0
"Collomia","Polemoniaceae","Ericales",0,0,0,15,0,NA
"Collospermum","Asteliaceae","Asparagales",0,0,1,5,1,0
"Colobanthera","Asteraceae","Asterales",0,0,0,1,0,NA
"Colobanthus","Caryophyllaceae","Caryophyllales",0,0,3,25,3,0
"Colobocarpos","Euphorbiaceae","Malpighiales",1,0,0,1,1,1
"Colocasia","Araceae","Alismatales",0,0,2,8,2,0
"Colocynthis","Cucurbitaceae","Cucurbitales",0,0,0,1,0,NA
"Cologania","Fabaceae","Fabales",0,0,0,12,0,NA
"Cololobus","Asteraceae","Asterales",0,0,0,3,0,NA
"Colona","Malvaceae","Malvales",6,0,0,37,6,1
"Colophospermum","Fabaceae","Fabales",1,0,0,1,1,1
"Colpias","Scrophulariaceae","Lamiales",0,0,1,1,1,0
"Colpodium","Poaceae","Poales",0,0,0,22,0,NA
"Colpogyne","Gesneriaceae","Lamiales",0,0,0,1,0,NA
"Colpoon","Santalaceae","Santalales",1,0,0,2,1,1
"Colpothrinax","Arecaceae","Arecales",2,0,0,3,2,1
"Colquhounia","Lamiaceae","Lamiales",0,0,0,5,0,NA
"Colubrina","Rhamnaceae","Rosales",12,0,0,34,12,1
"Columbea","Araucariaceae","Araucariales",0,0,0,1,0,NA
"Columbiadoria","Asteraceae","Asterales",0,0,0,1,0,NA
"Columellia","Columelliaceae","Bruniales",1,0,0,5,1,1
"Columnea","Gesneriaceae","Lamiales",0,1,3,195,3,0
"Coluria","Rosaceae","Rosales",0,0,0,5,0,NA
"Colutea","Fabaceae","Fabales",4,0,0,25,4,1
"Coluteastrum","Fabaceae","Fabales",0,0,0,33,0,NA
"Coluteocarpus","Brassicaceae","Brassicales",0,0,0,2,0,NA
"Colvillea","Fabaceae","Fabales",1,0,0,1,1,1
"Colymbada","Asteraceae","Asterales",0,0,0,1,0,NA
"Colysis","Polypodiaceae","Polypodiales",0,0,0,25,0,NA
"Comaclinium","Asteraceae","Asterales",0,0,0,1,0,NA
"Comandra","Santalaceae","Santalales",0,0,1,1,1,0
"Comanthera","Eriocaulaceae","Poales",0,0,0,40,0,NA
"Comanthosphace","Lamiaceae","Lamiales",0,0,0,5,0,NA
"Comarostaphylis","Ericaceae","Ericales",5,0,0,10,5,1
"Comarum","Rosaceae","Rosales",0,0,0,1,0,NA
"Comastoma","Gentianaceae","Gentianales",0,0,0,18,0,NA
"Combera","Solanaceae","Solanales",0,0,0,2,0,NA
"Comborhiza","Asteraceae","Asterales",0,0,0,2,0,NA
"Combretocarpus","Anisophylleaceae","Cucurbitales",1,0,0,1,1,1
"Combretum","Combretaceae","Myrtales",58,2,0,289,58,1
"Comesperma","Polygalaceae","Fabales",3,0,1,33,4,0.75
"Cometes","Caryophyllaceae","Caryophyllales",0,0,0,2,0,NA
"Comiphyton","Rhizophoraceae","Malpighiales",1,0,0,1,1,1
"Commelina","Commelinaceae","Commelinales",0,0,16,215,16,0
"Commersonia","Malvaceae","Malvales",3,0,0,30,3,1
"Commicarpus","Nyctaginaceae","Caryophyllales",0,0,0,1,0,NA
"Commidendrum","Asteraceae","Asterales",0,0,0,5,0,NA
"Commiphora","Burseraceae","Sapindales",35,0,0,208,35,1
"Comocladia","Anacardiaceae","Sapindales",5,0,0,26,5,1
"Comolia","Melastomataceae","Myrtales",0,0,0,20,0,NA
"Comoliopsis","Melastomataceae","Myrtales",0,0,0,1,0,NA
"Comoranthus","Oleaceae","Lamiales",1,0,0,3,1,1
"Comospermum","Asparagaceae","Asparagales",0,0,0,1,0,NA
"Comparettia","Orchidaceae","Asparagales",0,0,1,79,1,0
"Compsoneura","Myristicaceae","Magnoliales",4,0,0,17,4,1
"Comptonella","Rutaceae","Sapindales",0,0,0,8,0,NA
"Comptonia","Myricaceae","Fagales",1,0,0,1,1,1
"Conandrium","Primulaceae","Ericales",0,0,0,2,0,NA
"Conandron","Gesneriaceae","Lamiales",0,0,0,1,0,NA
"Conanthera","Tecophilaeaceae","Asparagales",0,0,4,6,4,0
"Conceveiba","Euphorbiaceae","Malpighiales",5,0,0,14,5,1
"Conchidium","Orchidaceae","Asparagales",0,0,0,10,0,NA
"Conchocarpus","Rutaceae","Sapindales",0,0,0,45,0,NA
"Conchopetalum","Sapindaceae","Sapindales",1,0,0,2,1,1
"Condalia","Rhamnaceae","Rosales",6,0,0,20,6,1
"Condaminea","Rubiaceae","Gentianales",1,0,0,5,1,1
"Condylidium","Asteraceae","Asterales",0,0,0,2,0,NA
"Condylocarpon","Apocynaceae","Gentianales",0,2,0,7,0,NA
"Condylopodium","Asteraceae","Asterales",0,0,0,6,0,NA
"Condylostylis","Fabaceae","Fabales",0,0,0,3,0,NA
"Congea","Lamiaceae","Lamiales",0,1,0,12,0,NA
"Congolanthus","Gentianaceae","Gentianales",0,0,0,1,0,NA
"Conicosia","Aizoaceae","Caryophyllales",0,0,0,2,0,NA
"Conimitella","Saxifragaceae","Saxifragales",0,0,1,1,1,0
"Coniogramme","Pteridaceae","Polypodiales",0,0,0,50,0,NA
"Conioselinum","Apiaceae","Apiales",0,0,0,17,0,NA
"Conium","Apiaceae","Apiales",0,0,1,4,1,0
"Connarus","Connaraceae","Oxalidales",13,0,0,100,13,1
"Connellia","Bromeliaceae","Poales",0,0,0,6,0,NA
"Conobea","Plantaginaceae","Lamiales",0,0,0,4,0,NA
"Conocalyx","Acanthaceae","Lamiales",0,0,0,1,0,NA
"Conocarpus","Combretaceae","Myrtales",2,0,0,2,2,1
"Conocliniopsis","Asteraceae","Asterales",0,0,0,1,0,NA
"Conoclinium","Asteraceae","Asterales",0,0,0,4,0,NA
"Conomitra","Apocynaceae","Gentianales",0,0,0,1,0,NA
"Conopholis","Orobanchaceae","Lamiales",0,0,0,2,0,NA
"Conophytum","Aizoaceae","Caryophyllales",0,0,0,110,0,NA
"Conopodium","Apiaceae","Apiales",0,0,1,8,1,0
"Conosapium","Euphorbiaceae","Malpighiales",0,0,0,1,0,NA
"Conospermum","Proteaceae","Proteales",53,0,0,53,53,1
"Conostegia","Melastomataceae","Myrtales",7,0,0,41,7,1
"Conostephium","Ericaceae","Ericales",1,0,0,10,1,1
"Conostomium","Rubiaceae","Gentianales",0,0,2,5,2,0
"Conostylis","Haemodoraceae","Commelinales",0,0,14,45,14,0
"Conothamnus","Myrtaceae","Myrtales",0,0,0,3,0,NA
"Conradia","Gesneriaceae","Lamiales",0,0,0,1,0,NA
"Conradina","Lamiaceae","Lamiales",0,0,0,6,0,NA
"Conringia","Brassicaceae","Brassicales",0,0,2,6,2,0
"Consolea","Cactaceae","Caryophyllales",0,0,0,10,0,NA
"Consolida","Ranunculaceae","Ranunculales",0,0,1,52,1,0
"Constancea","Asteraceae","Asterales",1,0,0,1,1,1
"Constantia","Orchidaceae","Asparagales",0,0,1,6,1,0
"Convallaria","Asparagaceae","Asparagales",0,0,1,3,1,0
"Convolvulus","Convolvulaceae","Solanales",0,0,5,72,5,0
"Conyza","Asteraceae","Asterales",0,0,2,154,2,0
"Conyzigeron","Asteraceae","Asterales",0,0,0,1,0,NA
"Conzattia","Fabaceae","Fabales",1,0,0,3,1,1
"Cooktownia","Orchidaceae","Asparagales",0,0,0,1,0,NA
"Coopernookia","Goodeniaceae","Asterales",1,0,0,6,1,1
"Copaiba","Fabaceae","Fabales",1,0,0,8,1,1
"Copaifera","Fabaceae","Fabales",15,0,0,47,15,1
"Copaiva","Fabaceae","Fabales",0,0,0,2,0,NA
"Copelandiopteris","Pteridaceae","Polypodiales",0,0,2,2,2,0
"Copernicia","Arecaceae","Arecales",13,0,0,28,13,1
"Copiapoa","Cactaceae","Caryophyllales",1,0,0,27,1,1
"Coprosma","Rubiaceae","Gentianales",37,0,0,118,37,1
"Coptidium","Ranunculaceae","Ranunculales",0,0,1,3,1,0
"Coptis","Ranunculaceae","Ranunculales",0,0,11,13,11,0
"Coptocheile","Gesneriaceae","Lamiales",0,0,0,1,0,NA
"Coptophyllum","Rubiaceae","Gentianales",0,0,0,8,0,NA
"Coptosapelta","Rubiaceae","Gentianales",1,0,0,16,1,1
"Coptosperma","Rubiaceae","Gentianales",6,0,0,19,6,1
"Corallocarpus","Cucurbitaceae","Cucurbitales",0,0,2,16,2,0
"Corallodendron","Fabaceae","Fabales",0,0,0,20,0,NA
"Corallodiscus","Gesneriaceae","Lamiales",0,0,0,6,0,NA
"Corallorhiza","Orchidaceae","Asparagales",0,0,3,11,3,0
"Corallospartium","Fabaceae","Fabales",0,0,0,1,0,NA
"Corbichonia","Lophiocarpaceae","Caryophyllales",0,0,1,2,1,0
"Corchoropsis","Malvaceae","Malvales",0,0,1,1,1,0
"Corchorus","Malvaceae","Malvales",1,0,4,77,5,0.2
"Cordeauxia","Fabaceae","Fabales",0,0,0,1,0,NA
"Cordia","Boraginaceae","UnknownOrder-Boraginaceae",60,1,0,405,60,1
"Cordiera","Rubiaceae","Gentianales",2,0,0,10,2,1
"Cordiglottis","Orchidaceae","Asparagales",0,0,0,7,0,NA
"Cordisepalum","Convolvulaceae","Solanales",0,1,0,1,0,NA
"Cordobia","Malpighiaceae","Malpighiales",1,0,0,1,1,1
"Cordyla","Fabaceae","Fabales",3,0,0,7,3,1
"Cordylanthus","Orobanchaceae","Lamiales",0,0,0,19,0,NA
"Cordyline","Asparagaceae","Asparagales",11,0,0,26,11,1
"Cordyloblaste","Symplocaceae","Ericales",0,0,0,1,0,NA
"Cordylocarpus","Brassicaceae","Brassicales",0,0,0,1,0,NA
"Cordylogyne","Apocynaceae","Gentianales",0,0,0,1,0,NA
"Cordylostigma","Rubiaceae","Gentianales",0,0,0,9,0,NA
"Corema","Ericaceae","Ericales",2,0,0,2,2,1
"Coreocarpus","Asteraceae","Asterales",0,0,0,6,0,NA
"Coreopsis","Asteraceae","Asterales",1,0,21,100,22,0.0454545454545455
"Corethamnium","Asteraceae","Asterales",0,0,0,1,0,NA
"Corethrodendron","Fabaceae","Fabales",0,0,0,5,0,NA
"Corethrogyne","Asteraceae","Asterales",0,0,0,2,0,NA
"Coriandrum","Apiaceae","Apiales",0,0,1,2,1,0
"Coriaria","Coriariaceae","Cucurbitales",12,0,0,16,12,1
"Coris","Primulaceae","Ericales",0,0,0,1,0,NA
"Corispermum","Amaranthaceae","Caryophyllales",0,0,6,69,6,0
"Cormonema","Rhamnaceae","Rosales",0,0,0,1,0,NA
"Cormophyllum","Cyatheaceae","Cyatheales",0,0,0,1,0,NA
"Cornopteris","Athyriaceae","Polypodiales",0,0,0,13,0,NA
"Cornucopiae","Poaceae","Poales",0,0,0,2,0,NA
"Cornukaempferia","Zingiberaceae","Zingiberales",0,0,0,3,0,NA
"Cornulaca","Amaranthaceae","Caryophyllales",0,0,0,7,0,NA
"Cornus","Cornaceae","Cornales",44,0,1,51,45,0.977777777777778
"Cornutia","Lamiaceae","Lamiales",0,0,0,9,0,NA
"Corokia","Argophyllaceae","Asterales",6,0,0,7,6,1
"Corollonema","Apocynaceae","Gentianales",0,0,0,1,0,NA
"Coronanthera","Gesneriaceae","Lamiales",0,0,0,11,0,NA
"Coronidium","Asteraceae","Asterales",0,0,4,9,4,0
"Coronilla","Fabaceae","Fabales",1,0,0,10,1,1
"Corothamnus","Fabaceae","Fabales",0,0,0,2,0,NA
"Corpuscularia","Aizoaceae","Caryophyllales",0,0,0,7,0,NA
"Correa","Rutaceae","Sapindales",2,0,0,12,2,1
"Corrigiola","Molluginaceae","Caryophyllales",0,0,1,11,1,0
"Corryocactus","Cactaceae","Caryophyllales",2,0,0,35,2,1
"Corsia","Corsiaceae","Liliales",0,0,25,25,25,0
"Corsiopsis","Corsiaceae","Liliales",0,0,1,1,1,0
"Cortaderia","Poaceae","Poales",0,0,7,25,7,0
"Cortia","Apiaceae","Apiales",0,0,0,3,0,NA
"Cortiella","Apiaceae","Apiales",0,0,0,4,0,NA
"Coryanthes","Orchidaceae","Asparagales",0,0,3,59,3,0
"Corybas","Orchidaceae","Asparagales",0,0,5,133,5,0
"Corycium","Orchidaceae","Asparagales",0,0,1,17,1,0
"Corydalis","Papaveraceae","Ranunculales",0,0,10,586,10,0
"Corylopsis","Hamamelidaceae","Saxifragales",10,0,0,25,10,1
"Corylus","Betulaceae","Fagales",12,0,0,17,12,1
"Corymbia","Myrtaceae","Myrtales",52,0,0,95,52,1
"Corymbium","Asteraceae","Asterales",0,0,1,9,1,0
"Corymborkis","Orchidaceae","Asparagales",0,0,1,6,1,0
"Corynabutilon","Malvaceae","Malvales",0,0,0,7,0,NA
"Corynaea","Balanophoraceae","Santalales",0,0,0,1,0,NA
"Corynanthe","Rubiaceae","Gentianales",3,0,0,3,3,1
"Corynanthera","Myrtaceae","Myrtales",1,0,0,1,1,1
"Corynephorus","Poaceae","Poales",0,0,1,5,1,0
"Corynocarpus","Corynocarpaceae","Cucurbitales",4,0,0,5,4,1
"Corynopuntia","Cactaceae","Caryophyllales",1,0,0,15,1,1
"Corynostylis","Violaceae","Malpighiales",0,0,0,4,0,NA
"Corynotheca","Xanthorrhoeaceae","Asparagales",0,0,1,6,1,0
"Corypha","Arecaceae","Arecales",3,0,0,5,3,1
"Coryphantha","Cactaceae","Caryophyllales",0,0,0,50,0,NA
"Coryphopteris","Thelypteridaceae","Polypodiales",0,0,0,27,0,NA
"Coryphothamnus","Rubiaceae","Gentianales",0,0,0,1,0,NA
"Corythophora","Lecythidaceae","Ericales",4,0,0,4,4,1
"Corytoplectus","Gesneriaceae","Lamiales",0,0,1,12,1,0
"Coscinium","Menispermaceae","Ranunculales",1,0,0,2,1,1
"Cosmea","Asteraceae","Asterales",0,0,0,2,0,NA
"Cosmelia","Ericaceae","Ericales",1,0,0,1,1,1
"Cosmianthemum","Acanthaceae","Lamiales",0,0,0,14,0,NA
"Cosmibuena","Rubiaceae","Gentianales",3,0,0,4,3,1
"Cosmocalyx","Rubiaceae","Gentianales",0,0,0,1,0,NA
"Cosmos","Asteraceae","Asterales",0,0,2,42,2,0
"Cosmostigma","Apocynaceae","Gentianales",0,0,0,3,0,NA
"Cossinia","Sapindaceae","Sapindales",2,0,0,5,2,1
"Costera","Ericaceae","Ericales",0,0,0,10,0,NA
"Costularia","Cyperaceae","Poales",0,0,2,25,2,0
"Costus","Costaceae","Zingiberales",42,0,0,105,42,1
"Cota","Asteraceae","Asterales",0,0,0,25,0,NA
"Cotinus","Anacardiaceae","Sapindales",3,0,0,8,3,1
"Cotoneaster","Rosaceae","Rosales",13,0,0,278,13,1
"Cotopaxia","Apiaceae","Apiales",0,0,0,2,0,NA
"Cottea","Poaceae","Poales",0,0,0,1,0,NA
"Cottendorfia","Bromeliaceae","Poales",0,0,1,1,1,0
"Cottonia","Orchidaceae","Asparagales",0,0,0,1,0,NA
"Cotula","Asteraceae","Asterales",0,0,2,62,2,0
"Cotyledon","Crassulaceae","Saxifragales",1,0,0,12,1,1
"Cotylelobium","Dipterocarpaceae","Malvales",4,0,0,5,4,1
"Cotylolabium","Orchidaceae","Asparagales",0,0,0,1,0,NA
"Couepia","Chrysobalanaceae","Malpighiales",16,0,0,71,16,1
"Coula","Olacaceae","Santalales",1,0,0,1,1,1
"Coulterella","Asteraceae","Asterales",1,0,0,1,1,1
"Coulteria","Fabaceae","Fabales",0,0,0,1,0,NA
"Coulterophytum","Apiaceae","Apiales",0,0,0,4,0,NA
"Couma","Apocynaceae","Gentianales",4,0,0,5,4,1
"Coumarouna","Fabaceae","Fabales",0,0,0,1,0,NA
"Couratari","Lecythidaceae","Ericales",10,0,0,19,10,1
"Couroupita","Lecythidaceae","Ericales",3,0,0,3,3,1
"Coursetia","Fabaceae","Fabales",7,0,2,40,9,0.777777777777778
"Courtoisina","Cyperaceae","Poales",0,0,1,2,1,0
"Cousinia","Asteraceae","Asterales",0,5,15,687,15,0
"Cousiniopsis","Asteraceae","Asterales",0,0,0,1,0,NA
"Coussapoa","Urticaceae","Rosales",12,0,0,48,12,1
"Coussarea","Rubiaceae","Gentianales",15,0,0,122,15,1
"Coutaportla","Rubiaceae","Gentianales",1,0,0,2,1,1
"Coutarea","Rubiaceae","Gentianales",1,0,0,7,1,1
"Coutoubea","Gentianaceae","Gentianales",0,0,0,5,0,NA
"Coveniella","Dryopteridaceae","Polypodiales",0,0,0,1,0,NA
"Cowania","Rosaceae","Rosales",1,0,0,1,1,1
"Cowellocassia","Fabaceae","Fabales",0,0,0,1,0,NA
"Cowiea","Rubiaceae","Gentianales",0,0,0,2,0,NA
"Crabbea","Acanthaceae","Lamiales",0,0,0,14,0,NA
"Cracca","Fabaceae","Fabales",0,0,0,102,0,NA
"Cracosna","Gentianaceae","Gentianales",0,0,0,3,0,NA
"Craibella","Annonaceae","Magnoliales",1,0,0,1,1,1
"Craibia","Fabaceae","Fabales",2,0,0,12,2,1
"Craibiodendron","Ericaceae","Ericales",2,0,0,5,2,1
"Craigia","Malvaceae","Malvales",1,0,0,2,1,1
"Crambe","Brassicaceae","Brassicales",0,0,1,39,1,0
"Crambella","Brassicaceae","Brassicales",0,0,0,1,0,NA
"Cranichis","Orchidaceae","Asparagales",0,0,0,53,0,NA
"Craniolaria","Martyniaceae","Lamiales",0,0,0,3,0,NA
"Craniospermum","Boraginaceae","UnknownOrder-Boraginaceae",0,0,0,5,0,NA
"Craniotome","Lamiaceae","Lamiales",0,0,0,1,0,NA
"Cranocarpus","Fabaceae","Fabales",1,0,0,3,1,1
"Crantzia","Gesneriaceae","Lamiales",0,0,0,2,0,NA
"Craspedaria","Polypodiaceae","Polypodiales",0,0,0,4,0,NA
"Craspedia","Asteraceae","Asterales",0,0,1,24,1,0
"Craspedolobium","Fabaceae","Fabales",0,0,0,2,0,NA
"Craspedoneuron","Hymenophyllaceae","Hymenophyllales",0,0,0,2,0,NA
"Craspedophyllum","Hymenophyllaceae","Hymenophyllales",0,0,0,1,0,NA
"Craspedorhachis","Poaceae","Poales",0,0,0,3,0,NA
"Craspedosorus","Thelypteridaceae","Polypodiales",0,0,0,1,0,NA
"Craspidospermum","Apocynaceae","Gentianales",1,0,0,1,1,1
"Crassocephalum","Asteraceae","Asterales",0,0,1,24,1,0
"Crassula","Crassulaceae","Saxifragales",2,0,3,209,5,0.4
"Crataegus","Rosaceae","Rosales",27,0,0,380,27,1
"Crataemespilus","Rosaceae","Rosales",0,0,0,1,0,NA
"Crateranthus","Lecythidaceae","Ericales",0,0,0,3,0,NA
"Craterispermum","Rubiaceae","Gentianales",3,0,0,16,3,1
"Craterocapsa","Campanulaceae","Asterales",0,0,0,5,0,NA
"Craterosiphon","Thymelaeaceae","Malvales",1,0,0,11,1,1
"Craterostigma","Linderniaceae","Lamiales",0,0,3,9,3,0
"Crateva","Capparaceae","Brassicales",4,0,0,15,4,1
"Cratoxylum","Hypericaceae","Malpighiales",5,0,0,6,5,1
"Cratylia","Fabaceae","Fabales",1,0,0,7,1,1
"Cratystylis","Asteraceae","Asterales",1,0,0,4,1,1
"Crawfurdia","Gentianaceae","Gentianales",0,0,0,19,0,NA
"Cremanium","Melastomataceae","Myrtales",0,0,0,2,0,NA
"Cremanthodium","Asteraceae","Asterales",0,0,8,76,8,0
"Cremaspora","Rubiaceae","Gentianales",1,0,0,2,1,1
"Cremastopus","Cucurbitaceae","Cucurbitales",0,0,0,2,0,NA
"Cremastosperma","Annonaceae","Magnoliales",20,0,0,31,20,1
"Cremastra","Orchidaceae","Asparagales",0,0,0,4,0,NA
"Cremersia","Gesneriaceae","Lamiales",0,0,0,1,0,NA
"Cremnophila","Crassulaceae","Saxifragales",0,0,0,2,0,NA
"Cremnothamnus","Asteraceae","Asterales",0,0,0,1,0,NA
"Cremocarpon","Rubiaceae","Gentianales",0,0,0,9,0,NA
"Cremolobus","Brassicaceae","Brassicales",0,0,1,7,1,0
"Cremosperma","Gesneriaceae","Lamiales",0,0,1,23,1,0
"Cremospermopsis","Gesneriaceae","Lamiales",0,0,0,2,0,NA
"Crenea","Lythraceae","Myrtales",0,0,0,2,0,NA
"Crenias","Podostemaceae","Malpighiales",0,0,0,5,0,NA
"Crenidium","Solanaceae","Solanales",1,0,0,1,1,1
"Crepi-Hieracium","Asteraceae","Asterales",0,0,0,1,0,NA
"Crepidiastrum","Asteraceae","Asterales",0,0,0,22,0,NA
"Crepidifolium","Asteraceae","Asterales",0,0,0,4,0,NA
"Crepidium","Orchidaceae","Asparagales",0,0,10,260,10,0
"Crepidomanes","Hymenophyllaceae","Hymenophyllales",0,0,0,32,0,NA
"Crepidorhopalon","Linderniaceae","Lamiales",0,0,0,30,0,NA
"Crepidospermum","Burseraceae","Sapindales",3,0,0,6,3,1
"Crepis","Asteraceae","Asterales",0,0,19,252,19,0
"Crescentia","Bignoniaceae","Lamiales",4,0,0,6,4,1
"Cressa","Convolvulaceae","Solanales",0,1,0,3,0,NA
"Cribbia","Orchidaceae","Asparagales",0,0,2,4,2,0
"Crinipes","Poaceae","Poales",0,0,0,2,0,NA
"Crinitaria","Asteraceae","Asterales",0,0,0,3,0,NA
"Crinodendron","Elaeocarpaceae","Oxalidales",3,0,0,4,3,1
"Crinonia","Orchidaceae","Asparagales",0,0,0,1,0,NA
"Crinum","Amaryllidaceae","Asparagales",0,0,7,106,7,0
"Crioceras","Apocynaceae","Gentianales",0,0,0,1,0,NA
"Criscia","Asteraceae","Asterales",0,0,0,1,0,NA
"Crispiloba","Alseuosmiaceae","Asterales",1,0,0,1,1,1
"Cristaria","Malvaceae","Malvales",0,0,0,26,0,NA
"Cristonia","Fabaceae","Fabales",0,0,0,1,0,NA
"Crithopsis","Poaceae","Poales",0,0,1,1,1,0
"Critonia","Asteraceae","Asterales",0,0,0,44,0,NA
"Critoniadelphus","Asteraceae","Asterales",0,0,0,2,0,NA
"Critoniella","Asteraceae","Asterales",0,0,0,6,0,NA
"Critoniopsis","Asteraceae","Asterales",0,0,0,75,0,NA
"Croatiella","Araceae","Alismatales",0,0,1,1,1,0
"Crobylanthe","Rubiaceae","Gentianales",0,0,0,1,0,NA
"Crocanthemum","Cistaceae","Malvales",0,0,0,3,0,NA
"Crocidium","Asteraceae","Asterales",0,0,0,2,0,NA
"Crocodeilanthe","Orchidaceae","Asparagales",0,0,0,1,0,NA
"Crocosmia","Iridaceae","Asparagales",0,0,4,9,4,0
"Crocus","Iridaceae","Asparagales",0,0,6,104,6,0
"Crocyllis","Rubiaceae","Gentianales",0,0,0,1,0,NA
"Croizatia","Phyllanthaceae","Malpighiales",0,0,0,5,0,NA
"Cromidon","Scrophulariaceae","Lamiales",0,0,1,12,1,0
"Croninia","Ericaceae","Ericales",0,0,0,1,0,NA
"Cronquistia","Asteraceae","Asterales",0,0,0,1,0,NA
"Cronquistianthus","Asteraceae","Asterales",0,0,0,28,0,NA
"Croomia","Stemonaceae","Pandanales",0,0,3,5,3,0
"Croptilon","Asteraceae","Asterales",0,0,0,3,0,NA
"Crossandra","Acanthaceae","Lamiales",1,0,0,54,1,1
"Crossandrella","Acanthaceae","Lamiales",0,0,0,3,0,NA
"Crosslandia","Cyperaceae","Poales",0,0,0,1,0,NA
"Crossoglossa","Orchidaceae","Asparagales",0,0,0,26,0,NA
"Crossopetalum","Celastraceae","Celastrales",2,0,0,37,2,1
"Crossopteryx","Rubiaceae","Gentianales",1,0,0,1,1,1
"Crossosoma","Crossosomataceae","Crossosomatales",2,0,0,3,2,1
"Crossosperma","Rutaceae","Sapindales",0,0,0,2,0,NA
"Crossostemma","Passifloraceae","Malpighiales",0,0,0,1,0,NA
"Crossostephium","Asteraceae","Asterales",0,0,0,3,0,NA
"Crossostylis","Rhizophoraceae","Malpighiales",7,0,0,12,7,1
"Crossothamnus","Asteraceae","Asterales",0,0,0,4,0,NA
"Crossotoma","Goodeniaceae","Asterales",1,0,0,2,1,1
"Crossyne","Amaryllidaceae","Asparagales",0,0,0,2,0,NA
"Crotalaria","Fabaceae","Fabales",3,3,3,699,6,0.5
"Croton","Euphorbiaceae","Malpighiales",92,0,9,1205,101,0.910891089108911
"Crotonogyne","Euphorbiaceae","Malpighiales",0,0,0,16,0,NA
"Crotonogynopsis","Euphorbiaceae","Malpighiales",1,0,0,2,1,1
"Crowea","Rutaceae","Sapindales",1,0,0,3,1,1
"Crucianella","Rubiaceae","Gentianales",0,0,4,31,4,0
"Cruciata","Rubiaceae","Gentianales",0,0,4,10,4,0
"Crucicaryum","Boraginaceae","UnknownOrder-Boraginaceae",0,0,0,1,0,NA
"Crucihimalaya","Brassicaceae","Brassicales",0,0,2,12,2,0
"Cruckshanksia","Rubiaceae","Gentianales",0,0,3,7,3,0
"Cruddasia","Fabaceae","Fabales",0,0,0,2,0,NA
"Crudia","Fabaceae","Fabales",21,0,0,55,21,1
"Crumenaria","Rhamnaceae","Rosales",1,0,0,6,1,1
"Crupina","Asteraceae","Asterales",0,0,0,5,0,NA
"Crusea","Rubiaceae","Gentianales",0,0,0,15,0,NA
"Cryosophila","Arecaceae","Arecales",9,0,0,10,9,1
"Crypsinopsis","Polypodiaceae","Polypodiales",0,0,0,5,0,NA
"Crypsinus","Polypodiaceae","Polypodiales",0,0,0,20,0,NA
"Crypsis","Poaceae","Poales",0,0,2,10,2,0
"Cryptadenia","Thymelaeaceae","Malvales",1,0,0,5,1,1
"Cryptandra","Rhamnaceae","Rosales",7,0,0,57,7,1
"Cryptantha","Boraginaceae","UnknownOrder-Boraginaceae",1,1,2,179,3,0.333333333333333
"Cryptanthus","Bromeliaceae","Poales",0,0,5,67,5,0
"Cryptarrhena","Orchidaceae","Asparagales",0,0,2,3,2,0
"Crypteronia","Penaeaceae","Myrtales",5,0,0,7,5,1
"Cryptocapnos","Papaveraceae","Ranunculales",0,0,0,1,0,NA
"Cryptocarpus","Nyctaginaceae","Caryophyllales",0,0,0,1,0,NA
"Cryptocarya","Lauraceae","Laurales",102,0,0,368,102,1
"Cryptocentrum","Orchidaceae","Asparagales",0,0,8,20,8,0
"Cryptochilus","Orchidaceae","Asparagales",0,0,0,5,0,NA
"Cryptochloa","Poaceae","Poales",0,0,0,8,0,NA
"Cryptocodon","Campanulaceae","Asterales",0,0,0,1,0,NA
"Cryptocoryne","Araceae","Alismatales",0,0,0,63,0,NA
"Cryptogramma","Pteridaceae","Polypodiales",0,0,1,12,1,0
"Cryptolepis","Apocynaceae","Gentianales",0,1,0,42,0,NA
"Cryptomeria","Cupressaceae","Cupressales",1,0,0,1,1,1
"Cryptopus","Orchidaceae","Asparagales",0,0,2,4,2,0
"Cryptopylos","Orchidaceae","Asparagales",0,0,1,1,1,0
"Cryptosepalum","Fabaceae","Fabales",1,0,0,11,1,1
"Cryptospora","Brassicaceae","Brassicales",0,0,0,3,0,NA
"Cryptostegia","Apocynaceae","Gentianales",1,0,0,2,1,1
"Cryptostephanus","Amaryllidaceae","Asparagales",0,0,1,3,1,0
"Cryptostylis","Orchidaceae","Asparagales",0,0,1,23,1,0
"Cryptotaenia","Apiaceae","Apiales",0,0,2,7,2,0
"Csapodya","Rubiaceae","Gentianales",0,0,0,3,0,NA
"Ctenanthe","Marantaceae","Zingiberales",0,0,1,15,1,0
"Ctenardisia","Primulaceae","Ericales",0,0,0,5,0,NA
"Ctenitis","Dryopteridaceae","Polypodiales",0,0,3,101,3,0
"Ctenitopsis","Tectariaceae","Polypodiales",0,0,0,4,0,NA
"Ctenium","Poaceae","Poales",0,0,1,20,1,0
"Ctenolepis","Cucurbitaceae","Cucurbitales",0,0,1,3,1,0
"Ctenolophon","Ctenolophonaceae","Malpighiales",2,0,0,2,2,1
"Ctenophyllum","Fabaceae","Fabales",0,0,0,1,0,NA
"Ctenopterella","Polypodiaceae","Polypodiales",0,0,0,8,0,NA
"Ctenopteris","Polypodiaceae","Polypodiales",0,0,0,22,0,NA
"Cuatrecasanthus","Asteraceae","Asterales",0,0,0,3,0,NA
"Cuatrecasasiella","Asteraceae","Asterales",0,0,0,2,0,NA
"Cuatresia","Solanaceae","Solanales",1,0,0,14,1,1
"Cubanola","Rubiaceae","Gentianales",1,0,0,2,1,1
"Cubilia","Sapindaceae","Sapindales",1,0,0,1,1,1
"Cubitanthus","Gesneriaceae","Lamiales",0,0,0,1,0,NA
"Cuchumatanea","Asteraceae","Asterales",0,0,0,1,0,NA
"Cucumella","Cucurbitaceae","Cucurbitales",1,0,0,2,1,1
"Cucumeropsis","Cucurbitaceae","Cucurbitales",0,0,0,1,0,NA
"Cucumis","Cucurbitaceae","Cucurbitales",0,0,15,52,15,0
"Cucurbita","Cucurbitaceae","Cucurbitales",0,0,4,19,4,0
"Cucurbitella","Cucurbitaceae","Cucurbitales",0,0,1,1,1,0
"Cuenotia","Acanthaceae","Lamiales",0,0,0,1,0,NA
"Cuervea","Celastraceae","Celastrales",1,0,0,7,1,1
"Cuitlauzina","Orchidaceae","Asparagales",0,0,1,7,1,0
"Culcasia","Araceae","Alismatales",1,0,0,28,1,1
"Culcita","Culcitaceae","Cyatheales",0,0,0,2,0,NA
"Culcitium","Asteraceae","Asterales",0,0,1,6,1,0
"Cullen","Fabaceae","Fabales",1,0,0,13,1,1
"Cullumia","Asteraceae","Asterales",1,0,0,16,1,1
"Cumaruna","Fabaceae","Fabales",0,0,0,1,0,NA
"Cuminia","Lamiaceae","Lamiales",0,0,0,1,0,NA
"Cuminum","Apiaceae","Apiales",0,0,0,4,0,NA
"Cumulopuntia","Cactaceae","Caryophyllales",0,0,0,18,0,NA
"Cuniculotinus","Asteraceae","Asterales",0,0,0,1,0,NA
"Cunila","Lamiaceae","Lamiales",1,0,0,18,1,1
"Cunninghamia","Cupressaceae","Cupressales",2,0,0,2,2,1
"Cunonia","Cunoniaceae","Oxalidales",6,0,0,26,6,1
"Cupania","Sapindaceae","Sapindales",13,0,0,58,13,1
"Cupaniopsis","Sapindaceae","Sapindales",9,0,0,63,9,1
"Cuphea","Lythraceae","Myrtales",3,0,3,280,6,0.5
"Cuphonotus","Brassicaceae","Brassicales",0,0,1,2,1,0
"Cupressus","Cupressaceae","Cupressales",14,0,0,19,14,1
"Curarea","Menispermaceae","Ranunculales",0,3,0,5,0,NA
"Curatella","Dilleniaceae","Dilleniales",1,0,0,1,1,1
"Curculigo","Hypoxidaceae","Asparagales",0,0,0,15,0,NA
"Curcuma","Zingiberaceae","Zingiberales",0,0,11,93,11,0
"Curio","Asteraceae","Asterales",0,0,0,1,0,NA
"Curitiba","Myrtaceae","Myrtales",0,0,0,1,0,NA
"Curtia","Gentianaceae","Gentianales",0,0,0,11,0,NA
"Curtisia","Curtisiaceae","Cornales",1,0,0,1,1,1
"Curupira","Olacaceae","Santalales",1,0,0,1,1,1
"Cuscatlania","Nyctaginaceae","Caryophyllales",0,0,0,1,0,NA
"Cuscuta","Convolvulaceae","Solanales",0,0,19,171,19,0
"Cusickiella","Brassicaceae","Brassicales",0,0,1,2,1,0
"Cuspidaria","Bignoniaceae","Lamiales",6,0,0,16,6,1
"Cuspidia","Asteraceae","Asterales",0,0,1,1,1,0
"Cussetia","Podostemaceae","Malpighiales",0,0,0,2,0,NA
"Cussonia","Araliaceae","Apiales",4,0,0,20,4,1
"Cutandia","Poaceae","Poales",0,0,1,6,1,0
"Cuttsia","Rousseaceae","Asterales",1,0,0,1,1,1
"Cuviera","Rubiaceae","Gentianales",2,0,0,24,2,1
"Cyamopsis","Fabaceae","Fabales",0,0,0,5,0,NA
"Cyanaeorchis","Orchidaceae","Asparagales",0,0,0,2,0,NA
"Cyananthus","Campanulaceae","Asterales",0,0,3,20,3,0
"Cyanastrum","Tecophilaeaceae","Asparagales",0,0,1,3,1,0
"Cyanea","Campanulaceae","Asterales",5,0,0,79,5,1
"Cyanella","Tecophilaeaceae","Asparagales",0,0,4,7,4,0
"Cyanicula","Orchidaceae","Asparagales",0,0,2,10,2,0
"Cyanixia","Iridaceae","Asparagales",0,0,0,1,0,NA
"Cyanoneuron","Rubiaceae","Gentianales",0,0,0,5,0,NA
"Cyanostegia","Lamiaceae","Lamiales",1,0,0,5,1,1
"Cyanotis","Commelinaceae","Commelinales",0,0,8,52,8,0
"Cyanthera","Orchidaceae","Asparagales",0,0,0,1,0,NA
"Cyanthillium","Asteraceae","Asterales",0,0,0,8,0,NA
"Cyanus","Asteraceae","Asterales",0,0,0,44,0,NA
"Cyathea","Cyatheaceae","Cyatheales",3,0,1,320,4,0.75
"Cyathobasis","Amaranthaceae","Caryophyllales",0,0,0,1,0,NA
"Cyathocalyx","Annonaceae","Magnoliales",4,0,0,22,4,1
"Cyathochaeta","Cyperaceae","Poales",0,0,3,5,3,0
"Cyathocline","Asteraceae","Asterales",0,0,0,4,0,NA
"Cyathocoma","Cyperaceae","Poales",0,0,2,3,2,0
"Cyathodes","Ericaceae","Ericales",1,0,0,3,1,1
"Cyathomone","Asteraceae","Asterales",0,0,0,1,0,NA
"Cyathopsis","Ericaceae","Ericales",0,0,0,3,0,NA
"Cyathopus","Poaceae","Poales",0,0,0,1,0,NA
"Cyathoselinum","Apiaceae","Apiales",0,0,0,1,0,NA
"Cyathostegia","Fabaceae","Fabales",0,0,0,2,0,NA
"Cyathostelma","Apocynaceae","Gentianales",0,0,0,1,0,NA
"Cyathostemma","Annonaceae","Magnoliales",0,0,0,1,0,NA
"Cyathostemon","Myrtaceae","Myrtales",0,0,0,1,0,NA
"Cyathula","Amaranthaceae","Caryophyllales",0,0,2,29,2,0
"Cybebus","Orchidaceae","Asparagales",0,0,0,1,0,NA
"Cybianthus","Primulaceae","Ericales",5,0,0,161,5,1
"Cybistax","Bignoniaceae","Lamiales",1,0,0,1,1,1
"Cycas","Cycadaceae","Cycadales",58,0,0,92,58,1
"Cyclacanthus","Acanthaceae","Lamiales",0,0,0,2,0,NA
"Cycladenia","Apocynaceae","Gentianales",0,0,1,1,1,0
"Cyclamen","Primulaceae","Ericales",0,0,16,20,16,0
"Cyclanthera","Cucurbitaceae","Cucurbitales",0,0,1,33,1,0
"Cyclantheropsis","Cucurbitaceae","Cucurbitales",0,0,0,3,0,NA
"Cyclanthus","Cyclanthaceae","Pandanales",0,0,0,2,0,NA
"Cyclea","Menispermaceae","Ranunculales",0,1,1,36,1,0
"Cyclobalanopsis","Fagaceae","Fagales",0,0,0,2,0,NA
"Cyclocarpa","Fabaceae","Fabales",0,0,0,1,0,NA
"Cyclocarya","Juglandaceae","Fagales",1,0,0,1,1,1
"Cyclocheilon","Orobanchaceae","Lamiales",1,0,0,3,1,1
"Cyclocodon","Campanulaceae","Asterales",0,0,2,2,2,0
"Cyclocotyla","Apocynaceae","Gentianales",0,0,0,1,0,NA
"Cyclodium","Dryopteridaceae","Polypodiales",0,0,0,10,0,NA
"Cyclogramma","Thelypteridaceae","Polypodiales",0,0,0,10,0,NA
"Cyclolepis","Asteraceae","Asterales",1,0,0,1,1,1
"Cyclolobium","Fabaceae","Fabales",1,0,0,5,1,1
"Cycloloma","Amaranthaceae","Caryophyllales",0,0,0,1,0,NA
"Cyclopeltis","Lomariopsidaceae","Polypodiales",0,0,0,2,0,NA
"Cyclophorus","Polypodiaceae","Polypodiales",0,0,0,4,0,NA
"Cyclophyllum","Rubiaceae","Gentianales",1,0,0,37,1,1
"Cyclopia","Fabaceae","Fabales",9,1,0,20,9,1
"Cyclopogon","Orchidaceae","Asparagales",0,0,0,83,0,NA
"Cyclorhiza","Apiaceae","Apiales",0,0,0,2,0,NA
"Cyclosorus","Thelypteridaceae","Polypodiales",0,0,3,170,3,0
"Cyclospermum","Apiaceae","Apiales",0,0,1,5,1,0
"Cyclostachya","Poaceae","Poales",0,0,0,1,0,NA
"Cyclotrichium","Lamiaceae","Lamiales",0,0,0,9,0,NA
"Cycniopsis","Orobanchaceae","Lamiales",0,0,0,2,0,NA
"Cycnium","Orobanchaceae","Lamiales",1,0,0,15,1,1
"Cycnoches","Orchidaceae","Asparagales",0,0,2,34,2,0
"Cycnogeton","Juncaginaceae","Alismatales",0,0,1,8,1,0
"Cydonia","Rosaceae","Rosales",1,0,0,1,1,1
"Cylactis","Rosaceae","Rosales",0,0,0,1,0,NA
"Cylicodiscus","Fabaceae","Fabales",1,0,0,1,1,1
"Cylicomorpha","Caricaceae","Brassicales",1,0,0,2,1,1
"Cylindrocarpa","Campanulaceae","Asterales",0,0,0,1,0,NA
"Cylindrocline","Asteraceae","Asterales",1,0,0,2,1,1
"Cylindrokelupha","Fabaceae","Fabales",0,0,0,1,0,NA
"Cylindrophyllum","Aizoaceae","Caryophyllales",0,0,0,5,0,NA
"Cylindropsis","Apocynaceae","Gentianales",0,0,0,1,0,NA
"Cylindropuntia","Cactaceae","Caryophyllales",2,0,0,43,2,1
"Cymaria","Lamiaceae","Lamiales",0,0,0,2,0,NA
"Cymatocarpus","Brassicaceae","Brassicales",0,0,0,3,0,NA
"Cymbalaria","Plantaginaceae","Lamiales",0,0,1,10,1,0
"Cymbaria","Orobanchaceae","Lamiales",0,0,1,5,1,0
"Cymbidiella","Orchidaceae","Asparagales",0,0,1,3,1,0
"Cymbidium","Orchidaceae","Asparagales",0,0,29,83,29,0
"Cymbocarpa","Burmanniaceae","Dioscoreales",0,0,0,2,0,NA
"Cymbocarpum","Apiaceae","Apiales",0,0,0,5,0,NA
"Cymbolaena","Asteraceae","Asterales",0,0,0,1,0,NA
"Cymbonotus","Asteraceae","Asterales",0,0,1,2,1,0
"Cymbopappus","Asteraceae","Asterales",0,0,0,3,0,NA
"Cymbopetalum","Annonaceae","Magnoliales",6,0,0,27,6,1
"Cymbopogon","Poaceae","Poales",0,0,9,52,9,0
"Cymbosema","Fabaceae","Fabales",1,0,0,1,1,1
"Cymodocea","Cymodoceaceae","Alismatales",0,0,2,4,2,0
"Cymophora","Asteraceae","Asterales",0,0,0,4,0,NA
"Cymophyllus","Cyperaceae","Poales",0,0,1,1,1,0
"Cymopterus","Apiaceae","Apiales",0,0,0,52,0,NA
"Cynanchum","Apocynaceae","Gentianales",1,0,1,283,2,0.5
"Cynara","Asteraceae","Asterales",0,0,2,11,2,0
"Cynarospermum","Acanthaceae","Lamiales",0,0,0,1,0,NA
"Cyne","Loranthaceae","Santalales",0,0,0,6,0,NA
"Cynochloris","Poaceae","Poales",0,0,0,2,0,NA
"Cynodon","Poaceae","Poales",0,0,3,11,3,0
"Cynoglossopsis","Boraginaceae","UnknownOrder-Boraginaceae",0,0,0,2,0,NA
"Cynoglossum","Boraginaceae","UnknownOrder-Boraginaceae",0,0,3,83,3,0
"Cynoglottis","Boraginaceae","UnknownOrder-Boraginaceae",0,0,0,2,0,NA
"Cynometra","Fabaceae","Fabales",18,0,0,88,18,1
"Cynomorium","Cynomoriaceae","UnknownOrder-Cynomoriaceae",0,0,1,1,1,0
"Cynophalla","Capparaceae","Brassicales",0,0,0,14,0,NA
"Cynorkis","Orchidaceae","Asparagales",0,0,2,158,2,0
"Cynosciadium","Apiaceae","Apiales",0,0,0,1,0,NA
"Cynosurus","Poaceae","Poales",0,0,2,9,2,0
"Cypella","Iridaceae","Asparagales",0,0,13,25,13,0
"Cyperochloa","Poaceae","Poales",0,0,1,1,1,0
"Cyperocymbidium","Orchidaceae","Asparagales",0,0,0,1,0,NA
"Cyperorchis","Orchidaceae","Asparagales",0,0,0,1,0,NA
"Cyperus","Cyperaceae","Poales",0,0,157,699,157,0
"Cyphacanthus","Acanthaceae","Lamiales",0,0,0,1,0,NA
"Cyphanthera","Solanaceae","Solanales",4,0,0,9,4,1
"Cyphia","Campanulaceae","Asterales",0,0,5,68,5,0
"Cyphocardamum","Brassicaceae","Brassicales",0,0,0,1,0,NA
"Cyphocarpa","Amaranthaceae","Caryophyllales",0,0,0,1,0,NA
"Cyphocarpus","Campanulaceae","Asterales",0,0,2,3,2,0
"Cyphochilus","Orchidaceae","Asparagales",0,0,0,8,0,NA
"Cyphochlaena","Poaceae","Poales",0,0,0,2,0,NA
"Cyphokentia","Arecaceae","Arecales",2,0,0,2,2,1
"Cypholophus","Urticaceae","Rosales",0,0,0,35,0,NA
"Cypholoron","Orchidaceae","Asparagales",0,0,0,3,0,NA
"Cyphomandra","Solanaceae","Solanales",0,0,0,1,0,NA
"Cyphomeris","Nyctaginaceae","Caryophyllales",0,0,1,2,1,0
"Cyphophoenix","Arecaceae","Arecales",3,0,0,4,3,1
"Cyphosperma","Arecaceae","Arecales",1,0,0,4,1,1
"Cyphostemma","Vitaceae","Vitales",0,0,0,253,0,NA
"Cyphostigma","Zingiberaceae","Zingiberales",0,0,0,1,0,NA
"Cyphotheca","Melastomataceae","Myrtales",0,0,0,1,0,NA
"Cypringlea","Cyperaceae","Poales",0,0,0,3,0,NA
"Cypripedium","Orchidaceae","Asparagales",0,0,15,59,15,0
"Cypselea","Aizoaceae","Caryophyllales",0,0,0,2,0,NA
"Cypselocarpus","Gyrostemonaceae","Brassicales",0,0,0,1,0,NA
"Cyrilla","Cyrillaceae","Ericales",1,0,0,7,1,1
"Cyrillopsis","Ixonanthaceae","Malpighiales",1,0,0,2,1,1
"Cyrtandra","Gesneriaceae","Lamiales",2,0,0,733,2,1
"Cyrtandromoea","Gesneriaceae","Lamiales",1,0,0,12,1,1
"Cyrtanthus","Amaryllidaceae","Asparagales",0,0,3,56,3,0
"Cyrtidiorchis","Orchidaceae","Asparagales",0,0,2,5,2,0
"Cyrtocarpa","Anacardiaceae","Sapindales",3,0,0,5,3,1
"Cyrtochiloides","Orchidaceae","Asparagales",0,0,2,3,2,0
"Cyrtochilum","Orchidaceae","Asparagales",0,0,12,138,12,0
"Cyrtochloa","Poaceae","Poales",0,0,0,7,0,NA
"Cyrtococcum","Poaceae","Poales",0,0,2,14,2,0
"Cyrtocymura","Asteraceae","Asterales",0,0,0,6,0,NA
"Cyrtogonellum","Dryopteridaceae","Polypodiales",0,0,0,8,0,NA
"Cyrtogonone","Euphorbiaceae","Malpighiales",1,0,0,1,1,1
"Cyrtomidictyum","Dryopteridaceae","Polypodiales",0,0,0,4,0,NA
"Cyrtomium","Dryopteridaceae","Polypodiales",0,0,0,43,0,NA
"Cyrtopodium","Orchidaceae","Asparagales",0,0,2,48,2,0
"Cyrtorchis","Orchidaceae","Asparagales",0,0,4,18,4,0
"Cyrtorhyncha","Ranunculaceae","Ranunculales",0,0,0,1,0,NA
"Cyrtosia","Orchidaceae","Asparagales",0,0,0,5,0,NA
"Cyrtosperma","Araceae","Alismatales",0,0,0,12,0,NA
"Cyrtostachys","Arecaceae","Arecales",1,0,0,7,1,1
"Cyrtostylis","Orchidaceae","Asparagales",0,0,0,5,0,NA
"Cystacanthus","Acanthaceae","Lamiales",0,0,0,3,0,NA
"Cysticapnos","Papaveraceae","Ranunculales",0,0,0,3,0,NA
"Cystium","Fabaceae","Fabales",0,0,0,1,0,NA
"Cystoathyrium","Cystopteridaceae","Polypodiales",0,0,0,1,0,NA
"Cystopteris","Cystopteridaceae","Polypodiales",0,0,5,26,5,0
"Cystorchis","Orchidaceae","Asparagales",0,0,0,21,0,NA
"Cystostemon","Boraginaceae","UnknownOrder-Boraginaceae",0,1,0,16,0,NA
"Cytinus","Cytinaceae","Malvales",0,0,0,8,0,NA
"Cytisanthus","Fabaceae","Fabales",0,0,0,3,0,NA
"Cytisogenista","Fabaceae","Fabales",0,0,0,1,0,NA
"Cytisophyllum","Fabaceae","Fabales",1,0,0,1,1,1
"Cytisopsis","Fabaceae","Fabales",0,0,0,2,0,NA
"Cytisus","Fabaceae","Fabales",6,0,0,73,6,1
"Cytogonidium","Restionaceae","Poales",0,0,1,1,1,0
"Cyttaranthus","Euphorbiaceae","Malpighiales",1,0,0,1,1,1
"Daboecia","Ericaceae","Ericales",1,0,0,2,1,1
"Dacrycarpus","Podocarpaceae","Araucariales",6,0,0,9,6,1
"Dacrydium","Podocarpaceae","Araucariales",9,0,0,22,9,1
"Dacryodes","Burseraceae","Sapindales",25,0,0,62,25,1
"Dacryotrichia","Asteraceae","Asterales",0,0,0,1,0,NA
"Dactyladenia","Chrysobalanaceae","Malpighiales",2,0,0,30,2,1
"Dactylaea","Apiaceae","Apiales",0,0,0,2,0,NA
"Dactylaena","Cleomaceae","Brassicales",0,0,0,6,0,NA
"Dactylanthera","Orchidaceae","Asparagales",0,0,0,4,0,NA
"Dactylanthus","Balanophoraceae","Santalales",0,0,1,1,1,0
"Dactyliandra","Cucurbitaceae","Cucurbitales",0,0,1,2,1,0
"Dactylicapnos","Papaveraceae","Ranunculales",0,0,0,11,0,NA
"Dactyliophora","Loranthaceae","Santalales",0,0,0,3,0,NA
"Dactylis","Poaceae","Poales",0,0,1,2,1,0
"Dactylocamptis","Orchidaceae","Asparagales",0,0,0,1,0,NA
"Dactylocardamum","Brassicaceae","Brassicales",0,0,0,1,0,NA
"Dactylocladus","Penaeaceae","Myrtales",1,0,0,1,1,1
"Dactyloctenium","Poaceae","Poales",0,0,2,12,2,0
"Dactylodenia","Orchidaceae","Asparagales",0,0,0,21,0,NA
"Dactyloglossum","Orchidaceae","Asparagales",0,0,0,8,0,NA
"Dactylogymnadenia","Orchidaceae","Asparagales",0,0,0,9,0,NA
"Dactylorchis","Orchidaceae","Asparagales",0,0,0,1,0,NA
"Dactylorhiza","Orchidaceae","Asparagales",0,0,5,115,5,0
"Dactylostalix","Orchidaceae","Asparagales",0,0,0,1,0,NA
"Dactylostelma","Apocynaceae","Gentianales",0,0,0,1,0,NA
"Daemonorops","Arecaceae","Arecales",1,0,0,107,1,1
"Daenikera","Santalaceae","Santalales",0,0,0,1,0,NA
"Dahlia","Asteraceae","Asterales",0,0,2,42,2,0
"Dahliaphyllum","Apiaceae","Apiales",0,0,0,1,0,NA
"Dahlstedtia","Fabaceae","Fabales",0,0,0,1,0,NA
"Daiotyla","Orchidaceae","Asparagales",0,0,2,4,2,0
"Dais","Thymelaeaceae","Malvales",1,0,0,2,1,1
"Dalbergia","Fabaceae","Fabales",43,0,0,287,43,1
"Dalbergiella","Fabaceae","Fabales",1,0,0,3,1,1
"Dalea","Fabaceae","Fabales",0,0,4,183,4,0
"Dalechampia","Euphorbiaceae","Malpighiales",1,0,1,122,2,0.5
"Dalembertia","Euphorbiaceae","Malpighiales",1,0,0,4,1,1
"Dalhousiea","Fabaceae","Fabales",0,0,0,3,0,NA
"Dallwatsonia","Poaceae","Poales",0,0,0,1,0,NA
"Dalzellia","Podostemaceae","Malpighiales",0,0,0,7,0,NA
"Dalzielia","Apocynaceae","Gentianales",0,0,0,1,0,NA
"Damapana","Fabaceae","Fabales",0,0,0,11,0,NA
"Damasonium","Alismataceae","Alismatales",0,0,4,6,4,0
"Damnacanthus","Rubiaceae","Gentianales",3,0,0,13,3,1
"Damnamenia","Asteraceae","Asterales",0,0,0,1,0,NA
"Damnxanthodium","Asteraceae","Asterales",0,0,1,1,1,0
"Dampiera","Goodeniaceae","Asterales",4,0,9,70,13,0.307692307692308
"Damrongia","Gesneriaceae","Lamiales",0,0,0,6,0,NA
"Danae","Asparagaceae","Asparagales",1,0,0,1,1,1
"Danaea","Marattiaceae","Marattiales",0,0,16,30,16,0
"Danaeopsis","Dryopteridaceae","Polypodiales",0,0,1,1,1,0
"Danais","Rubiaceae","Gentianales",2,0,0,31,2,1
"Dandya","Asparagaceae","Asparagales",0,0,1,4,1,0
"Danguya","Acanthaceae","Lamiales",0,0,0,1,0,NA
"Danhatchia","Orchidaceae","Asparagales",0,0,0,1,0,NA
"Daniellia","Fabaceae","Fabales",6,0,0,8,6,1
"Dankia","Theaceae","Ericales",0,0,0,1,0,NA
"Dansiea","Combretaceae","Myrtales",0,0,0,2,0,NA
"Danthonia","Poaceae","Poales",0,0,8,25,8,0
"Danthonidium","Poaceae","Poales",0,0,0,1,0,NA
"Danthoniopsis","Poaceae","Poales",0,0,2,16,2,0
"Danthosieglingia","Poaceae","Poales",0,0,0,1,0,NA
"Dapania","Oxalidaceae","Oxalidales",1,0,0,3,1,1
"Daphnandra","Atherospermataceae","Laurales",5,0,0,7,5,1
"Daphne","Thymelaeaceae","Malvales",5,0,1,92,6,0.833333333333333
"Daphnimorpha","Thymelaeaceae","Malvales",0,0,0,2,0,NA
"Daphniphyllum","Daphniphyllaceae","Saxifragales",8,0,0,29,8,1
"Daphnopsis","Thymelaeaceae","Malvales",5,0,0,73,5,1
"Dapsilanthus","Restionaceae","Poales",0,0,3,4,3,0
"Darcya","Plantaginaceae","Lamiales",0,0,0,3,0,NA
"Darcyanthus","Solanaceae","Solanales",0,0,0,1,0,NA
"Darea","Aspleniaceae","Polypodiales",0,0,0,2,0,NA
"Darlingia","Proteaceae","Proteales",2,0,0,2,2,1
"Darlingtonia","Sarraceniaceae","Ericales",0,0,1,1,1,0
"Darmera","Saxifragaceae","Saxifragales",0,0,1,1,1,0
"Darwinia","Myrtaceae","Myrtales",19,0,0,52,19,1
"Darwiniothamnus","Asteraceae","Asterales",0,0,0,3,0,NA
"Dasiphora","Rosaceae","Rosales",0,0,0,1,0,NA
"Dasispermum","Apiaceae","Apiales",0,1,0,7,0,NA
"Dasistoma","Orobanchaceae","Lamiales",0,0,1,1,1,0
"Dasyandantha","Asteraceae","Asterales",0,0,0,1,0,NA
"Dasyanthina","Asteraceae","Asterales",0,0,0,2,0,NA
"Dasycondylus","Asteraceae","Asterales",0,0,0,8,0,NA
"Dasylepis","Achariaceae","Malpighiales",1,0,0,6,1,1
"Dasylirion","Asparagaceae","Asparagales",5,0,0,22,5,1
"Dasymaschalon","Annonaceae","Magnoliales",2,0,0,23,2,1
"Dasynotus","Boraginaceae","UnknownOrder-Boraginaceae",0,0,0,1,0,NA
"Dasyphyllum","Asteraceae","Asterales",2,0,0,38,2,1
"Dasypogon","Dasypogonaceae","UnknownOrder-Dasypogonaceae",1,0,0,3,1,1
"Dasypyrum","Poaceae","Poales",0,0,0,2,0,NA
"Dasysphaera","Amaranthaceae","Caryophyllales",0,0,0,4,0,NA
"Dasytropis","Acanthaceae","Lamiales",0,0,0,1,0,NA
"Datisca","Datiscaceae","Cucurbitales",0,0,2,2,2,0
"Datura","Solanaceae","Solanales",0,0,2,13,2,0
"Daubentonia","Fabaceae","Fabales",0,0,0,1,0,NA
"Daubenya","Asparagaceae","Asparagales",0,0,1,8,1,0
"Daucosma","Apiaceae","Apiales",0,0,0,1,0,NA
"Daucus","Apiaceae","Apiales",0,0,2,28,2,0
"Dauphinea","Lamiaceae","Lamiales",0,0,0,1,0,NA
"Dauresia","Asteraceae","Asterales",0,0,0,1,0,NA
"Davallia","Davalliaceae","Polypodiales",0,0,0,22,0,NA
"Davallodes","Davalliaceae","Polypodiales",0,0,0,2,0,NA
"Daveaua","Asteraceae","Asterales",0,0,0,1,0,NA
"Davidia","Cornaceae","Cornales",1,0,0,1,1,1
"Davidsea","Poaceae","Poales",0,0,0,1,0,NA
"Davidsonia","Cunoniaceae","Oxalidales",2,0,0,3,2,1
"Daviesia","Fabaceae","Fabales",6,0,0,82,6,1
"Davilla","Dilleniaceae","Dilleniales",2,0,0,29,2,1
"Dayaoshania","Gesneriaceae","Lamiales",0,0,0,1,0,NA
"Dayia","Polemoniaceae","Ericales",0,0,0,2,0,NA
"Debregeasia","Urticaceae","Rosales",1,0,0,6,1,1
"Decachaeta","Asteraceae","Asterales",0,0,0,8,0,NA
"Decagonocarpus","Rutaceae","Sapindales",0,0,0,2,0,NA
"Decaisnea","Lardizabalaceae","Ranunculales",1,0,0,1,1,1
"Decaisnina","Loranthaceae","Santalales",1,0,0,25,1,1
"Decalepis","Apocynaceae","Gentianales",0,0,0,4,0,NA
"Decanema","Apocynaceae","Gentianales",0,0,0,2,0,NA
"Decaneuropsis","Asteraceae","Asterales",0,0,0,12,0,NA
"Decaneurum","Asteraceae","Asterales",0,0,0,1,0,NA
"Decaphalangium","Clusiaceae","Malpighiales",1,0,0,1,1,1
"Decaptera","Brassicaceae","Brassicales",0,0,0,1,0,NA
"Decarya","Didiereaceae","Caryophyllales",1,0,0,1,1,1
"Decarydendron","Monimiaceae","Laurales",1,0,0,4,1,1
"Decaryella","Poaceae","Poales",0,0,0,1,0,NA
"Decaryochloa","Poaceae","Poales",0,0,0,1,0,NA
"Decaschistia","Malvaceae","Malvales",1,0,0,17,1,1
"Decaspermum","Myrtaceae","Myrtales",7,0,0,34,7,1
"Decastelma","Apocynaceae","Gentianales",0,0,0,2,0,NA
"Decastylocarpus","Asteraceae","Asterales",0,0,0,1,0,NA
"Decatoca","Ericaceae","Ericales",0,0,0,1,0,NA
"Decatropis","Rutaceae","Sapindales",0,0,0,3,0,NA
"Decazesia","Asteraceae","Asterales",0,0,0,1,0,NA
"Decazyx","Rutaceae","Sapindales",0,0,0,2,0,NA
"Deccania","Rubiaceae","Gentianales",0,0,0,1,0,NA
"Deceptor","Orchidaceae","Asparagales",0,0,0,1,0,NA
"Deckenia","Arecaceae","Arecales",0,0,0,1,0,NA
"Declieuxia","Rubiaceae","Gentianales",0,0,0,29,0,NA
"Decodon","Lythraceae","Myrtales",1,0,0,1,1,1
"Decorsea","Fabaceae","Fabales",0,0,0,6,0,NA
"Decorsella","Violaceae","Malpighiales",0,0,0,1,0,NA
"Decumaria","Hydrangeaceae","Cornales",0,0,0,2,0,NA
"Dedeckera","Polygonaceae","Caryophyllales",1,0,0,1,1,1
"Deeringia","Amaranthaceae","Caryophyllales",1,2,0,10,1,1
"Deeringothamnus","Annonaceae","Magnoliales",1,0,0,1,1,1
"Degeneria","Degeneriaceae","Magnoliales",2,0,0,2,2,1
"Degenia","Brassicaceae","Brassicales",0,0,0,1,0,NA
"Degranvillea","Orchidaceae","Asparagales",0,0,0,1,0,NA
"Deguelia","Fabaceae","Fabales",2,1,0,18,2,1
"Dehaasia","Lauraceae","Laurales",8,0,0,38,8,1
"Deherainia","Primulaceae","Ericales",1,0,0,4,1,1
"Deianira","Gentianaceae","Gentianales",0,0,0,7,0,NA
"Deidamia","Passifloraceae","Malpighiales",0,0,0,5,0,NA
"Deilanthe","Aizoaceae","Caryophyllales",0,0,0,3,0,NA
"Deinandra","Asteraceae","Asterales",2,0,0,18,2,1
"Deinanthe","Hydrangeaceae","Cornales",0,0,1,2,1,0
"Deinbollia","Sapindaceae","Sapindales",3,0,0,41,3,1
"Deinocheilos","Gesneriaceae","Lamiales",0,0,0,2,0,NA
"Deinostema","Plantaginaceae","Lamiales",0,0,0,2,0,NA
"Deinostigma","Gesneriaceae","Lamiales",0,0,0,1,0,NA
"Deiregyne","Orchidaceae","Asparagales",0,0,0,18,0,NA
"Delairea","Asteraceae","Asterales",0,0,1,1,1,0
"Delamerea","Asteraceae","Asterales",0,0,0,1,0,NA
"Delarbrea","Myodocarpaceae","Apiales",5,0,0,7,5,1
"Delavaya","Sapindaceae","Sapindales",1,0,0,1,1,1
"Delilia","Asteraceae","Asterales",0,0,1,3,1,0
"Delissea","Campanulaceae","Asterales",1,0,0,15,1,1
"Delonix","Fabaceae","Fabales",4,0,0,11,4,1
"Delopyrum","Polygonaceae","Caryophyllales",0,0,0,1,0,NA
"Delosperma","Aizoaceae","Caryophyllales",0,0,1,175,1,0
"Delostoma","Bignoniaceae","Lamiales",0,0,0,4,0,NA
"Delphinium","Ranunculaceae","Ranunculales",0,0,7,457,7,0
"Delpinophytum","Brassicaceae","Brassicales",0,0,0,1,0,NA
"Delpydora","Sapotaceae","Ericales",2,0,0,2,2,1
"Deltaria","Thymelaeaceae","Malvales",0,0,0,1,0,NA
"Delwiensia","Asteraceae","Asterales",0,0,0,1,0,NA
"Demavendia","Apiaceae","Apiales",0,0,0,1,0,NA
"Demosthenesia","Ericaceae","Ericales",0,0,0,13,0,NA
"Dendranthema","Asteraceae","Asterales",0,0,0,36,0,NA
"Dendroarabis","Brassicaceae","Brassicales",0,0,0,1,0,NA
"Dendrobangia","Cardiopteridaceae","Aquifoliales",1,0,0,3,1,1
"Dendrobium","Orchidaceae","Asparagales",0,0,27,1523,27,0
"Dendrocacalia","Asteraceae","Asterales",0,0,0,2,0,NA
"Dendrocalamus","Poaceae","Poales",4,0,0,53,4,1
"Dendrochilum","Orchidaceae","Asparagales",0,0,3,278,3,0
"Dendrocnide","Urticaceae","Rosales",1,0,0,43,1,1
"Dendroconche","Polypodiaceae","Polypodiales",0,0,0,1,0,NA
"Dendrocousinsia","Euphorbiaceae","Malpighiales",0,0,0,3,0,NA
"Dendroglossa","Polypodiaceae","Polypodiales",0,0,0,3,0,NA
"Dendrokingstonia","Annonaceae","Magnoliales",0,0,0,1,0,NA
"Dendrolobium","Fabaceae","Fabales",1,0,0,18,1,1
"Dendrolycopodium","Lycopodiaceae","Lycopodiales",0,0,4,4,4,0
"Dendromecon","Papaveraceae","Ranunculales",2,0,0,2,2,1
"Dendromyza","Santalaceae","Santalales",0,0,0,9,0,NA
"Dendropanax","Araliaceae","Apiales",7,0,0,99,7,1
"Dendropemon","Loranthaceae","Santalales",1,0,0,26,1,1
"Dendrophorbium","Asteraceae","Asterales",0,0,0,72,0,NA
"Dendrophthoe","Loranthaceae","Santalales",2,0,0,59,2,1
"Dendrophthora","Santalaceae","Santalales",1,0,0,127,1,1
"Dendrophylax","Orchidaceae","Asparagales",0,0,7,14,7,0
"Dendroportulaca","Portulacaceae","Caryophyllales",0,0,0,1,0,NA
"Dendrorchis","Orchidaceae","Asparagales",0,0,0,1,0,NA
"Dendrosenecio","Asteraceae","Asterales",0,0,0,11,0,NA
"Dendroseris","Asteraceae","Asterales",5,0,0,12,5,1
"Dendrosicyos","Cucurbitaceae","Cucurbitales",0,0,0,1,0,NA
"Dendrosida","Malvaceae","Malvales",0,0,0,6,0,NA
"Dendrosipanea","Rubiaceae","Gentianales",0,0,0,2,0,NA
"Dendrosma","Rutaceae","Sapindales",0,0,0,1,0,NA
"Dendrostylis","Achariaceae","Malpighiales",0,0,0,1,0,NA
"Dendrothrix","Euphorbiaceae","Malpighiales",0,0,0,3,0,NA
"Dendrotrophe","Santalaceae","Santalales",1,0,0,7,1,1
"Dendroviguiera","Asteraceae","Asterales",0,0,0,2,0,NA
"Denhamia","Celastraceae","Celastrales",3,0,0,7,3,1
"Denmoza","Cactaceae","Caryophyllales",0,0,0,2,0,NA
"Dennettia","Annonaceae","Magnoliales",0,0,0,1,0,NA
"Dennstaedtia","Dennstaedtiaceae","Polypodiales",0,0,1,39,1,0
"Denscantia","Rubiaceae","Gentianales",0,0,0,4,0,NA
"Dentaria","Brassicaceae","Brassicales",0,0,0,1,0,NA
"Dentella","Rubiaceae","Gentianales",0,0,0,8,0,NA
"Depanthus","Gesneriaceae","Lamiales",0,0,0,2,0,NA
"Deparia","Athyriaceae","Polypodiales",0,0,1,34,1,0
"Deplanchea","Bignoniaceae","Lamiales",3,0,0,8,3,1
"Deppea","Rubiaceae","Gentianales",2,0,0,35,2,1
"Deprea","Solanaceae","Solanales",0,0,0,10,0,NA
"Dermatobotrys","Scrophulariaceae","Lamiales",0,0,1,1,1,0
"Dermatophyllum","Fabaceae","Fabales",0,0,0,6,0,NA
"Derris","Fabaceae","Fabales",5,2,0,87,5,1
"Desbordesia","Irvingiaceae","Malpighiales",1,0,0,1,1,1
"Deschampsia","Poaceae","Poales",0,0,10,42,10,0
"Descurainia","Brassicaceae","Brassicales",0,0,1,46,1,0
"Desfontainia","Columelliaceae","Bruniales",1,0,0,3,1,1
"Desideria","Brassicaceae","Brassicales",0,0,3,12,3,0
"Desmanthodium","Asteraceae","Asterales",1,0,0,8,1,1
"Desmanthus","Fabaceae","Fabales",1,0,3,29,4,0.25
"Desmaria","Loranthaceae","Santalales",0,0,0,1,0,NA
"Desmazeria","Poaceae","Poales",0,0,0,4,0,NA
"Desmidorchis","Apocynaceae","Gentianales",0,0,0,1,0,NA
"Desmocladus","Restionaceae","Poales",0,0,2,15,2,0
"Desmodiastrum","Fabaceae","Fabales",0,0,0,3,0,NA
"Desmodium","Fabaceae","Fabales",1,0,10,326,11,0.0909090909090909
"Desmogymnosiphon","Burmanniaceae","Dioscoreales",0,0,0,1,0,NA
"Desmoncus","Arecaceae","Arecales",7,0,0,11,7,1
"Desmopsis","Annonaceae","Magnoliales",8,0,0,17,8,1
"Desmos","Annonaceae","Magnoliales",1,0,0,27,1,1
"Desmoscelis","Melastomataceae","Myrtales",0,0,0,2,0,NA
"Desmostachya","Poaceae","Poales",0,0,1,1,1,0
"Desmostachys","Icacinaceae","UnknownOrder-Icacinaceae",1,0,0,6,1,1
"Desmotes","Rutaceae","Sapindales",0,0,0,1,0,NA
"Despeleza","Fabaceae","Fabales",0,0,0,4,0,NA
"Desplatsia","Malvaceae","Malvales",1,0,0,5,1,1
"Detarium","Fabaceae","Fabales",2,0,0,4,2,1
"Dethawia","Apiaceae","Apiales",0,0,0,1,0,NA
"Deuterocohnia","Bromeliaceae","Poales",0,0,4,18,4,0
"Deutzia","Hydrangeaceae","Cornales",4,0,0,72,4,1
"Deutzianthus","Euphorbiaceae","Malpighiales",0,0,0,2,0,NA
"Deverra","Apiaceae","Apiales",0,0,1,8,1,0
"Devia","Iridaceae","Asparagales",0,0,0,1,0,NA
"Devillea","Podostemaceae","Malpighiales",0,0,0,1,0,NA
"Devogelia","Orchidaceae","Asparagales",0,0,0,1,0,NA
"Dewevrea","Fabaceae","Fabales",1,0,0,2,1,1
"Dewevrella","Apocynaceae","Gentianales",0,0,0,1,0,NA
"Dewildemania","Asteraceae","Asterales",0,0,0,7,0,NA
"Dewinteria","Pedaliaceae","Lamiales",0,0,0,1,0,NA
"Deyeuxia","Poaceae","Poales",0,0,0,4,0,NA
"Dhofaria","Capparaceae","Brassicales",0,0,0,1,0,NA
"Diabelia","Caprifoliaceae","Dipsacales",0,0,0,3,0,NA
"Diacalpe","Dryopteridaceae","Polypodiales",0,0,0,9,0,NA
"Diacidia","Malpighiaceae","Malpighiales",2,0,0,11,2,1
"Diacranthera","Asteraceae","Asterales",0,0,0,3,0,NA
"Diacrodon","Rubiaceae","Gentianales",0,0,0,1,0,NA
"Dialium","Fabaceae","Fabales",19,0,0,41,19,1
"Dialyceras","Sphaerosepalaceae","Malvales",2,0,0,3,2,1
"Dialypetalanthus","Rubiaceae","Gentianales",1,0,0,1,1,1
"Dialypetalum","Campanulaceae","Asterales",0,0,0,6,0,NA
"Dialytheca","Menispermaceae","Ranunculales",0,0,0,1,0,NA
"Diamantina","Podostemaceae","Malpighiales",0,0,0,1,0,NA
"Diamena","Asparagaceae","Asparagales",0,0,0,1,0,NA
"Diandrolyra","Poaceae","Poales",0,0,0,2,0,NA
"Dianella","Xanthorrhoeaceae","Asparagales",0,0,7,41,7,0
"Dianthera","Acanthaceae","Lamiales",0,0,0,3,0,NA
"Dianthoveus","Cyclanthaceae","Pandanales",0,0,0,1,0,NA
"Dianthus","Caryophyllaceae","Caryophyllales",1,0,14,338,15,0.0666666666666667
"Diapensia","Diapensiaceae","Ericales",1,0,0,4,1,1
"Diaperia","Asteraceae","Asterales",0,0,0,3,0,NA
"Diaphananthe","Orchidaceae","Asparagales",0,0,4,22,4,0
"Diaphanoptera","Caryophyllaceae","Caryophyllales",0,0,0,6,0,NA
"Diaphractanthus","Asteraceae","Asterales",0,0,0,1,0,NA
"Diarrhena","Poaceae","Poales",0,0,1,5,1,0
"Diarthron","Thymelaeaceae","Malvales",0,0,1,15,1,0
"Diascia","Scrophulariaceae","Lamiales",0,0,4,68,4,0
"Diaspananthus","Asteraceae","Asterales",0,0,0,1,0,NA
"Diaspasis","Goodeniaceae","Asterales",0,1,0,1,0,NA
"Diastatea","Campanulaceae","Asterales",0,0,1,6,1,0
"Diastella","Proteaceae","Proteales",3,0,0,7,3,1
"Diastema","Gesneriaceae","Lamiales",0,0,1,21,1,0
"Diatenopteryx","Sapindaceae","Sapindales",1,0,0,2,1,1
"Dibrachionostylus","Rubiaceae","Gentianales",0,0,0,1,0,NA
"Dicarpellum","Celastraceae","Celastrales",3,0,0,4,3,1
"Dicarpidium","Malvaceae","Malvales",0,0,0,1,0,NA
"Dicella","Malpighiaceae","Malpighiales",0,1,0,7,0,NA
"Dicellandra","Melastomataceae","Myrtales",0,0,0,3,0,NA
"Dicellostyles","Malvaceae","Malvales",0,0,0,1,0,NA
"Dicentra","Papaveraceae","Ranunculales",0,0,3,8,3,0
"Dicerandra","Lamiaceae","Lamiales",0,0,0,6,0,NA
"Diceratella","Brassicaceae","Brassicales",0,0,0,10,0,NA
"Diceratostele","Orchidaceae","Asparagales",0,0,1,1,1,0
"Dicercoclados","Asteraceae","Asterales",0,0,0,1,0,NA
"Dicerma","Fabaceae","Fabales",0,0,0,1,0,NA
"Dicerocaryum","Pedaliaceae","Lamiales",0,0,0,4,0,NA
"Dicerothamnus","Asteraceae","Asterales",1,0,0,2,1,1
"Dichaea","Orchidaceae","Asparagales",0,0,7,120,7,0
"Dichaetanthera","Melastomataceae","Myrtales",1,0,0,31,1,1
"Dichaetaria","Poaceae","Poales",0,0,0,1,0,NA
"Dichaetophora","Asteraceae","Asterales",0,0,0,1,0,NA
"Dichanthelium","Poaceae","Poales",0,0,0,1,0,NA
"Dichanthium","Poaceae","Poales",0,0,4,21,4,0
"Dichapetalum","Dichapetalaceae","Malpighiales",25,0,0,150,25,1
"Dichasianthus","Brassicaceae","Brassicales",0,0,0,1,0,NA
"Dichazothece","Acanthaceae","Lamiales",0,0,0,1,0,NA
"Dichelachne","Poaceae","Poales",0,0,5,7,5,0
"Dichelostemma","Asparagaceae","Asparagales",0,0,4,6,4,0
"Dicheranthus","Caryophyllaceae","Caryophyllales",0,0,0,1,0,NA
"Dichilanthe","Rubiaceae","Gentianales",0,0,0,2,0,NA
"Dichilus","Fabaceae","Fabales",1,0,0,5,1,1
"Dichocarpum","Ranunculaceae","Ranunculales",0,0,1,18,1,0
"Dichondra","Convolvulaceae","Solanales",0,0,3,14,3,0
"Dichopogon","Asparagaceae","Asparagales",0,0,3,5,3,0
"Dichorisandra","Commelinaceae","Commelinales",0,0,1,38,1,0
"Dichosciadium","Apiaceae","Apiales",0,0,1,1,1,0
"Dichostemma","Euphorbiaceae","Malpighiales",1,0,0,2,1,1
"Dichotomanthes","Rosaceae","Rosales",0,0,0,1,0,NA
"Dichroa","Hydrangeaceae","Cornales",1,0,0,13,1,1
"Dichrocephala","Asteraceae","Asterales",0,0,0,6,0,NA
"Dichromanthus","Orchidaceae","Asparagales",0,0,0,4,0,NA
"Dichromochlamys","Asteraceae","Asterales",0,0,0,1,0,NA
"Dichrostachys","Fabaceae","Fabales",6,0,0,17,6,1
"Dickasonia","Orchidaceae","Asparagales",0,0,0,1,0,NA
"Dickinsia","Apiaceae","Apiales",0,0,0,1,0,NA
"Dicksonia","Dicksoniaceae","Cyatheales",1,0,0,9,1,1
"Dicladanthera","Acanthaceae","Lamiales",0,0,0,2,0,NA
"Diclidanthera","Polygalaceae","Fabales",0,0,0,6,0,NA
"Diclinanona","Annonaceae","Magnoliales",2,0,0,3,2,1
"Dicliptera","Acanthaceae","Lamiales",0,0,5,223,5,0
"Diclis","Scrophulariaceae","Lamiales",0,0,1,9,1,0
"Dicoelia","Phyllanthaceae","Malpighiales",1,0,0,2,1,1
"Dicoma","Asteraceae","Asterales",0,1,0,37,0,NA
"Dicoria","Asteraceae","Asterales",0,0,0,3,0,NA
"Dicorynia","Fabaceae","Fabales",1,0,0,2,1,1
"Dicoryphe","Hamamelidaceae","Saxifragales",1,0,0,13,1,1
"Dicraeanthus","Podostemaceae","Malpighiales",0,0,0,4,0,NA
"Dicraeopetalum","Fabaceae","Fabales",0,0,0,3,0,NA
"Dicranocarpus","Asteraceae","Asterales",0,0,0,1,0,NA
"Dicranoglossum","Polypodiaceae","Polypodiales",0,0,0,5,0,NA
"Dicranolepis","Thymelaeaceae","Malvales",1,0,0,20,1,1
"Dicranopteris","Gleicheniaceae","Gleicheniales",0,0,1,20,1,0
"Dicranopygium","Cyclanthaceae","Pandanales",0,0,0,54,0,NA
"Dicranostigma","Papaveraceae","Ranunculales",0,0,1,8,1,0
"Dicranostyles","Convolvulaceae","Solanales",0,3,0,15,0,NA
"Dicraspidia","Muntingiaceae","Malvales",0,0,0,1,0,NA
"Dicrastylis","Lamiaceae","Lamiales",1,0,0,34,1,1
"Dicraurus","Amaranthaceae","Caryophyllales",0,0,0,1,0,NA
"Dicrocaulon","Aizoaceae","Caryophyllales",0,0,0,7,0,NA
"Dicrocephala","Asteraceae","Asterales",0,0,0,1,0,NA
"Dictamnus","Rutaceae","Sapindales",0,0,0,1,0,NA
"Dictyandra","Rubiaceae","Gentianales",1,0,0,2,1,1
"Dictyanthus","Apocynaceae","Gentianales",0,0,0,17,0,NA
"Dictyocaryum","Arecaceae","Arecales",3,0,0,3,3,1
"Dictyocline","Thelypteridaceae","Polypodiales",0,0,0,4,0,NA
"Dictyodroma","Athyriaceae","Polypodiales",0,0,0,5,0,NA
"Dictyolimon","Plumbaginaceae","Caryophyllales",0,0,1,2,1,0
"Dictyoloma","Rutaceae","Sapindales",1,0,0,2,1,1
"Dictyoneura","Sapindaceae","Sapindales",0,0,0,2,0,NA
"Dictyophleba","Apocynaceae","Gentianales",1,0,0,6,1,1
"Dictyophragmus","Brassicaceae","Brassicales",0,0,0,3,0,NA
"Dictyopteris","Tectariaceae","Polypodiales",0,0,0,6,0,NA
"Dictyosperma","Arecaceae","Arecales",1,0,0,1,1,1
"Dictyospermum","Commelinaceae","Commelinales",0,0,0,5,0,NA
"Dictyostega","Burmanniaceae","Dioscoreales",0,0,0,1,0,NA
"Dictyoxiphium","Tectariaceae","Polypodiales",0,0,0,1,0,NA
"Dicyclophora","Apiaceae","Apiales",0,0,0,1,0,NA
"Dicymbe","Fabaceae","Fabales",2,0,0,20,2,1
"Dicymbopsis","Fabaceae","Fabales",0,0,0,2,0,NA
"Dicypellium","Lauraceae","Laurales",2,0,0,3,2,1
"Didelotia","Fabaceae","Fabales",4,0,0,12,4,1
"Didelta","Asteraceae","Asterales",2,0,0,2,2,1
"Didesmandra","Dilleniaceae","Dilleniales",0,0,0,1,0,NA
"Didesmus","Brassicaceae","Brassicales",0,0,0,2,0,NA
"Didiclis","Selaginellaceae","Selaginellales",0,0,0,1,0,NA
"Didierea","Didiereaceae","Caryophyllales",1,0,0,2,1,1
"Didiplis","Lythraceae","Myrtales",0,0,0,1,0,NA
"Didissandra","Gesneriaceae","Lamiales",1,0,0,9,1,1
"Didonica","Ericaceae","Ericales",0,0,0,4,0,NA
"Didymaea","Rubiaceae","Gentianales",0,0,1,8,1,0
"Didymanthus","Amaranthaceae","Caryophyllales",0,0,0,1,0,NA
"Didymaotus","Aizoaceae","Caryophyllales",0,0,0,1,0,NA
"Didymeles","Buxaceae","Buxales",2,0,0,3,2,1
"Didymocarpus","Gesneriaceae","Lamiales",0,0,0,87,0,NA
"Didymochlaena","Hypodematiaceae","Polypodiales",0,0,0,2,0,NA
"Didymochlamys","Rubiaceae","Gentianales",0,0,0,2,0,NA
"Didymocistus","Phyllanthaceae","Malpighiales",1,0,0,1,1,1
"Didymodoxa","Urticaceae","Rosales",0,0,1,2,1,0
"Didymoglossum","Hymenophyllaceae","Hymenophyllales",0,0,0,22,0,NA
"Didymophysa","Brassicaceae","Brassicales",0,0,0,2,0,NA
"Didymoplexiella","Orchidaceae","Asparagales",0,0,0,8,0,NA
"Didymoplexiopsis","Orchidaceae","Asparagales",0,0,0,1,0,NA
"Didymoplexis","Orchidaceae","Asparagales",0,0,1,17,1,0
"Didymopogon","Rubiaceae","Gentianales",0,0,0,1,0,NA
"Didymosalpinx","Rubiaceae","Gentianales",1,0,0,4,1,1
"Didymostigma","Gesneriaceae","Lamiales",0,0,0,3,0,NA
"Dieffenbachia","Araceae","Alismatales",0,0,6,68,6,0
"Diegodendron","Bixaceae","Malvales",1,0,0,1,1,1
"Dielitzia","Asteraceae","Asterales",0,0,1,1,1,0
"Diellia","Aspleniaceae","Polypodiales",0,0,4,6,4,0
"Dielsantha","Campanulaceae","Asterales",0,0,0,1,0,NA
"Dielsia","Restionaceae","Poales",0,0,1,1,1,0
"Dielsiocharis","Brassicaceae","Brassicales",0,0,0,2,0,NA
"Dielsiochloa","Poaceae","Poales",0,0,0,1,0,NA
"Dielsiodoxa","Ericaceae","Ericales",0,0,0,3,0,NA
"Dielsiothamnus","Annonaceae","Magnoliales",0,0,0,1,0,NA
"Dienia","Orchidaceae","Asparagales",0,0,1,6,1,0
"Dierama","Iridaceae","Asparagales",0,0,23,44,23,0
"Diervilla","Caprifoliaceae","Dipsacales",3,0,0,4,3,1
"Dieteria","Asteraceae","Asterales",0,0,0,2,0,NA
"Dieterlea","Cucurbitaceae","Cucurbitales",1,0,1,2,2,0.5
"Dietes","Iridaceae","Asparagales",0,0,5,7,5,0
"Digera","Amaranthaceae","Caryophyllales",0,0,0,1,0,NA
"Digitacalia","Asteraceae","Asterales",0,0,0,5,0,NA
"Digitalis","Plantaginaceae","Lamiales",0,0,2,25,2,0
"Digitaria","Poaceae","Poales",1,0,17,260,18,0.0555555555555556
"Diglyphosa","Orchidaceae","Asparagales",0,0,0,3,0,NA
"Dignathe","Orchidaceae","Asparagales",0,0,0,1,0,NA
"Dignathia","Poaceae","Poales",0,0,0,5,0,NA
"Digomphia","Bignoniaceae","Lamiales",1,0,0,3,1,1
"Digoniopterys","Malpighiaceae","Malpighiales",0,0,0,1,0,NA
"Diheteropogon","Poaceae","Poales",0,0,0,4,0,NA
"Diholcos","Fabaceae","Fabales",0,0,0,3,0,NA
"Dilatris","Haemodoraceae","Commelinales",0,0,3,4,3,0
"Dilkea","Passifloraceae","Malpighiales",0,0,0,11,0,NA
"Dillandia","Asteraceae","Asterales",0,0,0,2,0,NA
"Dillenia","Dilleniaceae","Dilleniales",25,0,0,58,25,1
"Dillwynia","Fabaceae","Fabales",6,0,0,22,6,1
"Dilobeia","Proteaceae","Proteales",2,0,0,2,2,1
"Dilochia","Orchidaceae","Asparagales",0,0,0,8,0,NA
"Dilochiopsis","Orchidaceae","Asparagales",0,0,0,1,0,NA
"Dilodendron","Sapindaceae","Sapindales",2,0,0,3,2,1
"Dilomilis","Orchidaceae","Asparagales",0,0,1,5,1,0
"Dilophia","Brassicaceae","Brassicales",0,0,1,2,1,0
"Dilophotriche","Poaceae","Poales",0,0,0,3,0,NA
"Dimerandra","Orchidaceae","Asparagales",0,0,1,8,1,0
"Dimeresia","Asteraceae","Asterales",0,0,1,1,1,0
"Dimeria","Poaceae","Poales",0,0,4,59,4,0
"Dimerocostus","Costaceae","Zingiberales",2,0,0,3,2,1
"Dimerostemma","Asteraceae","Asterales",0,2,1,21,1,0
"Dimetra","Oleaceae","Lamiales",0,0,0,1,0,NA
"Dimocarpus","Sapindaceae","Sapindales",3,0,0,8,3,1
"Dimorphandra","Fabaceae","Fabales",6,0,0,26,6,1
"Dimorphanthera","Ericaceae","Ericales",4,0,0,77,4,1
"Dimorphocalyx","Euphorbiaceae","Malpighiales",2,0,0,17,2,1
"Dimorphocarpa","Brassicaceae","Brassicales",0,0,0,4,0,NA
"Dimorphocoma","Asteraceae","Asterales",0,0,0,1,0,NA
"Dimorphorchis","Orchidaceae","Asparagales",0,0,1,5,1,0
"Dimorphosciadium","Apiaceae","Apiales",0,0,0,2,0,NA
"Dimorphotheca","Asteraceae","Asterales",0,0,2,19,2,0
"Dinebra","Poaceae","Poales",0,0,1,3,1,0
"Dinema","Orchidaceae","Asparagales",0,0,1,1,1,0
"Dinemagonum","Malpighiaceae","Malpighiales",1,0,0,1,1,1
"Dinemandra","Malpighiaceae","Malpighiales",1,0,0,1,1,1
"Dinetus","Convolvulaceae","Solanales",0,0,1,6,1,0
"Dinizia","Fabaceae","Fabales",1,0,0,1,1,1
"Dinklageella","Orchidaceae","Asparagales",0,0,0,4,0,NA
"Dinklageodoxa","Bignoniaceae","Lamiales",0,0,0,1,0,NA
"Dinochloa","Poaceae","Poales",0,0,0,36,0,NA
"Dinophora","Melastomataceae","Myrtales",0,0,0,1,0,NA
"Dinoseris","Asteraceae","Asterales",0,0,0,1,0,NA
"Dinosperma","Rutaceae","Sapindales",1,0,0,4,1,1
"Dintera","Plantaginaceae","Lamiales",0,0,0,1,0,NA
"Dinteranthus","Aizoaceae","Caryophyllales",0,0,0,5,0,NA
"Dioclea","Fabaceae","Fabales",6,0,0,59,6,1
"Diodella","Rubiaceae","Gentianales",0,0,1,12,1,0
"Diodia","Rubiaceae","Gentianales",0,0,0,22,0,NA
"Diodonopsis","Orchidaceae","Asparagales",0,0,0,5,0,NA
"Diodontium","Asteraceae","Asterales",0,0,0,1,0,NA
"Dioecrescis","Rubiaceae","Gentianales",1,0,0,1,1,1
"Diogenesia","Ericaceae","Ericales",1,0,0,13,1,1
"Diogoa","Olacaceae","Santalales",1,0,0,2,1,1
"Dioicodendron","Rubiaceae","Gentianales",0,0,0,1,0,NA
"Diolena","Melastomataceae","Myrtales",0,0,0,2,0,NA
"Dionaea","Droseraceae","Caryophyllales",0,0,1,1,1,0
"Dioncophyllum","Dioncophyllaceae","Caryophyllales",1,0,0,1,1,1
"Dionycha","Melastomataceae","Myrtales",0,0,0,3,0,NA
"Dionysia","Primulaceae","Ericales",0,0,10,54,10,0
"Dioon","Zamiaceae","Cycadales",11,0,0,13,11,1
"Diora","Asparagaceae","Asparagales",0,0,0,1,0,NA
"Dioscorea","Dioscoreaceae","Dioscoreales",0,0,117,613,117,0
"Dioscoreophyllum","Menispermaceae","Ranunculales",0,1,0,3,0,NA
"Diosma","Rutaceae","Sapindales",1,0,0,28,1,1
"Diospyros","Ebenaceae","Ericales",226,0,0,725,226,1
"Dipcadi","Asparagaceae","Asparagales",0,0,6,42,6,0
"Dipelta","Caprifoliaceae","Dipsacales",2,0,0,4,2,1
"Dipentodon","Dipentodontaceae","Huerteales",0,0,0,1,0,NA
"Diphaca","Fabaceae","Fabales",0,0,0,5,0,NA
"Diphalangium","Amaryllidaceae","Asparagales",0,0,0,1,0,NA
"Diphasiastrum","Lycopodiaceae","Lycopodiales",0,0,20,21,20,0
"Diphasium","Lycopodiaceae","Lycopodiales",0,0,1,1,1,0
"Diphyllarium","Fabaceae","Fabales",0,0,0,1,0,NA
"Diphylleia","Berberidaceae","Ranunculales",0,0,1,3,1,0
"Diphysa","Fabaceae","Fabales",3,0,0,21,3,1
"Diplacrum","Cyperaceae","Poales",0,0,3,9,3,0
"Diplactis","Asteraceae","Asterales",0,0,0,1,0,NA
"Diplarche","Ericaceae","Ericales",1,0,0,2,1,1
"Diplarpea","Melastomataceae","Myrtales",0,0,0,1,0,NA
"Diplarrena","Iridaceae","Asparagales",0,0,2,2,2,0
"Diplasia","Cyperaceae","Poales",0,0,0,1,0,NA
"Diplaspis","Apiaceae","Apiales",0,0,0,2,0,NA
"Diplatia","Loranthaceae","Santalales",1,0,0,4,1,1
"Diplaziopsis","Diplaziopsidaceae","Polypodiales",0,0,0,6,0,NA
"Diplazium","Athyriaceae","Polypodiales",0,0,7,211,7,0
"Diplazoptilon","Asteraceae","Asterales",0,0,0,2,0,NA
"Diplectria","Melastomataceae","Myrtales",0,0,0,1,0,NA
"Diploblechnum","Blechnaceae","Polypodiales",1,0,0,2,1,1
"Diplobryum","Podostemaceae","Malpighiales",0,0,0,4,0,NA
"Diplocentrum","Orchidaceae","Asparagales",0,0,0,2,0,NA
"Diplochita","Melastomataceae","Myrtales",0,0,0,1,0,NA
"Diploclisia","Menispermaceae","Ranunculales",0,0,0,2,0,NA
"Diplocyclos","Cucurbitaceae","Cucurbitales",0,0,1,5,1,0
"Diplodiscus","Malvaceae","Malvales",1,0,0,12,1,1
"Diploglottis","Sapindaceae","Sapindales",4,0,0,10,4,1
"Diplokeleba","Sapindaceae","Sapindales",1,0,0,2,1,1
"Diploknema","Sapotaceae","Ericales",2,0,0,7,2,1
"Diplolaena","Rutaceae","Sapindales",1,0,0,15,1,1
"Diplolepis","Apocynaceae","Gentianales",0,0,0,6,0,NA
"Diplolophium","Apiaceae","Apiales",0,0,0,7,0,NA
"Diplomeris","Orchidaceae","Asparagales",0,0,0,3,0,NA
"Diplomorpha","Thymelaeaceae","Malvales",0,0,0,1,0,NA
"Diploon","Sapotaceae","Ericales",1,0,0,1,1,1
"Diplopanax","Cornaceae","Cornales",1,0,0,2,1,1
"Diplopeltis","Sapindaceae","Sapindales",2,0,0,5,2,1
"Diplopogon","Poaceae","Poales",0,0,0,1,0,NA
"Diploprora","Orchidaceae","Asparagales",0,0,1,2,1,0
"Diplopterygium","Gleicheniaceae","Gleicheniales",0,0,1,23,1,0
"Diplopterys","Malpighiaceae","Malpighiales",4,1,0,31,4,1
"Diplorhynchus","Apocynaceae","Gentianales",1,0,0,1,1,1
"Diplosoma","Aizoaceae","Caryophyllales",0,0,0,1,0,NA
"Diplospora","Rubiaceae","Gentianales",1,0,0,23,1,1
"Diplostachyum","Selaginellaceae","Selaginellales",0,0,0,2,0,NA
"Diplostephium","Asteraceae","Asterales",1,0,0,111,1,1
"Diplostigma","Apocynaceae","Gentianales",0,0,0,1,0,NA
"Diplotaenia","Apiaceae","Apiales",0,0,0,2,0,NA
"Diplotaxis","Brassicaceae","Brassicales",0,0,4,35,4,0
"Diplotropis","Fabaceae","Fabales",3,0,0,12,3,1
"Diplusodon","Lythraceae","Myrtales",0,0,0,92,0,NA
"Diplycosia","Ericaceae","Ericales",2,0,0,111,2,1
"Dipodium","Orchidaceae","Asparagales",0,0,1,24,1,0
"Dipogon","Fabaceae","Fabales",0,0,1,1,1,0
"Dipoma","Brassicaceae","Brassicales",0,0,0,1,0,NA
"Diposis","Apiaceae","Apiales",0,0,1,3,1,0
"Dipsacus","Caprifoliaceae","Dipsacales",0,0,4,28,4,0
"Dipteracanthus","Acanthaceae","Lamiales",0,0,0,1,0,NA
"Dipteris","Dipteridaceae","Gleicheniales",0,0,0,5,0,NA
"Dipterocarpus","Dipterocarpaceae","Malvales",48,0,0,66,48,1
"Dipterocome","Asteraceae","Asterales",0,0,0,1,0,NA
"Dipterocypsela","Asteraceae","Asterales",0,0,0,1,0,NA
"Dipteronia","Sapindaceae","Sapindales",2,0,0,2,2,1
"Dipteropeltis","Convolvulaceae","Solanales",0,1,0,1,0,NA
"Dipterygia","Apiaceae","Apiales",0,0,0,1,0,NA
"Dipterygium","Capparaceae","Brassicales",0,0,0,1,0,NA
"Dipteryx","Fabaceae","Fabales",6,0,0,9,6,1
"Diptychandra","Fabaceae","Fabales",0,0,0,2,0,NA
"Diptychocarpus","Brassicaceae","Brassicales",0,0,1,1,1,0
"Dipyrena","Verbenaceae","Lamiales",1,0,0,4,1,1
"Dirachma","Dirachmaceae","Rosales",1,0,0,2,1,1
"Dirca","Thymelaeaceae","Malvales",2,0,0,4,2,1
"Dirhamphis","Malvaceae","Malvales",0,0,0,2,0,NA
"Dirichletia","Rubiaceae","Gentianales",3,0,0,5,3,1
"Disa","Orchidaceae","Asparagales",0,0,120,185,120,0
"Disanthus","Hamamelidaceae","Saxifragales",1,0,0,1,1,1
"Discaria","Rhamnaceae","Rosales",5,0,0,7,5,1
"Dischidanthus","Apocynaceae","Gentianales",0,0,0,1,0,NA
"Dischidia","Apocynaceae","Gentianales",0,0,0,116,0,NA
"Dischidiopsis","Apocynaceae","Gentianales",0,0,0,8,0,NA
"Dischisma","Scrophulariaceae","Lamiales",0,0,1,11,1,0
"Dischistocalyx","Acanthaceae","Lamiales",0,0,0,13,0,NA
"Disciphania","Menispermaceae","Ranunculales",1,0,1,26,2,0.5
"Discladium","Ochnaceae","Malpighiales",0,0,0,1,0,NA
"Discocactus","Cactaceae","Caryophyllales",0,0,0,7,0,NA
"Discocalyx","Primulaceae","Ericales",1,0,0,56,1,1
"Discocapnos","Papaveraceae","Ranunculales",0,0,0,1,0,NA
"Discocarpus","Phyllanthaceae","Malpighiales",1,0,0,4,1,1
"Discoclaoxylon","Euphorbiaceae","Malpighiales",1,0,0,4,1,1
"Discocleidion","Euphorbiaceae","Malpighiales",1,0,0,1,1,1
"Discocnide","Urticaceae","Rosales",0,0,0,1,0,NA
"Discoglypremna","Euphorbiaceae","Malpighiales",1,0,0,1,1,1
"Discolobium","Fabaceae","Fabales",0,0,0,8,0,NA
"Discophora","Stemonuraceae","Aquifoliales",1,0,0,2,1,1
"Discopleura","Apiaceae","Apiales",0,0,0,2,0,NA
"Discopodium","Solanaceae","Solanales",0,0,0,1,0,NA
"Discospermum","Rubiaceae","Gentianales",2,0,0,7,2,1
"Discostegia","Marattiaceae","Marattiales",0,0,1,1,1,0
"Discretitheca","Lamiaceae","Lamiales",0,0,0,1,0,NA
"Discyphus","Orchidaceae","Asparagales",0,0,0,1,0,NA
"Diselma","Cupressaceae","Cupressales",0,0,0,1,0,NA
"Disemma","Passifloraceae","Malpighiales",0,0,0,3,0,NA
"Disepalum","Annonaceae","Magnoliales",3,0,0,9,3,1
"Disocactus","Cactaceae","Caryophyllales",0,0,0,15,0,NA
"Disparago","Asteraceae","Asterales",1,0,0,4,1,1
"Disperis","Orchidaceae","Asparagales",0,0,5,79,5,0
"Disphyma","Aizoaceae","Caryophyllales",0,0,1,5,1,0
"Disporopsis","Asparagaceae","Asparagales",0,0,3,7,3,0
"Disporum","Colchicaceae","Liliales",0,0,3,21,3,0
"Dissanthelium","Poaceae","Poales",0,0,0,15,0,NA
"Dissiliaria","Picrodendraceae","Malpighiales",3,0,0,6,3,1
"Dissocarpus","Amaranthaceae","Caryophyllales",1,0,1,4,2,0.5
"Dissochaeta","Melastomataceae","Myrtales",0,0,0,2,0,NA
"Dissochondrus","Poaceae","Poales",0,0,0,1,0,NA
"Dissomeria","Salicaceae","Malpighiales",0,0,0,2,0,NA
"Dissothrix","Asteraceae","Asterales",0,0,0,1,0,NA
"Dissotis","Melastomataceae","Myrtales",1,0,0,21,1,1
"Distaxia","Blechnaceae","Polypodiales",0,0,0,1,0,NA
"Disteganthus","Bromeliaceae","Poales",0,0,0,3,0,NA
"Distegia","Asteraceae","Asterales",0,0,0,1,0,NA
"Distemma","Passifloraceae","Malpighiales",0,0,0,1,0,NA
"Distemonanthus","Fabaceae","Fabales",1,0,0,1,1,1
"Distephanus","Asteraceae","Asterales",0,0,0,32,0,NA
"Disterigma","Ericaceae","Ericales",4,0,0,39,4,1
"Distichia","Juncaceae","Poales",0,0,2,3,2,0
"Distichirhops","Phyllanthaceae","Malpighiales",0,0,0,3,0,NA
"Distichlis","Poaceae","Poales",0,0,1,7,1,0
"Distichochlamys","Zingiberaceae","Zingiberales",0,0,0,3,0,NA
"Distichoselinum","Apiaceae","Apiales",0,0,0,1,0,NA
"Distichostemon","Sapindaceae","Sapindales",1,0,0,6,1,1
"Distictella","Bignoniaceae","Lamiales",0,0,0,2,0,NA
"Distrianthes","Loranthaceae","Santalales",0,0,0,3,0,NA
"Distyliopsis","Hamamelidaceae","Saxifragales",2,0,0,6,2,1
"Distylium","Hamamelidaceae","Saxifragales",3,0,0,15,3,1
"Distylodon","Orchidaceae","Asparagales",0,0,0,1,0,NA
"Disynaphia","Asteraceae","Asterales",0,0,0,16,0,NA
"Disynstemon","Fabaceae","Fabales",0,0,0,1,0,NA
"Ditassa","Apocynaceae","Gentianales",0,0,0,118,0,NA
"Ditaxis","Euphorbiaceae","Malpighiales",0,0,0,50,0,NA
"Ditepalanthus","Balanophoraceae","Santalales",0,0,0,2,0,NA
"Dithyrea","Brassicaceae","Brassicales",0,0,0,2,0,NA
"Dithyrostegia","Asteraceae","Asterales",0,0,1,2,1,0
"Ditrysinia","Euphorbiaceae","Malpighiales",1,0,0,1,1,1
"Ditta","Euphorbiaceae","Malpighiales",1,0,0,2,1,1
"Dittoceras","Apocynaceae","Gentianales",0,0,0,4,0,NA
"Dittrichia","Asteraceae","Asterales",1,0,0,2,1,1
"Diuranthera","Asparagaceae","Asparagales",0,0,1,4,1,0
"Diuris","Orchidaceae","Asparagales",0,0,2,75,2,0
"Diyaminauclea","Rubiaceae","Gentianales",0,0,0,1,0,NA
"Dizygostemon","Plantaginaceae","Lamiales",0,0,0,2,0,NA
"Dizygotheca","Araliaceae","Apiales",0,0,0,2,0,NA
"Djaloniella","Gentianaceae","Gentianales",0,0,0,1,0,NA
"Djinga","Podostemaceae","Malpighiales",0,0,0,1,0,NA
"Dobera","Salvadoraceae","Brassicales",1,0,0,2,1,1
"Dobinea","Anacardiaceae","Sapindales",0,0,0,2,0,NA
"Docynia","Rosaceae","Rosales",1,0,0,2,1,1
"Dodartia","Phrymaceae","Lamiales",0,0,0,1,0,NA
"Dodecadenia","Lauraceae","Laurales",1,0,0,1,1,1
"Dodecahema","Polygonaceae","Caryophyllales",0,0,0,1,0,NA
"Dodecastigma","Euphorbiaceae","Malpighiales",2,0,0,3,2,1
"Dodecatheon","Primulaceae","Ericales",0,0,12,15,12,0
"Dodonaea","Sapindaceae","Sapindales",46,0,0,67,46,1
"Doellia","Asteraceae","Asterales",0,0,0,1,0,NA
"Doellingeria","Asteraceae","Asterales",0,0,1,11,1,0
"Doerpfeldia","Rhamnaceae","Rosales",1,0,0,1,1,1
"Dolianthus","Rubiaceae","Gentianales",0,0,0,13,0,NA
"Dolichandra","Bignoniaceae","Lamiales",1,0,0,8,1,1
"Dolichandrone","Bignoniaceae","Lamiales",3,0,0,10,3,1
"Dolichlasium","Asteraceae","Asterales",0,0,0,1,0,NA
"Dolichodelphys","Rubiaceae","Gentianales",0,0,0,1,0,NA
"Dolichoglottis","Asteraceae","Asterales",0,0,0,2,0,NA
"Dolicholobium","Rubiaceae","Gentianales",1,0,0,28,1,1
"Dolicholoma","Gesneriaceae","Lamiales",0,0,0,1,0,NA
"Dolicholus","Fabaceae","Fabales",0,0,0,3,0,NA
"Dolichometra","Rubiaceae","Gentianales",0,0,0,1,0,NA
"Dolichopentas","Rubiaceae","Gentianales",0,0,0,4,0,NA
"Dolichopetalum","Apocynaceae","Gentianales",0,0,0,1,0,NA
"Dolichopsis","Fabaceae","Fabales",0,0,2,3,2,0
"Dolichorrhiza","Asteraceae","Asterales",0,0,0,4,0,NA
"Dolichos","Fabaceae","Fabales",0,0,2,69,2,0
"Dolichostachys","Acanthaceae","Lamiales",0,0,0,1,0,NA
"Dolichostemon","Scrophulariaceae","Lamiales",0,0,0,1,0,NA
"Dolichothrix","Asteraceae","Asterales",1,0,0,1,1,1
"Dolichoura","Melastomataceae","Myrtales",0,0,0,1,0,NA
"Doliocarpus","Dilleniaceae","Dilleniales",5,0,0,54,5,1
"Dolomiaea","Asteraceae","Asterales",0,0,0,15,0,NA
"Dombeya","Malvaceae","Malvales",4,0,0,221,4,1
"Domeykoa","Apiaceae","Apiales",0,0,0,4,0,NA
"Domingoa","Orchidaceae","Asparagales",0,0,2,5,2,0
"Donatia","Stylidiaceae","Asterales",0,0,2,2,2,0
"Donax","Marantaceae","Zingiberales",0,0,1,1,1,0
"Donella","Sapotaceae","Ericales",1,0,0,1,1,1
"Doniophyton","Asteraceae","Asterales",1,0,0,2,1,1
"Donnellsmithia","Apiaceae","Apiales",0,0,1,19,1,0
"Donnellyanthus","Rubiaceae","Gentianales",0,0,0,1,0,NA
"Dontostemon","Brassicaceae","Brassicales",0,0,1,13,1,0
"Doodia","Blechnaceae","Polypodiales",0,0,1,4,1,0
"Dopatrium","Plantaginaceae","Lamiales",0,0,0,14,0,NA
"Doratoxylon","Sapindaceae","Sapindales",1,0,0,5,1,1
"Dorema","Apiaceae","Apiales",0,0,0,12,0,NA
"Dorobaea","Asteraceae","Asterales",0,0,0,3,0,NA
"Doronicum","Asteraceae","Asterales",0,0,5,39,5,0
"Dorotheanthus","Aizoaceae","Caryophyllales",0,0,0,8,0,NA
"Dorstenia","Moraceae","Rosales",0,1,1,117,1,0
"Doryanthes","Doryanthaceae","Asparagales",0,0,2,2,2,0
"Dorycnium","Fabaceae","Fabales",2,0,1,12,3,0.666666666666667
"Dorycnopsis","Fabaceae","Fabales",0,0,0,2,0,NA
"Doryopteris","Pteridaceae","Polypodiales",0,0,0,34,0,NA
"Doryphora","Atherospermataceae","Laurales",2,0,0,2,2,1
"Dorystaechas","Lamiaceae","Lamiales",0,0,0,1,0,NA
"Doryxylon","Euphorbiaceae","Malpighiales",0,0,0,1,0,NA
"Dossinia","Orchidaceae","Asparagales",0,0,0,1,0,NA
"Douepea","Brassicaceae","Brassicales",0,0,0,2,0,NA
"Douradoa","Olacaceae","Santalales",1,0,0,1,1,1
"Dovyalis","Salicaceae","Malpighiales",7,0,0,17,7,1
"Downingia","Campanulaceae","Asterales",0,0,13,13,13,0
"Doyerea","Cucurbitaceae","Cucurbitales",0,0,0,1,0,NA
"Doyleanthus","Myristicaceae","Magnoliales",0,0,0,1,0,NA
"Draba","Brassicaceae","Brassicales",0,0,17,440,17,0
"Drabastrum","Brassicaceae","Brassicales",0,0,0,1,0,NA
"Dracaena","Asparagaceae","Asparagales",14,0,0,113,14,1
"Dracocephalum","Lamiaceae","Lamiales",0,0,8,74,8,0
"Dracoglossum","Dryopteridaceae","Polypodiales",0,0,0,2,0,NA
"Dracomonticola","Orchidaceae","Asparagales",0,0,0,1,0,NA
"Draconanthes","Orchidaceae","Asparagales",0,0,0,2,0,NA
"Dracontioides","Araceae","Alismatales",0,0,0,2,0,NA
"Dracontium","Araceae","Alismatales",0,0,0,24,0,NA
"Dracontomelon","Anacardiaceae","Sapindales",4,0,0,9,4,1
"Dracophilus","Aizoaceae","Caryophyllales",0,0,0,4,0,NA
"Dracophyllum","Ericaceae","Ericales",13,0,0,61,13,1
"Dracosciadium","Apiaceae","Apiales",0,0,0,2,0,NA
"Dracula","Orchidaceae","Asparagales",0,0,1,130,1,0
"Dracunculus","Araceae","Alismatales",0,0,2,2,2,0
"Drakaea","Orchidaceae","Asparagales",0,0,0,10,0,NA
"Drake-brockmania","Poaceae","Poales",0,0,0,2,0,NA
"Dransfieldia","Arecaceae","Arecales",1,0,0,1,1,1
"Draperia","Boraginaceae","UnknownOrder-Boraginaceae",0,1,0,1,0,NA
"Drapetes","Thymelaeaceae","Malvales",0,0,0,1,0,NA
"Dregea","Apocynaceae","Gentianales",0,0,0,12,0,NA
"Dregeochloa","Poaceae","Poales",0,0,0,2,0,NA
"Drepananthus","Annonaceae","Magnoliales",0,0,0,11,0,NA
"Drepanocarpus","Fabaceae","Fabales",0,0,0,1,0,NA
"Drepanocaryum","Lamiaceae","Lamiales",0,0,0,1,0,NA
"Drepanostachyum","Poaceae","Poales",1,0,0,13,1,1
"Dresslerella","Orchidaceae","Asparagales",0,0,1,16,1,0
"Dressleria","Orchidaceae","Asparagales",0,0,2,11,2,0
"Dresslerothamnus","Asteraceae","Asterales",0,0,0,3,0,NA
"Drimia","Asparagaceae","Asparagales",0,0,12,99,12,0
"Drimiopsis","Asparagaceae","Asparagales",0,0,0,14,0,NA
"Drimycarpus","Anacardiaceae","Sapindales",1,0,0,4,1,1
"Drimys","Winteraceae","Canellales",4,0,0,7,4,1
"Droceloncia","Euphorbiaceae","Malpighiales",1,0,0,1,1,1
"Droguetia","Urticaceae","Rosales",0,0,1,7,1,0
"Droogmansia","Fabaceae","Fabales",0,0,0,24,0,NA
"Drosanthemum","Aizoaceae","Caryophyllales",0,0,0,112,0,NA
"Drosera","Droseraceae","Caryophyllales",0,0,57,187,57,0
"Drosophyllum","Drosophyllaceae","Caryophyllales",0,0,1,1,1,0
"Drummondita","Rutaceae","Sapindales",0,0,0,9,0,NA
"Drusa","Apiaceae","Apiales",0,0,1,1,1,0
"Dryadella","Orchidaceae","Asparagales",0,0,2,54,2,0
"Dryadodaphne","Atherospermataceae","Laurales",2,0,0,3,2,1
"Dryadorchis","Orchidaceae","Asparagales",0,0,0,5,0,NA
"Dryandra","Proteaceae","Proteales",78,0,0,94,78,1
"Dryas","Rosaceae","Rosales",2,1,0,10,2,1
"Drymaria","Caryophyllaceae","Caryophyllales",0,0,0,55,0,NA
"Drymoanthus","Orchidaceae","Asparagales",0,0,1,4,1,0
"Drymocallis","Rosaceae","Rosales",0,0,0,8,0,NA
"Drymoda","Orchidaceae","Asparagales",0,0,0,3,0,NA
"Drymoglossum","Polypodiaceae","Polypodiales",0,0,0,1,0,NA
"Drymonia","Gesneriaceae","Lamiales",1,0,3,75,4,0.25
"Drymophila","Alstroemeriaceae","Liliales",0,0,2,2,2,0
"Drymophloeus","Arecaceae","Arecales",1,0,0,7,1,1
"Drymotaenium","Polypodiaceae","Polypodiales",0,0,0,1,0,NA
"Drynaria","Polypodiaceae","Polypodiales",0,0,3,15,3,0
"Dryoathyrium","Athyriaceae","Polypodiales",0,0,0,9,0,NA
"Dryobalanops","Dipterocarpaceae","Malvales",7,0,0,7,7,1
"Dryomenis","Tectariaceae","Polypodiales",0,0,0,1,0,NA
"Dryopetalon","Brassicaceae","Brassicales",0,0,0,8,0,NA
"Dryopoa","Poaceae","Poales",0,0,0,1,0,NA
"Dryopolystichum","Dryopteridaceae","Polypodiales",0,0,0,1,0,NA
"Dryopsis","Dryopteridaceae","Polypodiales",0,0,0,21,0,NA
"Dryopteris","Dryopteridaceae","Polypodiales",0,0,17,302,17,0
"Drypetes","Putranjivaceae","Malpighiales",49,0,0,209,49,1
"Drypis","Caryophyllaceae","Caryophyllales",0,0,0,1,0,NA
"Duabanga","Lythraceae","Myrtales",2,0,0,2,2,1
"Dubautia","Asteraceae","Asterales",2,0,0,32,2,1
"Duboisia","Solanaceae","Solanales",2,0,0,4,2,1
"Duboscia","Malvaceae","Malvales",0,0,0,2,0,NA
"Dubouzetia","Elaeocarpaceae","Oxalidales",6,0,0,11,6,1
"Dubyaea","Asteraceae","Asterales",0,0,0,18,0,NA
"Duchesnea","Rosaceae","Rosales",0,0,0,2,0,NA
"Duckea","Rapateaceae","Poales",0,0,0,4,0,NA
"Duckeanthus","Annonaceae","Magnoliales",0,0,0,1,0,NA
"Duckeella","Orchidaceae","Asparagales",0,0,1,3,1,0
"Duckeodendron","Solanaceae","Solanales",1,0,0,1,1,1
"Duckesia","Humiriaceae","Malpighiales",1,0,0,1,1,1
"Ducrosia","Apiaceae","Apiales",0,0,0,6,0,NA
"Dudleveria","Crassulaceae","Saxifragales",0,0,0,1,0,NA
"Dudleya","Crassulaceae","Saxifragales",0,0,1,46,1,0
"Dugaldia","Asteraceae","Asterales",0,0,0,2,0,NA
"Dugandiodendron","Magnoliaceae","Magnoliales",0,0,0,1,0,NA
"Dugesia","Asteraceae","Asterales",0,0,1,1,1,0
"Duguetia","Annonaceae","Magnoliales",37,0,0,94,37,1
"Duhaldea","Asteraceae","Asterales",0,0,0,10,0,NA
"Duidaea","Asteraceae","Asterales",0,0,0,4,0,NA
"Duidania","Rubiaceae","Gentianales",0,0,0,1,0,NA
"Dulacia","Olacaceae","Santalales",2,0,0,13,2,1
"Dulichium","Cyperaceae","Poales",0,0,1,1,1,0
"Duma","Polygonaceae","Caryophyllales",0,0,0,3,0,NA
"Dumaniana","Apiaceae","Apiales",0,0,0,4,0,NA
"Dumasia","Fabaceae","Fabales",0,0,1,11,1,0
"Dunalia","Solanaceae","Solanales",1,0,0,8,1,1
"Dunbaria","Fabaceae","Fabales",0,0,0,25,0,NA
"Dunnia","Rubiaceae","Gentianales",0,0,0,1,0,NA
"Dunstervillea","Orchidaceae","Asparagales",0,0,0,1,0,NA
"Duosperma","Acanthaceae","Lamiales",1,0,0,26,1,1
"Duparquetia","Fabaceae","Fabales",0,0,0,1,0,NA
"Duperrea","Rubiaceae","Gentianales",1,0,0,1,1,1
"Duplipetala","Gentianaceae","Gentianales",0,0,0,2,0,NA
"Dupoa","Poaceae","Poales",0,0,0,1,0,NA
"Dupontia","Poaceae","Poales",0,0,0,1,0,NA
"Dupontopoa","Poaceae","Poales",0,0,0,1,0,NA
"Dupuya","Fabaceae","Fabales",0,0,0,2,0,NA
"Durandea","Linaceae","Malpighiales",0,0,0,8,0,NA
"Duranta","Verbenaceae","Lamiales",2,0,0,29,2,1
"Durio","Malvaceae","Malvales",17,0,0,32,17,1
"Duroia","Rubiaceae","Gentianales",6,0,0,38,6,1
"Durringtonia","Rubiaceae","Gentianales",0,0,0,1,0,NA
"Duseniella","Asteraceae","Asterales",0,0,0,1,0,NA
"Dussia","Fabaceae","Fabales",6,0,0,11,6,1
"Dutailliopsis","Rutaceae","Sapindales",0,0,0,1,0,NA
"Dutaillyea","Rutaceae","Sapindales",0,0,0,3,0,NA
"Duthiastrum","Iridaceae","Asparagales",0,0,1,1,1,0
"Duthiea","Poaceae","Poales",0,0,0,3,0,NA
"Duvalia","Apocynaceae","Gentianales",0,0,0,19,0,NA
"Duvaliandra","Apocynaceae","Gentianales",0,0,0,1,0,NA
"Dyakia","Orchidaceae","Asparagales",0,0,1,1,1,0
"Dyckia","Bromeliaceae","Poales",0,0,4,149,4,0
"Dyera","Apocynaceae","Gentianales",2,0,0,2,2,1
"Dyerophytum","Plumbaginaceae","Caryophyllales",1,0,0,3,1,1
"Dymondia","Asteraceae","Asterales",0,0,1,1,1,0
"Dypsis","Arecaceae","Arecales",5,0,0,162,5,1
"Dyschoriste","Acanthaceae","Lamiales",0,0,0,102,0,NA
"Dyscritogyne","Asteraceae","Asterales",0,0,0,2,0,NA
"Dyscritothamnus","Asteraceae","Asterales",1,0,0,2,1,1
"Dysodiopsis","Asteraceae","Asterales",0,0,0,1,0,NA
"Dysolobium","Fabaceae","Fabales",0,0,0,6,0,NA
"Dysopsis","Euphorbiaceae","Malpighiales",0,0,1,3,1,0
"Dysosma","Berberidaceae","Ranunculales",0,0,2,13,2,0
"Dysoxylum","Meliaceae","Sapindales",46,0,0,97,46,1
"Dysphania","Amaranthaceae","Caryophyllales",0,0,7,36,7,0
"Dyssochroma","Solanaceae","Solanales",0,0,0,1,0,NA
"Dyssodia","Asteraceae","Asterales",0,0,1,8,1,0
"Dystaenia","Apiaceae","Apiales",0,0,0,2,0,NA
"Dystovomita","Clusiaceae","Malpighiales",1,0,0,3,1,1
"Earina","Orchidaceae","Asparagales",0,0,2,7,2,0
"Eastwoodia","Asteraceae","Asterales",1,0,0,1,1,1
"Eatonella","Asteraceae","Asterales",0,0,1,1,1,0
"Ebenidium","Fabaceae","Fabales",0,0,0,12,0,NA
"Ebenopsis","Fabaceae","Fabales",1,0,0,3,1,1
"Ebenus","Fabaceae","Fabales",1,0,0,6,1,1
"Eberhardtia","Sapotaceae","Ericales",0,0,0,3,0,NA
"Eberlanzia","Aizoaceae","Caryophyllales",0,0,0,32,0,NA
"Ebracteola","Aizoaceae","Caryophyllales",0,0,0,4,0,NA
"Ebulum","Caprifoliaceae","Dipsacales",0,0,0,1,0,NA
"Ecastaphyllum","Fabaceae","Fabales",0,0,0,1,0,NA
"Ecballium","Cucurbitaceae","Cucurbitales",0,0,1,1,1,0
"Ecbolium","Acanthaceae","Lamiales",0,0,0,21,0,NA
"Ecclinusa","Sapotaceae","Ericales",11,0,0,11,11,1
"Eccoptocarpha","Poaceae","Poales",0,0,0,1,0,NA
"Eccremis","Xanthorrhoeaceae","Asparagales",0,0,0,1,0,NA
"Eccremocarpus","Bignoniaceae","Lamiales",1,0,0,3,1,1
"Ecdeiocolea","Ecdeiocoleaceae","Poales",0,0,1,2,1,0
"Echeandia","Asparagaceae","Asparagales",0,0,2,80,2,0
"Echeveria","Crassulaceae","Saxifragales",0,0,0,170,0,NA
"Echidnopsis","Apocynaceae","Gentianales",0,0,0,34,0,NA
"Echinacanthus","Acanthaceae","Lamiales",0,0,0,4,0,NA
"Echinacea","Asteraceae","Asterales",0,0,2,10,2,0
"Echinaria","Poaceae","Poales",0,0,0,1,0,NA
"Echinocactus","Cactaceae","Caryophyllales",1,0,0,6,1,1
"Echinocereus","Cactaceae","Caryophyllales",1,0,0,64,1,1
"Echinochloa","Poaceae","Poales",0,0,9,35,9,0
"Echinocodon","Campanulaceae","Asterales",0,0,0,1,0,NA
"Echinocoryne","Asteraceae","Asterales",0,0,0,7,0,NA
"Echinocystis","Cucurbitaceae","Cucurbitales",0,0,1,1,1,0
"Echinodorus","Alismataceae","Alismatales",0,0,3,30,3,0
"Echinofossulocactus","Cactaceae","Caryophyllales",0,0,0,2,0,NA
"Echinolaena","Poaceae","Poales",0,0,1,7,1,0
"Echinomastus","Cactaceae","Caryophyllales",0,0,0,2,0,NA
"Echinopepon","Cucurbitaceae","Cucurbitales",0,0,4,20,4,0
"Echinophora","Apiaceae","Apiales",0,0,0,11,0,NA
"Echinopogon","Poaceae","Poales",0,0,2,7,2,0
"Echinops","Asteraceae","Asterales",0,0,7,193,7,0
"Echinopsis","Cactaceae","Caryophyllales",0,0,0,131,0,NA
"Echinopterys","Malpighiaceae","Malpighiales",1,0,0,2,1,1
"Echinorhyncha","Orchidaceae","Asparagales",0,0,1,5,1,0
"Echinosepala","Orchidaceae","Asparagales",0,0,2,11,2,0
"Echinospartum","Fabaceae","Fabales",0,0,0,4,0,NA
"Echinospermum","Boraginaceae","UnknownOrder-Boraginaceae",0,0,0,2,0,NA
"Echinostephia","Menispermaceae","Ranunculales",1,0,0,1,1,1
"Echiochilon","Boraginaceae","UnknownOrder-Boraginaceae",0,0,3,16,3,0
"Echiostachys","Boraginaceae","UnknownOrder-Boraginaceae",0,1,0,3,0,NA
"Echites","Apocynaceae","Gentianales",0,1,2,12,2,0
"Echium","Boraginaceae","UnknownOrder-Boraginaceae",0,0,4,67,4,0
"Eclecticus","Orchidaceae","Asparagales",0,0,0,1,0,NA
"Eclipta","Asteraceae","Asterales",0,0,1,11,1,0
"Ecliptostelma","Apocynaceae","Gentianales",0,0,0,1,0,NA
"Ectadium","Apocynaceae","Gentianales",0,0,0,3,0,NA
"Ectopopterys","Malpighiaceae","Malpighiales",0,1,0,1,0,NA
"Ectrosia","Poaceae","Poales",0,0,0,13,0,NA
"Ectrosiopsis","Poaceae","Poales",0,0,0,1,0,NA
"Ecua","Apocynaceae","Gentianales",0,0,0,1,0,NA
"Ecuadendron","Fabaceae","Fabales",0,0,0,1,0,NA
"Edgaria","Cucurbitaceae","Cucurbitales",0,0,0,1,0,NA
"Edgeworthia","Thymelaeaceae","Malvales",1,0,0,4,1,1
"Edithcolea","Apocynaceae","Gentianales",0,0,0,1,0,NA
"Edithea","Rubiaceae","Gentianales",0,0,0,3,0,NA
"Edmondia","Asteraceae","Asterales",0,0,0,3,0,NA
"Edraianthus","Campanulaceae","Asterales",0,0,1,24,1,0
"Eduandrea","Bromeliaceae","Poales",0,0,0,1,0,NA
"Edwartiothamnus","Asteraceae","Asterales",0,0,0,1,0,NA
"Efulensia","Passifloraceae","Malpighiales",1,0,0,2,1,1
"Egenolfia","Dryopteridaceae","Polypodiales",0,0,0,15,0,NA
"Egeria","Hydrocharitaceae","Alismatales",0,0,2,3,2,0
"Eggelingia","Orchidaceae","Asparagales",0,0,0,3,0,NA
"Egletes","Asteraceae","Asterales",0,0,1,11,1,0
"Ehrendorferia","Papaveraceae","Ranunculales",0,1,0,2,0,NA
"Ehretia","Boraginaceae","UnknownOrder-Boraginaceae",7,0,0,65,7,1
"Ehrharta","Poaceae","Poales",0,0,11,37,11,0
"Eichhornia","Pontederiaceae","Commelinales",0,0,6,6,6,0
"Eidothea","Proteaceae","Proteales",2,0,0,2,2,1
"Eigia","Brassicaceae","Brassicales",0,0,0,1,0,NA
"Einadia","Amaranthaceae","Caryophyllales",2,0,0,6,2,1
"Eirmocephala","Asteraceae","Asterales",0,0,0,3,0,NA
"Eitenia","Asteraceae","Asterales",0,0,0,2,0,NA
"Eithea","Amaryllidaceae","Asparagales",0,0,0,1,0,NA
"Eizia","Rubiaceae","Gentianales",0,0,0,1,0,NA
"Ekebergia","Meliaceae","Sapindales",2,0,0,4,2,1
"Ekimia","Apiaceae","Apiales",0,0,0,1,0,NA
"Ekmania","Asteraceae","Asterales",0,0,0,1,0,NA
"Ekmanianthe","Bignoniaceae","Lamiales",0,0,0,2,0,NA
"Ekmaniopappus","Asteraceae","Asterales",0,0,0,1,0,NA
"Ekmanochloa","Poaceae","Poales",0,0,0,2,0,NA
"Elachanthemum","Asteraceae","Asterales",0,0,0,1,0,NA
"Elachanthus","Asteraceae","Asterales",0,0,0,2,0,NA
"Elacholoma","Phrymaceae","Lamiales",0,0,0,1,0,NA
"Elachyptera","Celastraceae","Celastrales",2,0,0,8,2,1
"Elaeagia","Rubiaceae","Gentianales",0,0,0,25,0,NA
"Elaeagnus","Elaeagnaceae","Rosales",6,0,0,98,6,1
"Elaeis","Arecaceae","Arecales",2,0,0,2,2,1
"Elaeocarpus","Elaeocarpaceae","Oxalidales",90,0,0,480,90,1
"Elaeodendron","Celastraceae","Celastrales",0,0,0,1,0,NA
"Elaeoluma","Sapotaceae","Ericales",4,0,0,4,4,1
"Elaeoselinum","Apiaceae","Apiales",0,0,0,5,0,NA
"Elaeosticta","Apiaceae","Apiales",0,0,0,27,0,NA
"Elaphandra","Asteraceae","Asterales",1,0,0,14,1,1
"Elaphanthera","Santalaceae","Santalales",0,0,0,1,0,NA
"Elaphoglossum","Dryopteridaceae","Polypodiales",0,0,16,583,16,0
"Elaphrium","Burseraceae","Sapindales",0,0,0,1,0,NA
"Elasis","Commelinaceae","Commelinales",0,0,1,1,1,0
"Elateriopsis","Cucurbitaceae","Cucurbitales",0,0,1,6,1,0
"Elateriospermum","Euphorbiaceae","Malpighiales",1,0,0,1,1,1
"Elatine","Elatinaceae","Malpighiales",0,0,3,28,3,0
"Elatostema","Urticaceae","Rosales",1,0,10,525,11,0.0909090909090909
"Elattostachys","Sapindaceae","Sapindales",7,0,0,21,7,1
"Elburzia","Brassicaceae","Brassicales",0,0,0,1,0,NA
"Elegia","Restionaceae","Poales",0,0,37,49,37,0
"Eleiodoxa","Arecaceae","Arecales",0,0,0,1,0,NA
"Eleiotis","Fabaceae","Fabales",0,0,0,2,0,NA
"Elekmania","Asteraceae","Asterales",0,0,0,9,0,NA
"Eleocharis","Cyperaceae","Poales",0,0,59,288,59,0
"Eleorchis","Orchidaceae","Asparagales",0,0,1,1,1,0
"Elephantomene","Menispermaceae","Ranunculales",0,1,0,1,0,NA
"Elephantopus","Asteraceae","Asterales",0,0,3,29,3,0
"Elephantorrhiza","Fabaceae","Fabales",1,0,0,9,1,1
"Elettaria","Zingiberaceae","Zingiberales",0,0,1,11,1,0
"Elettariopsis","Zingiberaceae","Zingiberales",0,0,1,20,1,0
"Eleusine","Poaceae","Poales",0,0,3,10,3,0
"Eleutharrhena","Menispermaceae","Ranunculales",0,0,0,1,0,NA
"Eleutherandra","Achariaceae","Malpighiales",1,0,0,1,1,1
"Eleutheranthera","Asteraceae","Asterales",0,0,1,3,1,0
"Eleutherine","Iridaceae","Asparagales",0,0,2,4,2,0
"Eleutherococcus","Araliaceae","Apiales",8,0,0,37,8,1
"Eleutherospermum","Apiaceae","Apiales",0,0,0,1,0,NA
"Eleutherostylis","Malvaceae","Malvales",0,0,0,1,0,NA
"Eliea","Hypericaceae","Malpighiales",0,0,0,1,0,NA
"Eligmocarpus","Fabaceae","Fabales",0,0,0,1,0,NA
"Elingamita","Primulaceae","Ericales",1,0,0,1,1,1
"Elionurus","Poaceae","Poales",0,0,0,15,0,NA
"Elizabetha","Fabaceae","Fabales",2,0,0,11,2,1
"Elleanthus","Orchidaceae","Asparagales",0,0,0,112,0,NA
"Ellenbergia","Asteraceae","Asterales",0,0,0,1,0,NA
"Elliottia","Ericaceae","Ericales",3,0,0,4,3,1
"Ellipanthus","Connaraceae","Oxalidales",1,0,0,9,1,1
"Ellipeiopsis","Annonaceae","Magnoliales",0,0,0,2,0,NA
"Ellisia","Boraginaceae","UnknownOrder-Boraginaceae",0,0,1,1,1,0
"Ellisiophyllum","Plantaginaceae","Lamiales",0,0,0,1,0,NA
"Ellisochloa","Poaceae","Poales",0,0,0,2,0,NA
"Elmera","Saxifragaceae","Saxifragales",0,0,1,1,1,0
"Elodea","Hydrocharitaceae","Alismatales",0,0,4,6,4,0
"Eloyella","Orchidaceae","Asparagales",0,0,0,10,0,NA
"Elsholtzia","Lamiaceae","Lamiales",1,0,2,42,3,0.333333333333333
"Eltroplectris","Orchidaceae","Asparagales",0,0,1,13,1,0
"Elvasia","Ochnaceae","Malpighiales",2,0,0,14,2,1
"Elyhordeum","Poaceae","Poales",0,0,0,20,0,NA
"Elyleymus","Poaceae","Poales",0,0,0,1,0,NA
"Elymandra","Poaceae","Poales",0,0,0,6,0,NA
"Elymordeum","Poaceae","Poales",0,0,0,1,0,NA
"Elymostachys","Poaceae","Poales",0,0,0,1,0,NA
"Elymotrigia","Poaceae","Poales",0,0,0,9,0,NA
"Elymus","Poaceae","Poales",0,0,31,234,31,0
"Elysitanion","Poaceae","Poales",0,0,0,1,0,NA
"Elythranthera","Orchidaceae","Asparagales",0,0,1,3,1,0
"Elytranthe","Loranthaceae","Santalales",0,0,0,8,0,NA
"Elytraria","Acanthaceae","Lamiales",0,0,1,21,1,0
"Elytrigia","Poaceae","Poales",0,0,0,5,0,NA
"Elytropappus","Asteraceae","Asterales",0,0,0,2,0,NA
"Elytrophorus","Poaceae","Poales",0,0,1,2,1,0
"Elytropus","Apocynaceae","Gentianales",1,0,0,1,1,1
"Elytrostachys","Poaceae","Poales",0,0,0,2,0,NA
"Emarhendia","Gesneriaceae","Lamiales",0,0,0,1,0,NA
"Embadium","Boraginaceae","UnknownOrder-Boraginaceae",0,0,0,3,0,NA
"Embelia","Primulaceae","Ericales",2,0,0,134,2,1
"Emblemantha","Primulaceae","Ericales",0,0,0,1,0,NA
"Emblingia","Emblingiaceae","Brassicales",1,0,0,1,1,1
"Embolanthera","Hamamelidaceae","Saxifragales",0,0,0,2,0,NA
"Embothrium","Proteaceae","Proteales",1,0,0,1,1,1
"Embreea","Orchidaceae","Asparagales",0,0,1,2,1,0
"Emelianthe","Loranthaceae","Santalales",0,0,0,1,0,NA
"Emerus","Fabaceae","Fabales",0,0,0,9,0,NA
"Emex","Polygonaceae","Caryophyllales",0,0,1,2,1,0
"Emicocarpus","Apocynaceae","Gentianales",0,0,0,1,0,NA
"Emilia","Asteraceae","Asterales",0,0,0,115,0,NA
"Emiliella","Asteraceae","Asterales",0,0,0,6,0,NA
"Eminia","Fabaceae","Fabales",0,0,0,4,0,NA
"Eminium","Araceae","Alismatales",0,0,0,9,0,NA
"Emmenanthe","Boraginaceae","UnknownOrder-Boraginaceae",0,0,1,1,1,0
"Emmenopterys","Rubiaceae","Gentianales",1,0,0,2,1,1
"Emmenosperma","Rhamnaceae","Rosales",2,0,0,5,2,1
"Emmeorhiza","Rubiaceae","Gentianales",0,0,0,1,0,NA
"Emmotum","Icacinaceae","UnknownOrder-Icacinaceae",3,0,0,12,3,1
"Emodiopteris","Dennstaedtiaceae","Polypodiales",0,0,0,2,0,NA
"Emorya","Scrophulariaceae","Lamiales",0,0,1,2,1,0
"Empetrum","Ericaceae","Ericales",2,0,0,3,2,1
"Emplectanthus","Apocynaceae","Gentianales",0,0,0,3,0,NA
"Empleuridium","Celastraceae","Celastrales",1,0,0,1,1,1
"Empleurum","Rutaceae","Sapindales",1,0,0,3,1,1
"Empodisma","Restionaceae","Poales",0,0,1,2,1,0
"Empodium","Hypoxidaceae","Asparagales",0,0,1,7,1,0
"Empogona","Rubiaceae","Gentianales",3,0,0,28,3,1
"Enantiophylla","Apiaceae","Apiales",0,0,0,1,0,NA
"Enarganthe","Aizoaceae","Caryophyllales",0,0,0,1,0,NA
"Enarthrocarpus","Brassicaceae","Brassicales",0,0,0,5,0,NA
"Encelia","Asteraceae","Asterales",4,0,0,20,4,1
"Enceliopsis","Asteraceae","Asterales",0,0,0,3,0,NA
"Encephalartos","Zamiaceae","Cycadales",55,0,0,68,55,1
"Encephalosphaera","Acanthaceae","Lamiales",0,0,0,3,0,NA
"Encheiridion","Orchidaceae","Asparagales",0,0,0,1,0,NA
"Encholirium","Bromeliaceae","Poales",0,0,2,25,2,0
"Enchylaena","Amaranthaceae","Caryophyllales",1,0,0,2,1,1
"Encopella","Plantaginaceae","Lamiales",0,0,0,1,0,NA
"Encyclia","Orchidaceae","Asparagales",0,0,12,172,12,0
"Endertia","Fabaceae","Fabales",1,0,0,1,1,1
"Endiandra","Lauraceae","Laurales",47,0,0,125,47,1
"Endlicheria","Lauraceae","Laurales",19,0,0,59,19,1
"Endocaulos","Podostemaceae","Malpighiales",0,0,0,1,0,NA
"Endocellion","Asteraceae","Asterales",0,0,0,1,0,NA
"Endocomia","Myristicaceae","Magnoliales",2,0,0,4,2,1
"Endodesmia","Calophyllaceae","Malpighiales",1,0,0,1,1,1
"Endonema","Penaeaceae","Myrtales",2,0,0,2,2,1
"Endopappus","Asteraceae","Asterales",0,0,0,1,0,NA
"Endopleura","Humiriaceae","Malpighiales",1,0,0,1,1,1
"Endosamara","Fabaceae","Fabales",1,0,0,1,1,1
"Endospermum","Euphorbiaceae","Malpighiales",7,0,0,11,7,1
"Endostemon","Lamiaceae","Lamiales",0,0,0,20,0,NA
"Endressia","Apiaceae","Apiales",0,0,1,2,1,0
"Enekbatus","Myrtaceae","Myrtales",0,0,0,10,0,NA
"Enemion","Ranunculaceae","Ranunculales",0,0,2,7,2,0
"Engelhardia","Juglandaceae","Fagales",0,0,0,3,0,NA
"Engelhardtia","Juglandaceae","Fagales",4,0,0,12,4,1
"Engelmannia","Asteraceae","Asterales",0,0,1,2,1,0
"Engleria","Asteraceae","Asterales",0,0,0,2,0,NA
"Englerina","Loranthaceae","Santalales",2,0,0,26,2,1
"Englerocharis","Brassicaceae","Brassicales",0,0,0,2,0,NA
"Englerodaphne","Thymelaeaceae","Malvales",0,0,0,3,0,NA
"Englerodendron","Fabaceae","Fabales",1,0,0,2,1,1
"Englerophytum","Sapotaceae","Ericales",5,0,0,8,5,1
"Engomegoma","Olacaceae","Santalales",1,0,0,1,1,1
"Enhalus","Hydrocharitaceae","Alismatales",0,0,1,1,1,0
"Enicosanthum","Annonaceae","Magnoliales",5,0,0,19,5,1
"Enicostema","Gentianaceae","Gentianales",0,0,0,3,0,NA
"Enkianthus","Ericaceae","Ericales",3,0,0,14,3,1
"Enkleia","Thymelaeaceae","Malvales",0,0,0,3,0,NA
"Ennealophus","Iridaceae","Asparagales",0,0,3,5,3,0
"Enneapogon","Poaceae","Poales",0,0,8,23,8,0
"Enneatypus","Polygonaceae","Caryophyllales",0,0,0,2,0,NA
"Enriquebeltrania","Euphorbiaceae","Malpighiales",2,0,0,2,2,1
"Ensete","Musaceae","Zingiberales",1,0,1,8,2,0.5
"Entada","Fabaceae","Fabales",1,0,0,29,1,1
"Entadopsis","Fabaceae","Fabales",1,0,0,7,1,1
"Entandrophragma","Meliaceae","Sapindales",8,0,0,12,8,1
"Entelea","Malvaceae","Malvales",1,0,0,1,1,1
"Enterolobium","Fabaceae","Fabales",7,0,0,13,7,1
"Enteropogon","Poaceae","Poales",0,0,2,17,2,0
"Enterosora","Polypodiaceae","Polypodiales",0,0,0,13,0,NA
"Entolasia","Poaceae","Poales",0,0,2,5,2,0
"Entomophobia","Orchidaceae","Asparagales",0,0,1,1,1,0
"Entoplocamia","Poaceae","Poales",0,0,0,1,0,NA
"Enydra","Asteraceae","Asterales",0,0,1,6,1,0
"Eomecon","Papaveraceae","Ranunculales",0,0,0,1,0,NA
"Eosanthe","Rubiaceae","Gentianales",0,0,0,1,0,NA
"Epacris","Ericaceae","Ericales",30,0,0,49,30,1
"Epallage","Asteraceae","Asterales",0,0,0,3,0,NA
"Epaltes","Asteraceae","Asterales",0,1,1,9,1,0
"Eparmatostigma","Orchidaceae","Asparagales",0,0,0,1,0,NA
"Eperua","Fabaceae","Fabales",9,0,0,15,9,1
"Ephedra","Ephedraceae","Ephedrales",22,0,0,70,22,1
"Ephedranthus","Annonaceae","Magnoliales",4,0,0,6,4,1
"Ephippiandra","Monimiaceae","Laurales",2,0,0,7,2,1
"Ephippianthus","Orchidaceae","Asparagales",0,0,0,2,0,NA
"Ephippiocarpa","Apocynaceae","Gentianales",0,0,0,2,0,NA
"Epiblastus","Orchidaceae","Asparagales",0,0,0,22,0,NA
"Epiblema","Orchidaceae","Asparagales",0,0,0,1,0,NA
"Epiclastopelma","Acanthaceae","Lamiales",0,0,0,2,0,NA
"Epidendrum","Orchidaceae","Asparagales",0,0,6,1435,6,0
"Epidryos","Rapateaceae","Poales",0,0,1,3,1,0
"Epifagus","Orobanchaceae","Lamiales",0,0,0,2,0,NA
"Epigaea","Ericaceae","Ericales",1,0,0,3,1,1
"Epigynum","Apocynaceae","Gentianales",0,3,0,5,0,NA
"Epilasia","Asteraceae","Asterales",0,0,0,3,0,NA
"Epilobium","Onagraceae","Myrtales",0,0,13,222,13,0
"Epilyna","Orchidaceae","Asparagales",0,0,0,2,0,NA
"Epimedium","Berberidaceae","Ranunculales",0,0,1,65,1,0
"Epipactis","Orchidaceae","Asparagales",0,0,6,70,6,0
"Epipetrum","Dioscoreaceae","Dioscoreales",0,0,0,1,0,NA
"Epiphyllum","Cactaceae","Caryophyllales",1,0,0,15,1,1
"Epipogium","Orchidaceae","Asparagales",0,0,0,3,0,NA
"Epipremnum","Araceae","Alismatales",0,0,1,15,1,0
"Epiprinus","Euphorbiaceae","Malpighiales",0,0,0,6,0,NA
"Epirixanthes","Polygalaceae","Fabales",0,0,0,5,0,NA
"Epischoenus","Cyperaceae","Poales",0,0,1,8,1,0
"Episcia","Gesneriaceae","Lamiales",0,0,4,12,4,0
"Epistemma","Apocynaceae","Gentianales",0,0,0,3,0,NA
"Epistephium","Orchidaceae","Asparagales",0,0,3,21,3,0
"Epithelantha","Cactaceae","Caryophyllales",0,0,0,1,0,NA
"Epithema","Gesneriaceae","Lamiales",0,0,0,21,0,NA
"Epithymum","Convolvulaceae","Solanales",0,0,0,2,0,NA
"Epitriche","Asteraceae","Asterales",0,0,0,1,0,NA
"Epixiphium","Plantaginaceae","Lamiales",0,0,0,1,0,NA
"Equisetum","Equisetaceae","Equisetales",0,0,15,25,15,0
"Eragrostiella","Poaceae","Poales",0,0,1,6,1,0
"Eragrostis","Poaceae","Poales",0,0,42,424,42,0
"Eranthemum","Acanthaceae","Lamiales",0,0,0,22,0,NA
"Eranthis","Ranunculaceae","Ranunculales",0,0,2,9,2,0
"Erasanthe","Orchidaceae","Asparagales",0,0,0,1,0,NA
"Erato","Asteraceae","Asterales",0,0,0,5,0,NA
"Erblichia","Passifloraceae","Malpighiales",0,0,0,5,0,NA
"Ercilla","Phytolaccaceae","Caryophyllales",1,0,0,2,1,1
"Erdisia","Cactaceae","Caryophyllales",0,0,0,1,0,NA
"Erechtites","Asteraceae","Asterales",0,0,2,15,2,0
"Eremaea","Myrtaceae","Myrtales",7,0,0,16,7,1
"Eremalche","Malvaceae","Malvales",0,0,1,3,1,0
"Eremanthus","Asteraceae","Asterales",0,0,0,29,0,NA
"Eremia","Ericaceae","Ericales",0,0,0,7,0,NA
"Eremiella","Ericaceae","Ericales",0,0,0,1,0,NA
"Eremiolirion","Tecophilaeaceae","Asparagales",0,0,1,1,1,0
"Eremitilla","Orobanchaceae","Lamiales",0,0,0,1,0,NA
"Eremitis","Poaceae","Poales",0,0,0,1,0,NA
"Eremobium","Brassicaceae","Brassicales",0,0,0,3,0,NA
"Eremoblastus","Brassicaceae","Brassicales",0,0,0,1,0,NA
"Eremocaulon","Poaceae","Poales",0,0,0,5,0,NA
"Eremocharis","Apiaceae","Apiales",1,0,0,9,1,1
"Eremochloa","Poaceae","Poales",0,0,1,12,1,0
"Eremocrinum","Asparagaceae","Asparagales",0,0,0,1,0,NA
"Eremodaucus","Apiaceae","Apiales",0,0,0,1,0,NA
"Eremodraba","Brassicaceae","Brassicales",0,0,0,2,0,NA
"Eremogeton","Scrophulariaceae","Lamiales",0,0,0,1,0,NA
"Eremogone","Caryophyllaceae","Caryophyllales",0,0,0,71,0,NA
"Eremolaena","Sarcolaenaceae","Malvales",0,0,0,2,0,NA
"Eremomastax","Acanthaceae","Lamiales",0,0,0,1,0,NA
"Eremophea","Amaranthaceae","Caryophyllales",0,0,0,2,0,NA
"Eremophila","Scrophulariaceae","Lamiales",17,0,0,214,17,1
"Eremophyton","Brassicaceae","Brassicales",0,0,0,1,0,NA
"Eremopoa","Poaceae","Poales",0,0,0,5,0,NA
"Eremopodium","Aspleniaceae","Polypodiales",0,0,0,1,0,NA
"Eremopyrum","Poaceae","Poales",0,0,2,4,2,0
"Eremosis","Asteraceae","Asterales",0,0,0,9,0,NA
"Eremosparton","Fabaceae","Fabales",0,0,0,3,0,NA
"Eremospatha","Arecaceae","Arecales",1,0,0,11,1,1
"Eremostachys","Lamiaceae","Lamiales",0,0,0,30,0,NA
"Eremosyne","Escalloniaceae","Escalloniales",1,0,0,1,1,1
"Eremothamnus","Asteraceae","Asterales",1,0,0,1,1,1
"Eremothera","Onagraceae","Myrtales",0,0,0,7,0,NA
"Eremurus","Xanthorrhoeaceae","Asparagales",0,0,11,60,11,0
"Erepsia","Aizoaceae","Caryophyllales",0,0,0,30,0,NA
"Ergocarpon","Apiaceae","Apiales",0,0,0,1,0,NA
"Eria","Orchidaceae","Asparagales",0,0,2,238,2,0
"Eriachaenium","Asteraceae","Asterales",0,0,0,1,0,NA
"Eriachne","Poaceae","Poales",0,0,5,48,5,0
"Eriandra","Polygalaceae","Fabales",0,0,0,1,0,NA
"Erianthecium","Poaceae","Poales",0,0,0,1,0,NA
"Erianthemum","Loranthaceae","Santalales",1,0,0,16,1,1
"Erianthera","Lamiaceae","Lamiales",0,0,0,1,0,NA
"Erianthus","Poaceae","Poales",0,0,0,1,0,NA
"Eriastrum","Polemoniaceae","Ericales",1,0,0,16,1,1
"Eriaxis","Orchidaceae","Asparagales",0,0,1,1,1,0
"Erica","Ericaceae","Ericales",118,0,0,868,118,1
"Ericameria","Asteraceae","Asterales",21,0,0,39,21,1
"Ericentrodea","Asteraceae","Asterales",0,0,0,6,0,NA
"Erichsenia","Fabaceae","Fabales",0,0,0,1,0,NA
"Ericksonella","Orchidaceae","Asparagales",0,0,0,1,0,NA
"Erigenia","Apiaceae","Apiales",0,0,1,1,1,0
"Erigeron","Asteraceae","Asterales",1,0,12,476,13,0.0769230769230769
"Erinacea","Fabaceae","Fabales",1,0,0,3,1,1
"Erinocarpus","Malvaceae","Malvales",0,0,0,1,0,NA
"Erinus","Plantaginaceae","Lamiales",0,0,0,2,0,NA
"Eriobotrya","Rosaceae","Rosales",4,0,0,12,4,1
"Eriocaulon","Eriocaulaceae","Poales",0,0,32,477,32,0
"Eriocephalus","Asteraceae","Asterales",0,0,0,36,0,NA
"Eriocereus","Cactaceae","Caryophyllales",0,0,0,1,0,NA
"Eriochilus","Orchidaceae","Asparagales",0,0,1,9,1,0
"Eriochlamys","Asteraceae","Asterales",0,0,0,4,0,NA
"Eriochloa","Poaceae","Poales",0,0,5,35,5,0
"Eriochrysis","Poaceae","Poales",0,0,0,11,0,NA
"Eriocnema","Melastomataceae","Myrtales",0,0,0,1,0,NA
"Eriocoelum","Sapindaceae","Sapindales",5,0,0,12,5,1
"Eriocoma","Poaceae","Poales",0,0,0,1,0,NA
"Eriodes","Orchidaceae","Asparagales",0,0,0,1,0,NA
"Eriodictyon","Boraginaceae","UnknownOrder-Boraginaceae",8,0,0,9,8,1
"Eriogonum","Polygonaceae","Caryophyllales",21,1,4,255,25,0.84
"Eriolaena","Malvaceae","Malvales",2,0,0,10,2,1
"Eriolarynx","Solanaceae","Solanales",0,0,0,3,0,NA
"Eriolobus","Rosaceae","Rosales",0,0,0,1,0,NA
"Erioneuron","Poaceae","Poales",0,0,0,3,0,NA
"Eriope","Lamiaceae","Lamiales",0,0,0,31,0,NA
"Eriophorum","Cyperaceae","Poales",0,0,13,27,13,0
"Eriophyllum","Asteraceae","Asterales",1,0,1,13,2,0.5
"Eriophyton","Lamiaceae","Lamiales",0,0,0,6,0,NA
"Eriopsis","Orchidaceae","Asparagales",0,0,2,5,2,0
"Eriosema","Fabaceae","Fabales",0,0,1,157,1,0
"Eriosemopsis","Rubiaceae","Gentianales",0,0,0,1,0,NA
"Eriosolena","Thymelaeaceae","Malvales",0,0,0,1,0,NA
"Eriosonia","Pteridaceae","Polypodiales",0,0,0,2,0,NA
"Eriosorus","Pteridaceae","Polypodiales",0,0,0,30,0,NA
"Eriospermum","Asparagaceae","Asparagales",0,0,7,119,7,0
"Eriostemon","Rutaceae","Sapindales",5,0,0,37,5,1
"Eriostylos","Amaranthaceae","Caryophyllales",0,0,0,1,0,NA
"Eriosyce","Cactaceae","Caryophyllales",4,0,0,42,4,1
"Eriosynaphe","Apiaceae","Apiales",0,0,0,1,0,NA
"Eriotheca","Malvaceae","Malvales",11,0,0,23,11,1
"Eriothymus","Lamiaceae","Lamiales",0,0,0,1,0,NA
"Eriotrix","Asteraceae","Asterales",0,0,0,2,0,NA
"Erioxylum","Malvaceae","Malvales",0,0,0,1,0,NA
"Erisma","Vochysiaceae","Myrtales",6,0,0,22,6,1
"Erismadelphus","Vochysiaceae","Myrtales",1,0,0,2,1,1
"Erismanthus","Euphorbiaceae","Malpighiales",0,0,0,2,0,NA
"Erithalis","Rubiaceae","Gentianales",1,0,0,8,1,1
"Eritrichium","Boraginaceae","UnknownOrder-Boraginaceae",0,0,0,70,0,NA
"Erlangea","Asteraceae","Asterales",0,0,0,16,0,NA
"Ernestia","Melastomataceae","Myrtales",0,0,0,13,0,NA
"Ernodea","Rubiaceae","Gentianales",2,0,0,9,2,1
"Erocallis","Montiaceae","Caryophyllales",0,0,1,1,1,0
"Erodiophyllum","Asteraceae","Asterales",0,0,0,2,0,NA
"Erodium","Geraniaceae","Geraniales",0,0,19,128,19,0
"Erophaca","Fabaceae","Fabales",0,0,0,1,0,NA
"Erophila","Brassicaceae","Brassicales",0,0,1,4,1,0
"Errazurizia","Fabaceae","Fabales",0,0,0,4,0,NA
"Ertela","Rutaceae","Sapindales",0,0,0,2,0,NA
"Eruca","Brassicaceae","Brassicales",0,0,0,3,0,NA
"Erucaria","Brassicaceae","Brassicales",0,0,0,10,0,NA
"Erucastrum","Brassicaceae","Brassicales",0,0,0,28,0,NA
"Ervum","Fabaceae","Fabales",0,0,0,6,0,NA
"Erycibe","Convolvulaceae","Solanales",0,0,0,10,0,NA
"Erycina","Orchidaceae","Asparagales",0,0,4,7,4,0
"Erymophyllum","Asteraceae","Asterales",0,0,1,5,1,0
"Eryngiophyllum","Asteraceae","Asterales",0,0,0,2,0,NA
"Eryngium","Apiaceae","Apiales",0,0,11,257,11,0
"Erysimum","Brassicaceae","Brassicales",0,0,4,261,4,0
"Erythradenia","Asteraceae","Asterales",0,0,0,1,0,NA
"Erythrina","Fabaceae","Fabales",29,0,0,129,29,1
"Erythrocephalum","Asteraceae","Asterales",0,0,0,15,0,NA
"Erythrochiton","Rutaceae","Sapindales",1,0,0,7,1,1
"Erythrococca","Euphorbiaceae","Malpighiales",4,0,0,41,4,1
"Erythrodes","Orchidaceae","Asparagales",0,0,0,26,0,NA
"Erythronium","Liliaceae","Liliales",0,0,20,29,20,0
"Erythropalum","Olacaceae","Santalales",1,0,0,1,1,1
"Erythrophleum","Fabaceae","Fabales",6,0,0,10,6,1
"Erythrophysa","Sapindaceae","Sapindales",2,0,0,9,2,1
"Erythrorchis","Orchidaceae","Asparagales",0,0,2,2,2,0
"Erythroselinum","Apiaceae","Apiales",0,0,0,1,0,NA
"Erythroseris","Asteraceae","Asterales",1,0,0,2,1,1
"Erythrospermum","Achariaceae","Malpighiales",2,0,0,19,2,1
"Erythroxylum","Erythroxylaceae","Malpighiales",67,0,0,258,67,1
"Escallonia","Escalloniaceae","Escalloniales",8,0,0,47,8,1
"Eschenbachia","Asteraceae","Asterales",0,0,0,1,0,NA
"Eschscholzia","Papaveraceae","Ranunculales",0,0,1,12,1,0
"Eschweilera","Lecythidaceae","Ericales",48,0,0,92,48,1
"Escobaria","Cactaceae","Caryophyllales",0,0,0,24,0,NA
"Escobedia","Orobanchaceae","Lamiales",0,0,0,9,0,NA
"Escontria","Cactaceae","Caryophyllales",1,0,0,1,1,1
"Esenbeckia","Rutaceae","Sapindales",4,0,0,32,4,1
"Esmeralda","Orchidaceae","Asparagales",0,0,0,3,0,NA
"Espadaea","Solanaceae","Solanales",1,0,0,1,1,1
"Espejoa","Asteraceae","Asterales",0,0,0,1,0,NA
"Espeletia","Asteraceae","Asterales",0,0,0,74,0,NA
"Espeletiopsis","Asteraceae","Asterales",0,0,0,24,0,NA
"Espostoa","Cactaceae","Caryophyllales",0,0,0,11,0,NA
"Espostoopsis","Cactaceae","Caryophyllales",0,0,0,1,0,NA
"Esterhazya","Orobanchaceae","Lamiales",0,0,0,7,0,NA
"Esterhuysenia","Aizoaceae","Caryophyllales",0,0,0,5,0,NA
"Estevesia","Cactaceae","Caryophyllales",0,0,0,1,0,NA
"Etaballia","Fabaceae","Fabales",1,0,0,1,1,1
"Eteriscius","Rubiaceae","Gentianales",0,0,0,1,0,NA
"Ethulia","Asteraceae","Asterales",0,0,0,18,0,NA
"Etlingera","Zingiberaceae","Zingiberales",0,0,3,100,3,0
"Euadenia","Capparaceae","Brassicales",0,0,0,3,0,NA
"Euanthe","Orchidaceae","Asparagales",0,0,0,1,0,NA
"Eubotrys","Ericaceae","Ericales",0,0,0,2,0,NA
"Eubrachion","Santalaceae","Santalales",1,0,0,2,1,1
"Eucalyptopsis","Myrtaceae","Myrtales",1,0,0,2,1,1
"Eucalyptus","Myrtaceae","Myrtales",622,0,0,822,622,1
"Eucephalus","Asteraceae","Asterales",0,0,0,10,0,NA
"Euceraea","Salicaceae","Malpighiales",2,0,0,3,2,1
"Euchaetis","Rutaceae","Sapindales",1,0,0,22,1,1
"Eucharis","Amaryllidaceae","Asparagales",0,0,2,18,2,0
"Euchile","Orchidaceae","Asparagales",0,0,2,3,2,0
"Euchilopsis","Fabaceae","Fabales",0,0,0,1,0,NA
"Euchiton","Asteraceae","Asterales",0,0,4,17,4,0
"Euchorium","Sapindaceae","Sapindales",0,0,0,1,0,NA
"Euchresta","Fabaceae","Fabales",3,0,0,4,3,1
"Euclasta","Poaceae","Poales",0,0,0,2,0,NA
"Euclea","Ebenaceae","Ericales",6,0,0,18,6,1
"Euclidium","Brassicaceae","Brassicales",0,0,1,1,1,0
"Euclinia","Rubiaceae","Gentianales",2,0,0,3,2,1
"Eucnide","Loasaceae","Cornales",2,2,0,13,2,1
"Eucodonia","Gesneriaceae","Lamiales",0,0,0,2,0,NA
"Eucodonopsis","Gesneriaceae","Lamiales",0,0,0,1,0,NA
"Eucomis","Asparagaceae","Asparagales",0,0,7,11,7,0
"Eucommia","Eucommiaceae","Garryales",1,0,0,1,1,1
"Eucorymbia","Apocynaceae","Gentianales",0,0,0,1,0,NA
"Eucrosia","Amaryllidaceae","Asparagales",0,0,2,8,2,0
"Eucryphia","Cunoniaceae","Oxalidales",6,0,0,7,6,1
"Eucrypta","Boraginaceae","UnknownOrder-Boraginaceae",0,0,2,2,2,0
"Eudema","Brassicaceae","Brassicales",0,0,0,6,0,NA
"Eugeissona","Arecaceae","Arecales",1,0,0,6,1,1
"Eugenia","Myrtaceae","Myrtales",86,0,0,1058,86,1
"Euglypha","Aristolochiaceae","Piperales",0,0,0,1,0,NA
"Eulalia","Poaceae","Poales",0,0,3,36,3,0
"Eulaliopsis","Poaceae","Poales",0,0,0,2,0,NA
"Euleria","Anacardiaceae","Sapindales",0,0,0,1,0,NA
"Eulobus","Onagraceae","Myrtales",0,0,0,4,0,NA
"Eulophia","Orchidaceae","Asparagales",0,0,5,201,5,0
"Eulophiella","Orchidaceae","Asparagales",0,0,0,5,0,NA
"Eulychnia","Cactaceae","Caryophyllales",1,0,0,5,1,1
"Eumorphia","Asteraceae","Asterales",0,0,0,6,0,NA
"Euodia","Rutaceae","Sapindales",2,0,0,5,2,1
"Euonymus","Celastraceae","Celastrales",19,0,0,142,19,1
"Eupatoriastrum","Asteraceae","Asterales",0,0,0,6,0,NA
"Eupatorina","Asteraceae","Asterales",0,0,0,1,0,NA
"Eupatoriopsis","Asteraceae","Asterales",0,0,0,1,0,NA
"Eupatorium","Asteraceae","Asterales",1,0,9,126,10,0.1
"Euphorbia","Euphorbiaceae","Malpighiales",53,2,78,2046,131,0.404580152671756
"Euphorianthus","Sapindaceae","Sapindales",0,0,0,1,0,NA
"Euphrasia","Orobanchaceae","Lamiales",0,0,4,54,4,0
"Euphronia","Euphroniaceae","Malpighiales",2,0,0,3,2,1
"Euphrosyne","Asteraceae","Asterales",0,0,0,1,0,NA
"Euplassa","Proteaceae","Proteales",4,0,0,20,4,1
"Euploca","Boraginaceae","UnknownOrder-Boraginaceae",0,0,0,21,0,NA
"Eupodium","Marattiaceae","Marattiales",0,0,2,3,2,0
"Eupomatia","Eupomatiaceae","Magnoliales",3,0,0,3,3,1
"Euptelea","Eupteleaceae","Ranunculales",2,0,0,2,2,1
"Eureiandra","Cucurbitaceae","Cucurbitales",0,0,1,8,1,0
"Euroschinus","Anacardiaceae","Sapindales",9,0,0,9,9,1
"Eurya","Pentaphylacaceae","Ericales",29,0,0,157,29,1
"Euryale","Nymphaeaceae","Nymphaeales",0,0,1,1,1,0
"Eurybia","Asteraceae","Asterales",0,0,1,23,1,0
"Euryblema","Orchidaceae","Asparagales",0,0,1,2,1,0
"Eurycarpus","Brassicaceae","Brassicales",0,0,0,2,0,NA
"Eurycentrum","Orchidaceae","Asparagales",0,0,0,7,0,NA
"Eurychone","Orchidaceae","Asparagales",0,0,2,2,2,0
"Eurychorda","Restionaceae","Poales",0,0,1,1,1,0
"Eurycoma","Simaroubaceae","Sapindales",2,0,0,3,2,1
"Eurycorymbus","Sapindaceae","Sapindales",1,0,0,1,1,1
"Eurydochus","Asteraceae","Asterales",0,0,0,1,0,NA
"Euryodendron","Theaceae","Ericales",1,0,0,1,1,1
"Euryomyrtus","Myrtaceae","Myrtales",3,0,0,7,3,1
"Euryops","Asteraceae","Asterales",1,0,0,97,1,1
"Eurypetalum","Fabaceae","Fabales",1,0,0,3,1,1
"Eurysolen","Lamiaceae","Lamiales",0,0,0,1,0,NA
"Eurystigma","Aizoaceae","Caryophyllales",0,0,0,1,0,NA
"Eurystyles","Orchidaceae","Asparagales",0,0,0,20,0,NA
"Eurytaenia","Apiaceae","Apiales",0,0,0,2,0,NA
"Euscaphis","Staphyleaceae","Crossosomatales",1,0,0,2,1,1
"Eusideroxylon","Lauraceae","Laurales",1,0,0,1,1,1
"Eusiphon","Acanthaceae","Lamiales",0,0,0,3,0,NA
"Eustachys","Poaceae","Poales",0,0,3,16,3,0
"Eustegia","Apocynaceae","Gentianales",0,0,1,6,1,0
"Eustephia","Amaryllidaceae","Asparagales",0,0,2,6,2,0
"Eustigma","Hamamelidaceae","Saxifragales",1,0,0,3,1,1
"Eustoma","Gentianaceae","Gentianales",0,0,0,3,0,NA
"Eustrephus","Asparagaceae","Asparagales",0,0,1,1,1,0
"Eutaxia","Fabaceae","Fabales",1,0,0,8,1,1
"Euterpe","Arecaceae","Arecales",6,0,0,7,6,1
"Eutetras","Asteraceae","Asterales",0,0,1,2,1,0
"Euthamia","Asteraceae","Asterales",0,0,1,4,1,0
"Euthemis","Ochnaceae","Malpighiales",0,0,0,2,0,NA
"Euthystachys","Stilbaceae","Lamiales",1,0,0,1,1,1
"Eutrema","Brassicaceae","Brassicales",0,0,2,31,2,0
"Eutrochium","Asteraceae","Asterales",0,0,0,5,0,NA
"Euxylophora","Rutaceae","Sapindales",1,0,0,1,1,1
"Evacidium","Asteraceae","Asterales",0,0,0,1,0,NA
"Evandra","Cyperaceae","Poales",0,0,1,2,1,0
"Evax","Asteraceae","Asterales",0,0,0,1,0,NA
"Everardia","Cyperaceae","Poales",0,0,0,11,0,NA
"Everistia","Rubiaceae","Gentianales",0,0,0,1,0,NA
"Eversmannia","Fabaceae","Fabales",0,0,0,4,0,NA
"Evodia","Rutaceae","Sapindales",0,0,0,7,0,NA
"Evodianthus","Cyclanthaceae","Pandanales",0,0,0,1,0,NA
"Evodiella","Rutaceae","Sapindales",0,0,0,2,0,NA
"Evolvulus","Convolvulaceae","Solanales",0,2,2,100,2,0
"Evonymopsis","Celastraceae","Celastrales",0,0,0,5,0,NA
"Evotella","Orchidaceae","Asparagales",0,0,0,1,0,NA
"Ewartia","Asteraceae","Asterales",0,0,1,5,1,0
"Exaculum","Gentianaceae","Gentianales",0,0,0,1,0,NA
"Exacum","Gentianaceae","Gentianales",0,0,1,70,1,0
"Exalaria","Orchidaceae","Asparagales",0,0,1,1,1,0
"Exarata","Schlegeliaceae","Lamiales",0,0,0,1,0,NA
"Exbucklandia","Hamamelidaceae","Saxifragales",2,0,0,3,2,1
"Excentradenia","Malpighiaceae","Malpighiales",0,0,0,4,0,NA
"Excoecaria","Euphorbiaceae","Malpighiales",5,0,0,38,5,1
"Exellia","Annonaceae","Magnoliales",1,0,0,1,1,1
"Exellodendron","Chrysobalanaceae","Malpighiales",2,0,0,5,2,1
"Exhalimolobos","Brassicaceae","Brassicales",0,0,1,10,1,0
"Exoacantha","Apiaceae","Apiales",0,0,0,1,0,NA
"Exocarpos","Santalaceae","Santalales",8,0,0,27,8,1
"Exocarya","Cyperaceae","Poales",0,0,0,1,0,NA
"Exochorda","Rosaceae","Rosales",1,0,0,2,1,1
"Exodeconus","Solanaceae","Solanales",0,0,0,6,0,NA
"Exogonium","Convolvulaceae","Solanales",0,0,0,8,0,NA
"Exomiocarpon","Asteraceae","Asterales",0,0,0,1,0,NA
"Exomis","Amaranthaceae","Caryophyllales",1,0,0,1,1,1
"Exorhopala","Balanophoraceae","Santalales",0,0,0,1,0,NA
"Exostema","Rubiaceae","Gentianales",11,0,0,43,11,1
"Exostyles","Fabaceae","Fabales",0,0,0,4,0,NA
"Exothea","Sapindaceae","Sapindales",1,0,0,3,1,1
"Exotheca","Poaceae","Poales",0,0,0,1,0,NA
"Eysenhardtia","Fabaceae","Fabales",3,0,0,13,3,1
"Ezosciadium","Apiaceae","Apiales",0,0,1,1,1,0
"Faberia","Asteraceae","Asterales",0,0,0,7,0,NA
"Fabiana","Solanaceae","Solanales",3,0,0,15,3,1
"Fabricia","Myrtaceae","Myrtales",0,0,0,9,0,NA
"Facelis","Asteraceae","Asterales",0,0,1,2,1,0
"Facheiroa","Cactaceae","Caryophyllales",0,0,0,4,0,NA
"Fadenia","Amaranthaceae","Caryophyllales",0,0,0,1,0,NA
"Fadogia","Rubiaceae","Gentianales",2,0,0,41,2,1
"Fadogiella","Rubiaceae","Gentianales",1,0,0,3,1,1
"Fadyenia","Tectariaceae","Polypodiales",0,0,0,2,0,NA
"Fagara","Rutaceae","Sapindales",0,0,0,1,0,NA
"Fagaropsis","Rutaceae","Sapindales",1,0,0,4,1,1
"Fagelia","Fabaceae","Fabales",0,0,0,2,0,NA
"Fagonia","Zygophyllaceae","Zygophyllales",3,0,1,34,4,0.75
"Fagopyrum","Polygonaceae","Caryophyllales",0,0,15,26,15,0
"Fagraea","Gentianaceae","Gentianales",11,0,0,72,11,1
"Faguetia","Anacardiaceae","Sapindales",0,0,0,1,0,NA
"Fagus","Fagaceae","Fagales",10,0,0,11,10,1
"Faidherbia","Fabaceae","Fabales",1,0,0,1,1,1
"Faika","Monimiaceae","Laurales",0,0,0,1,0,NA
"Falcaria","Apiaceae","Apiales",0,0,0,1,0,NA
"Falcata","Fabaceae","Fabales",0,0,0,2,0,NA
"Falcataria","Fabaceae","Fabales",1,0,0,3,1,1
"Falcatifolium","Podocarpaceae","Araucariales",2,0,0,6,2,1
"Falconeria","Euphorbiaceae","Malpighiales",0,0,0,1,0,NA
"Falkia","Convolvulaceae","Solanales",0,0,1,2,1,0
"Fallopia","Polygonaceae","Caryophyllales",0,0,4,16,4,0
"Fallugia","Rosaceae","Rosales",1,0,0,1,1,1
"Fanninia","Apocynaceae","Gentianales",0,0,0,1,0,NA
"Faradaya","Lamiaceae","Lamiales",1,0,0,7,1,1
"Faramea","Rubiaceae","Gentianales",9,0,0,212,9,1
"Farfugium","Asteraceae","Asterales",0,0,1,2,1,0
"Fargesia","Poaceae","Poales",2,0,0,82,2,1
"Farmeria","Podostemaceae","Malpighiales",0,0,1,1,1,0
"Faroa","Gentianaceae","Gentianales",0,0,0,19,0,NA
"Farquharia","Apocynaceae","Gentianales",1,0,0,1,1,1
"Farrago","Poaceae","Poales",0,0,0,1,0,NA
"Farsetia","Brassicaceae","Brassicales",0,1,0,28,0,NA
"Fascicularia","Bromeliaceae","Poales",0,0,1,1,1,0
"Fatoua","Moraceae","Rosales",0,0,2,3,2,0
"Fatsia","Araliaceae","Apiales",1,0,0,3,1,1
"Faucaria","Aizoaceae","Caryophyllales",0,0,0,6,0,NA
"Faucherea","Sapotaceae","Ericales",2,0,0,11,2,1
"Faujasia","Asteraceae","Asterales",0,0,0,4,0,NA
"Faujasiopsis","Asteraceae","Asterales",0,0,0,3,0,NA
"Faurea","Proteaceae","Proteales",3,0,0,15,3,1
"Favratia","Campanulaceae","Asterales",0,0,0,1,0,NA
"Faxonia","Asteraceae","Asterales",0,0,0,1,0,NA
"Feddea","Asteraceae","Asterales",0,0,0,1,0,NA
"Fedia","Caprifoliaceae","Dipsacales",0,0,1,3,1,0
"Fedorovia","Campanulaceae","Asterales",0,0,0,2,0,NA
"Feea","Hymenophyllaceae","Hymenophyllales",0,0,0,1,0,NA
"Feeria","Campanulaceae","Asterales",0,0,0,1,0,NA
"Fegimanra","Anacardiaceae","Sapindales",0,0,0,3,0,NA
"Feldstonia","Asteraceae","Asterales",0,0,1,1,1,0
"Felicia","Asteraceae","Asterales",1,0,1,84,2,0.5
"Fendlera","Hydrangeaceae","Cornales",1,0,0,5,1,1
"Fendlerella","Hydrangeaceae","Cornales",1,0,0,3,1,1
"Fenerivia","Annonaceae","Magnoliales",0,0,0,8,0,NA
"Fenestraria","Aizoaceae","Caryophyllales",0,0,0,1,0,NA
"Fenixia","Asteraceae","Asterales",0,0,0,1,0,NA
"Ferdinanda","Bignoniaceae","Lamiales",0,0,0,1,0,NA
"Ferdinandusa","Rubiaceae","Gentianales",2,0,0,24,2,1
"Feretia","Rubiaceae","Gentianales",2,0,0,3,2,1
"Fergania","Apiaceae","Apiales",0,0,0,1,0,NA
"Fergusonia","Rubiaceae","Gentianales",0,0,0,1,0,NA
"Fernaldia","Apocynaceae","Gentianales",0,0,1,3,1,0
"Fernandezia","Orchidaceae","Asparagales",0,0,2,51,2,0
"Fernandoa","Bignoniaceae","Lamiales",3,0,0,15,3,1
"Fernelia","Rubiaceae","Gentianales",1,0,0,4,1,1
"Fernseea","Bromeliaceae","Poales",0,0,1,2,1,0
"Ferocactus","Cactaceae","Caryophyllales",0,0,0,24,0,NA
"Ferraria","Iridaceae","Asparagales",0,0,9,13,9,0
"Ferreyranthus","Asteraceae","Asterales",0,0,0,8,0,NA
"Ferreyrella","Asteraceae","Asterales",0,0,0,2,0,NA
"Ferrocalamus","Poaceae","Poales",0,0,0,1,0,NA
"Ferula","Apiaceae","Apiales",0,0,0,208,0,NA
"Ferulago","Apiaceae","Apiales",0,0,0,46,0,NA
"Ferulopsis","Apiaceae","Apiales",0,0,0,2,0,NA
"Fessia","Asparagaceae","Asparagales",0,0,0,11,0,NA
"Festuca","Poaceae","Poales",0,0,55,664,55,0
"Festulolium","Poaceae","Poales",0,0,0,6,0,NA
"Festulpia","Poaceae","Poales",0,0,0,2,0,NA
"Feuilleea","Fabaceae","Fabales",0,0,0,125,0,NA
"Fevillea","Cucurbitaceae","Cucurbitales",2,0,1,8,3,0.666666666666667
"Fezia","Brassicaceae","Brassicales",0,0,0,1,0,NA
"Fibigia","Brassicaceae","Brassicales",0,0,0,13,0,NA
"Fibraurea","Menispermaceae","Ranunculales",0,1,0,3,0,NA
"Ficalhoa","Sladeniaceae","Ericales",1,0,0,1,1,1
"Ficaria","Ranunculaceae","Ranunculales",0,0,1,4,1,0
"Ficinia","Cyperaceae","Poales",0,0,10,76,10,0
"Ficus","Moraceae","Rosales",132,1,0,841,132,1
"Fiebrigiella","Fabaceae","Fabales",0,0,0,1,0,NA
"Fieldia","Gesneriaceae","Lamiales",1,0,0,2,1,1
"Filago","Asteraceae","Asterales",0,0,2,56,2,0
"Filarum","Araceae","Alismatales",0,0,1,1,1,0
"Filetia","Acanthaceae","Lamiales",0,0,0,9,0,NA
"Filfia","Asteraceae","Asterales",0,0,0,1,0,NA
"Filgueirasia","Poaceae","Poales",0,0,0,2,0,NA
"Filicium","Sapindaceae","Sapindales",1,0,0,3,1,1
"Filicula","Dryopteridaceae","Polypodiales",0,0,0,1,0,NA
"Filifolium","Asteraceae","Asterales",0,0,1,1,1,0
"Filipendula","Rosaceae","Rosales",0,0,4,16,4,0
"Filix","Dryopteridaceae","Polypodiales",0,0,0,1,0,NA
"Filix-foemina","Dennstaedtiaceae","Polypodiales",0,0,0,1,0,NA
"Fillaeopsis","Fabaceae","Fabales",1,0,0,1,1,1
"Fimbristylis","Cyperaceae","Poales",0,0,59,306,59,0
"Fingalia","Asteraceae","Asterales",0,0,0,1,0,NA
"Fingerhuthia","Poaceae","Poales",0,0,2,2,2,0
"Finlaysonia","Apocynaceae","Gentianales",0,1,0,7,0,NA
"Finschia","Proteaceae","Proteales",0,0,0,4,0,NA
"Firmiana","Malvaceae","Malvales",5,0,0,16,5,1
"Fischeria","Apocynaceae","Gentianales",0,0,1,7,1,0
"Fissicalyx","Fabaceae","Fabales",1,0,0,1,1,1
"Fissistigma","Annonaceae","Magnoliales",3,0,0,65,3,1
"Fitchia","Asteraceae","Asterales",0,0,0,7,0,NA
"Fittingia","Primulaceae","Ericales",0,0,0,9,0,NA
"Fittonia","Acanthaceae","Lamiales",0,0,0,2,0,NA
"Fitzalania","Annonaceae","Magnoliales",1,0,0,2,1,1
"Fitzroya","Cupressaceae","Cupressales",1,0,0,1,1,1
"Fitzwillia","Asteraceae","Asterales",0,0,1,1,1,0
"Flabellaria","Malpighiaceae","Malpighiales",0,0,0,1,0,NA
"Flabellariopsis","Malpighiaceae","Malpighiales",1,0,0,1,1,1
"Flacourtia","Salicaceae","Malpighiales",9,0,0,22,9,1
"Flagellaria","Flagellariaceae","Poales",1,0,1,4,2,0.5
"Flagenium","Rubiaceae","Gentianales",1,0,0,6,1,1
"Flaveria","Asteraceae","Asterales",0,0,4,24,4,0
"Fleischmannia","Asteraceae","Asterales",0,0,0,100,0,NA
"Fleischmanniopsis","Asteraceae","Asterales",0,0,0,5,0,NA
"Flemingia","Fabaceae","Fabales",0,0,0,37,0,NA
"Fleroya","Rubiaceae","Gentianales",2,0,0,3,2,1
"Fleurydora","Ochnaceae","Malpighiales",0,0,0,1,0,NA
"Flexanthera","Rubiaceae","Gentianales",0,0,0,1,0,NA
"Flindersia","Rutaceae","Sapindales",15,0,0,17,15,1
"Floerkea","Limnanthaceae","Brassicales",0,0,1,1,1,0
"Florestina","Asteraceae","Asterales",0,0,1,8,1,0
"Floscaldasia","Asteraceae","Asterales",0,0,0,2,0,NA
"Floscopa","Commelinaceae","Commelinales",0,0,5,22,5,0
"Flosmutisia","Asteraceae","Asterales",0,0,0,1,0,NA
"Flourensia","Asteraceae","Asterales",3,0,0,33,3,1
"Floydia","Proteaceae","Proteales",1,0,0,1,1,1
"Flueggea","Phyllanthaceae","Malpighiales",8,0,0,16,8,1
"Flyriella","Asteraceae","Asterales",0,0,0,6,0,NA
"Fockea","Apocynaceae","Gentianales",0,1,0,6,0,NA
"Fockeanthus","Campanulaceae","Asterales",0,0,0,1,0,NA
"Foeniculum","Apiaceae","Apiales",0,0,1,3,1,0
"Foetidia","Lecythidaceae","Ericales",4,0,0,18,4,1
"Fokienia","Cupressaceae","Cupressales",1,0,0,1,1,1
"Foleyola","Brassicaceae","Brassicales",0,0,0,1,0,NA
"Fonkia","Scrophulariaceae","Lamiales",0,0,0,1,0,NA
"Fontainea","Euphorbiaceae","Malpighiales",4,0,0,9,4,1
"Fontanesia","Oleaceae","Lamiales",2,0,0,2,2,1
"Forchhammeria","Capparaceae","Brassicales",4,0,0,13,4,1
"Forcipella","Acanthaceae","Lamiales",0,0,0,6,0,NA
"Fordia","Fabaceae","Fabales",1,0,0,18,1,1
"Fordiophyton","Melastomataceae","Myrtales",0,0,0,9,0,NA
"Forestiera","Oleaceae","Lamiales",9,0,0,23,9,1
"Forgesia","Escalloniaceae","Escalloniales",1,0,0,1,1,1
"Formania","Asteraceae","Asterales",0,0,0,1,0,NA
"Forsskaolea","Urticaceae","Rosales",0,0,0,7,0,NA
"Forstera","Stylidiaceae","Asterales",0,0,5,7,5,0
"Forsteronia","Apocynaceae","Gentianales",5,2,0,45,5,1
"Forsythia","Oleaceae","Lamiales",4,0,0,13,4,1
"Fortunearia","Hamamelidaceae","Saxifragales",1,0,0,1,1,1
"Fortuynia","Brassicaceae","Brassicales",0,0,0,1,0,NA
"Fosbergia","Rubiaceae","Gentianales",0,0,0,4,0,NA
"Fosterella","Bromeliaceae","Poales",0,0,7,31,7,0
"Fothergilla","Hamamelidaceae","Saxifragales",2,0,0,2,2,1
"Fouquieria","Fouquieriaceae","Ericales",7,0,0,11,7,1
"Fourniera","Cyatheaceae","Cyatheales",0,0,0,1,0,NA
"Foveolina","Asteraceae","Asterales",0,0,1,4,1,0
"Fragaria","Rosaceae","Rosales",0,0,4,17,4,0
"Frailea","Cactaceae","Caryophyllales",2,0,0,20,2,1
"Franciscodendron","Malvaceae","Malvales",1,0,0,1,1,1
"Francoa","Melianthaceae","Geraniales",0,0,2,3,2,0
"Frangula","Rhamnaceae","Rosales",3,0,0,34,3,1
"Frankenia","Frankeniaceae","Caryophyllales",8,1,3,73,11,0.727272727272727
"Franklandia","Proteaceae","Proteales",2,0,0,2,2,1
"Franklinia","Theaceae","Ericales",1,0,0,1,1,1
"Franseria","Asteraceae","Asterales",0,0,0,2,0,NA
"Frasera","Gentianaceae","Gentianales",0,0,0,15,0,NA
"Fraunhofera","Celastraceae","Celastrales",0,0,0,1,0,NA
"Fraxinus","Oleaceae","Lamiales",34,0,0,63,34,1
"Freesia","Iridaceae","Asparagales",0,0,5,16,5,0
"Fremontodendron","Malvaceae","Malvales",2,0,0,2,2,1
"Frerea","Apocynaceae","Gentianales",0,0,0,1,0,NA
"Freya","Asteraceae","Asterales",0,0,0,1,0,NA
"Freycinetia","Pandanaceae","Pandanales",43,0,0,308,43,1
"Freylinia","Scrophulariaceae","Lamiales",1,0,2,8,3,0.333333333333333
"Freziera","Pentaphylacaceae","Ericales",3,0,0,44,3,1
"Fridericia","Bignoniaceae","Lamiales",21,0,0,68,21,1
"Friesodielsia","Annonaceae","Magnoliales",2,0,0,47,2,1
"Frigidorchis","Orchidaceae","Asparagales",0,0,0,1,0,NA
"Frithia","Aizoaceae","Caryophyllales",0,0,0,2,0,NA
"Fritillaria","Liliaceae","Liliales",0,0,31,141,31,0
"Fritzschia","Melastomataceae","Myrtales",0,0,0,3,0,NA
"Froelichia","Amaranthaceae","Caryophyllales",0,0,1,15,1,0
"Froelichiella","Amaranthaceae","Caryophyllales",0,0,0,1,0,NA
"Froesia","Ochnaceae","Malpighiales",1,0,0,5,1,1
"Froesiochloa","Poaceae","Poales",0,0,0,1,0,NA
"Froesiodendron","Annonaceae","Magnoliales",0,0,0,3,0,NA
"Frolovia","Asteraceae","Asterales",0,0,0,1,0,NA
"Frommia","Apiaceae","Apiales",0,0,0,1,0,NA
"Frondaria","Orchidaceae","Asparagales",0,0,1,1,1,0
"Froriepia","Apiaceae","Apiales",0,0,0,2,0,NA
"Fryxellia","Malvaceae","Malvales",0,0,0,1,0,NA
"Fuchsia","Onagraceae","Myrtales",27,0,1,113,28,0.964285714285714
"Fuernrohria","Apiaceae","Apiales",0,0,0,1,0,NA
"Fuerstia","Lamiaceae","Lamiales",0,0,0,9,0,NA
"Fuertesia","Loasaceae","Cornales",0,1,0,1,0,NA
"Fuertesiella","Orchidaceae","Asparagales",0,0,0,1,0,NA
"Fuertesimalva","Malvaceae","Malvales",0,0,0,14,0,NA
"Fuirena","Cyperaceae","Poales",0,0,16,59,16,0
"Fulcaldea","Asteraceae","Asterales",0,0,0,1,0,NA
"Fumana","Cistaceae","Malvales",3,0,0,19,3,1
"Fumaria","Papaveraceae","Ranunculales",0,0,4,57,4,0
"Fumariola","Papaveraceae","Ranunculales",0,0,0,1,0,NA
"Funastrum","Apocynaceae","Gentianales",0,0,0,2,0,NA
"Funifera","Thymelaeaceae","Malvales",0,0,0,4,0,NA
"Funkiella","Orchidaceae","Asparagales",0,0,0,4,0,NA
"Funtumia","Apocynaceae","Gentianales",2,0,0,2,2,1
"Furcraea","Asparagaceae","Asparagales",0,0,4,23,4,0
"Furtadoa","Araceae","Alismatales",0,0,1,2,1,0
"Fusaea","Annonaceae","Magnoliales",2,0,0,3,2,1
"Fusifilum","Asparagaceae","Asparagales",0,0,0,15,0,NA
"Fusispermum","Violaceae","Malpighiales",0,0,0,3,0,NA
"Gaertnera","Rubiaceae","Gentianales",4,0,0,71,4,1
"Gagea","Liliaceae","Liliales",0,0,11,209,11,0
"Gagnebina","Fabaceae","Fabales",4,0,0,6,4,1
"Gagnepainia","Zingiberaceae","Zingiberales",0,0,0,3,0,NA
"Gahnia","Cyperaceae","Poales",0,0,21,40,21,0
"Gaiadendron","Loranthaceae","Santalales",1,0,0,1,1,1
"Gaillardia","Asteraceae","Asterales",0,0,2,24,2,0
"Gaimardia","Centrolepidaceae","Poales",0,0,0,4,0,NA
"Gajanus","Fabaceae","Fabales",0,0,0,2,0,NA
"Galactia","Fabaceae","Fabales",1,0,2,113,3,0.333333333333333
"Galactites","Asteraceae","Asterales",0,0,0,4,0,NA
"Galactophora","Apocynaceae","Gentianales",1,0,0,6,1,1
"Galagania","Apiaceae","Apiales",0,0,0,4,0,NA
"Galanthus","Amaryllidaceae","Asparagales",0,0,8,21,8,0
"Galatella","Asteraceae","Asterales",0,0,0,34,0,NA
"Galax","Diapensiaceae","Ericales",0,0,1,1,1,0
"Galbulimima","Himantandraceae","Magnoliales",1,0,0,1,1,1
"Galeana","Asteraceae","Asterales",0,0,1,2,1,0
"Galeandra","Orchidaceae","Asparagales",0,0,1,39,1,0
"Galearia","Pandaceae","Malpighiales",3,0,0,5,3,1
"Galearis","Orchidaceae","Asparagales",0,0,1,9,1,0
"Galega","Fabaceae","Fabales",0,0,1,5,1,0
"Galenia","Aizoaceae","Caryophyllales",0,1,0,28,0,NA
"Galeoglossum","Orchidaceae","Asparagales",0,0,0,3,0,NA
"Galeola","Orchidaceae","Asparagales",0,0,1,6,1,0
"Galeomma","Asteraceae","Asterales",0,0,0,2,0,NA
"Galeopsis","Lamiaceae","Lamiales",0,0,3,14,3,0
"Galeottia","Orchidaceae","Asparagales",0,0,5,12,5,0
"Galeottiella","Orchidaceae","Asparagales",0,0,0,2,0,NA
"Galianthe","Rubiaceae","Gentianales",0,0,0,48,0,NA
"Galiniera","Rubiaceae","Gentianales",1,0,0,2,1,1
"Galinsoga","Asteraceae","Asterales",0,0,2,15,2,0
"Galipea","Rutaceae","Sapindales",1,0,0,16,1,1
"Galitzkya","Brassicaceae","Brassicales",0,0,0,3,0,NA
"Galium","Rubiaceae","Gentianales",3,0,44,659,47,0.0638297872340425
"Gallardoa","Malpighiaceae","Malpighiales",1,0,0,1,1,1
"Gallesia","Phytolaccaceae","Caryophyllales",1,0,0,1,1,1
"Gallienia","Rubiaceae","Gentianales",1,0,0,1,1,1
"Galopina","Rubiaceae","Gentianales",1,0,0,4,1,1
"Galphimia","Malpighiaceae","Malpighiales",2,0,0,27,2,1
"Galpinia","Lythraceae","Myrtales",0,0,0,1,0,NA
"Galtonia","Asparagaceae","Asparagales",0,0,0,1,0,NA
"Galvezia","Plantaginaceae","Lamiales",1,0,0,5,1,1
"Gamanthera","Lauraceae","Laurales",0,0,0,1,0,NA
"Gamanthus","Amaranthaceae","Caryophyllales",0,0,0,5,0,NA
"Gambelia","Plantaginaceae","Lamiales",1,0,0,4,1,1
"Gamblea","Araliaceae","Apiales",2,0,0,4,2,1
"Gamocarpha","Calyceraceae","Asterales",0,0,0,7,0,NA
"Gamochaeta","Asteraceae","Asterales",0,0,1,48,1,0
"Gamochaetopsis","Asteraceae","Asterales",0,0,0,1,0,NA
"Ganguelia","Rubiaceae","Gentianales",0,0,0,1,0,NA
"Ganophyllum","Sapindaceae","Sapindales",2,0,0,2,2,1
"Gaoligongshania","Poaceae","Poales",0,0,0,1,0,NA
"Garberia","Asteraceae","Asterales",0,0,0,1,0,NA
"Garcia","Euphorbiaceae","Malpighiales",2,0,0,2,2,1
"Garciadelia","Euphorbiaceae","Malpighiales",0,0,0,4,0,NA
"Garcibarrigoa","Asteraceae","Asterales",0,0,0,2,0,NA
"Garcilassa","Asteraceae","Asterales",0,0,0,1,0,NA
"Garcinia","Clusiaceae","Malpighiales",70,0,0,390,70,1
"Gardenia","Rubiaceae","Gentianales",24,0,1,134,25,0.96
"Gardeniopsis","Rubiaceae","Gentianales",0,0,0,1,0,NA
"Gardneria","Loganiaceae","Gentianales",1,0,0,7,1,1
"Gardnerina","Asteraceae","Asterales",0,0,0,1,0,NA
"Garhadiolus","Asteraceae","Asterales",0,0,0,4,0,NA
"Garnieria","Proteaceae","Proteales",1,0,0,1,1,1
"Garnotia","Poaceae","Poales",0,0,6,31,6,0
"Garrettia","Lamiaceae","Lamiales",0,0,0,1,0,NA
"Garrya","Garryaceae","Garryales",11,0,0,15,11,1
"Garuga","Burseraceae","Sapindales",3,0,0,4,3,1
"Garuleum","Asteraceae","Asterales",0,0,1,8,1,0
"Gasteranthus","Gesneriaceae","Lamiales",0,1,1,38,1,0
"Gasteria","Xanthorrhoeaceae","Asparagales",0,0,7,26,7,0
"Gastridium","Poaceae","Poales",0,0,1,2,1,0
"Gastrocalyx","Caryophyllaceae","Caryophyllales",0,0,0,1,0,NA
"Gastrochilus","Orchidaceae","Asparagales",0,0,0,57,0,NA
"Gastrocotyle","Boraginaceae","UnknownOrder-Boraginaceae",0,0,0,3,0,NA
"Gastrodia","Orchidaceae","Asparagales",0,0,0,60,0,NA
"Gastrolepis","Stemonuraceae","Aquifoliales",1,0,0,2,1,1
"Gastrolobium","Fabaceae","Fabales",1,0,0,105,1,1
"Gastrolychnis","Caryophyllaceae","Caryophyllales",0,0,0,2,0,NA
"Gastrorchis","Orchidaceae","Asparagales",0,0,0,8,0,NA
"Gatyona","Asteraceae","Asterales",0,0,0,1,0,NA
"Gaudichaudia","Malpighiaceae","Malpighiales",3,1,0,21,3,1
"Gaudinia","Poaceae","Poales",0,0,1,4,1,0
"Gaultheria","Ericaceae","Ericales",65,0,0,141,65,1
"Gaura","Onagraceae","Myrtales",0,0,1,21,1,0
"Gaussia","Arecaceae","Arecales",5,0,0,5,5,1
"Gavilea","Orchidaceae","Asparagales",0,0,1,15,1,0
"Gaya","Malvaceae","Malvales",0,0,0,37,0,NA
"Gaylussacia","Ericaceae","Ericales",3,0,0,56,3,1
"Gayophytum","Onagraceae","Myrtales",0,0,0,9,0,NA
"Gazania","Asteraceae","Asterales",0,0,2,19,2,0
"Gearum","Araceae","Alismatales",0,0,1,1,1,0
"Geesinkorchis","Orchidaceae","Asparagales",0,0,1,4,1,0
"Geigeria","Asteraceae","Asterales",1,0,0,30,1,1
"Geijera","Rutaceae","Sapindales",3,0,0,8,3,1
"Geissanthus","Primulaceae","Ericales",0,0,0,51,0,NA
"Geissaspis","Fabaceae","Fabales",0,0,0,4,0,NA
"Geissois","Cunoniaceae","Oxalidales",7,0,0,20,7,1
"Geissolepis","Asteraceae","Asterales",0,0,0,1,0,NA
"Geissoloma","Geissolomataceae","Crossosomatales",0,0,0,1,0,NA
"Geissomeria","Acanthaceae","Lamiales",0,0,0,17,0,NA
"Geissorhiza","Iridaceae","Asparagales",0,0,12,97,12,0
"Geissospermum","Apocynaceae","Gentianales",3,0,0,6,3,1
"Geitonoplesium","Xanthorrhoeaceae","Asparagales",0,0,1,2,1,0
"Gelasia","Asteraceae","Asterales",0,0,0,2,0,NA
"Gelasine","Iridaceae","Asparagales",0,0,2,7,2,0
"Geleznowia","Rutaceae","Sapindales",0,0,0,1,0,NA
"Gelidocalamus","Poaceae","Poales",0,0,0,12,0,NA
"Gelonium","Euphorbiaceae","Malpighiales",0,0,0,1,0,NA
"Gelsemium","Gelsemiaceae","Gentianales",1,1,0,4,1,1
"Genianthus","Apocynaceae","Gentianales",0,0,0,18,0,NA
"Geniostemon","Gentianaceae","Gentianales",0,0,0,5,0,NA
"Geniostoma","Loganiaceae","Gentianales",3,0,0,30,3,1
"Genipa","Rubiaceae","Gentianales",2,0,0,4,2,1
"Genista","Fabaceae","Fabales",20,0,0,125,20,1
"Genistidium","Fabaceae","Fabales",1,0,0,1,1,1
"Genlisea","Lentibulariaceae","Lamiales",0,0,0,19,0,NA
"Gennaria","Orchidaceae","Asparagales",0,0,1,1,1,0
"Genoplesium","Orchidaceae","Asparagales",0,0,1,47,1,0
"Gentiana","Gentianaceae","Gentianales",0,0,11,359,11,0
"Gentianella","Gentianaceae","Gentianales",1,0,7,295,8,0.125
"Gentianopsis","Gentianaceae","Gentianales",0,0,0,23,0,NA
"Gentianothamnus","Gentianaceae","Gentianales",0,0,0,1,0,NA
"Gentingia","Rubiaceae","Gentianales",0,0,0,1,0,NA
"Genyorchis","Orchidaceae","Asparagales",0,0,0,10,0,NA
"Geoblasta","Orchidaceae","Asparagales",0,0,0,1,0,NA
"Geocarpon","Caryophyllaceae","Caryophyllales",0,0,0,1,0,NA
"Geocaryum","Apiaceae","Apiales",0,0,0,8,0,NA
"Geocaulon","Santalaceae","Santalales",0,0,1,1,1,0
"Geocharis","Zingiberaceae","Zingiberales",0,0,0,6,0,NA
"Geochloa","Poaceae","Poales",0,0,0,3,0,NA
"Geochorda","Plantaginaceae","Lamiales",0,0,0,1,0,NA
"Geococcus","Brassicaceae","Brassicales",0,0,0,1,0,NA
"Geodorum","Orchidaceae","Asparagales",0,0,0,12,0,NA
"Geoffroea","Fabaceae","Fabales",2,0,0,4,2,1
"Geogenanthus","Commelinaceae","Commelinales",0,0,1,3,1,0
"Geohintonia","Cactaceae","Caryophyllales",0,0,0,1,0,NA
"Geomitra","Burmanniaceae","Dioscoreales",0,0,0,1,0,NA
"Geonoma","Arecaceae","Arecales",35,0,0,69,35,1
"Geophila","Rubiaceae","Gentianales",0,0,1,27,1,0
"Georgeantha","Ecdeiocoleaceae","Poales",0,0,1,1,1,0
"Geosiris","Iridaceae","Asparagales",0,0,0,1,0,NA
"Geostachys","Zingiberaceae","Zingiberales",0,0,0,25,0,NA
"Geraea","Asteraceae","Asterales",0,0,1,2,1,0
"Geranium","Geraniaceae","Geraniales",3,0,31,415,34,0.0882352941176471
"Gerardia","Orobanchaceae","Lamiales",0,0,0,2,0,NA
"Gerardiina","Orobanchaceae","Lamiales",0,0,0,2,0,NA
"Gerbera","Asteraceae","Asterales",0,0,2,40,2,0
"Gereaua","Sapindaceae","Sapindales",0,0,0,1,0,NA
"Germainia","Poaceae","Poales",0,0,0,9,0,NA
"Geropogon","Asteraceae","Asterales",0,0,0,1,0,NA
"Gerrardanthus","Cucurbitaceae","Cucurbitales",0,2,0,5,0,NA
"Gerrardina","Gerrardinaceae","Huerteales",1,0,0,2,1,1
"Gerritea","Poaceae","Poales",0,0,0,1,0,NA
"Gesneria","Gesneriaceae","Lamiales",6,0,0,54,6,1
"Gesnouinia","Urticaceae","Rosales",0,0,0,2,0,NA
"Gethyllis","Amaryllidaceae","Asparagales",0,0,2,31,2,0
"Getonia","Combretaceae","Myrtales",1,0,0,1,1,1
"Geum","Rosaceae","Rosales",1,0,7,35,8,0.125
"Gevuina","Proteaceae","Proteales",1,0,0,1,1,1
"Ghikaea","Orobanchaceae","Lamiales",0,0,0,1,0,NA
"Gibasis","Commelinaceae","Commelinales",0,0,1,14,1,0
"Gibasoides","Commelinaceae","Commelinales",0,0,0,1,0,NA
"Gibbaeum","Aizoaceae","Caryophyllales",0,0,0,23,0,NA
"Gibbaria","Asteraceae","Asterales",0,0,0,1,0,NA
"Gibbsia","Urticaceae","Rosales",0,0,0,2,0,NA
"Gibsoniothamnus","Schlegeliaceae","Lamiales",0,0,0,12,0,NA
"Gigantochloa","Poaceae","Poales",0,0,0,55,0,NA
"Gigasiphon","Fabaceae","Fabales",0,0,0,4,0,NA
"Gilberta","Asteraceae","Asterales",0,0,1,1,1,0
"Gilbertiella","Annonaceae","Magnoliales",0,0,0,1,0,NA
"Gilbertiodendron","Fabaceae","Fabales",9,0,0,27,9,1
"Gilesia","Malvaceae","Malvales",0,0,0,1,0,NA
"Gilgiochloa","Poaceae","Poales",0,0,0,1,0,NA
"Gilia","Polemoniaceae","Ericales",0,0,2,40,2,0
"Giliastrum","Polemoniaceae","Ericales",0,0,2,9,2,0
"Gillbeea","Cunoniaceae","Oxalidales",1,0,0,3,1,1
"Gillespiea","Rubiaceae","Gentianales",0,0,0,1,0,NA
"Gilletiodendron","Fabaceae","Fabales",3,0,0,5,3,1
"Gilliesia","Amaryllidaceae","Asparagales",0,0,1,7,1,0
"Gilmania","Polygonaceae","Caryophyllales",0,0,0,1,0,NA
"Gilruthia","Asteraceae","Asterales",0,0,1,1,1,0
"Ginalloa","Santalaceae","Santalales",1,0,0,9,1,1
"Gingidia","Apiaceae","Apiales",0,0,2,10,2,0
"Ginkgo","Ginkgoaceae","Ginkgoales",1,0,0,1,1,1
"Ginoria","Lythraceae","Myrtales",0,0,0,13,0,NA
"Girardinia","Urticaceae","Rosales",0,0,0,3,0,NA
"Girgensohnia","Amaranthaceae","Caryophyllales",0,0,1,5,1,0
"Gironniera","Cannabaceae","Rosales",4,0,0,6,4,1
"Gisekia","Gisekiaceae","Caryophyllales",0,0,0,7,0,NA
"Githopsis","Campanulaceae","Asterales",0,0,0,4,0,NA
"Givotia","Euphorbiaceae","Malpighiales",2,0,0,4,2,1
"Gjellerupia","Opiliaceae","Santalales",0,0,0,1,0,NA
"Gladiolus","Iridaceae","Asparagales",0,0,138,280,138,0
"Gladiopappus","Asteraceae","Asterales",0,0,0,1,0,NA
"Glandonia","Malpighiaceae","Malpighiales",1,0,0,3,1,1
"Glandora","Boraginaceae","UnknownOrder-Boraginaceae",0,0,1,6,1,0
"Glandularia","Verbenaceae","Lamiales",0,0,1,80,1,0
"Glaphyropteridopsis","Thelypteridaceae","Polypodiales",0,0,0,11,0,NA
"Glastaria","Brassicaceae","Brassicales",0,0,0,1,0,NA
"Glaucidium","Ranunculaceae","Ranunculales",0,0,1,1,1,0
"Glaucium","Papaveraceae","Ranunculales",0,0,2,25,2,0
"Glaucocarpum","Brassicaceae","Brassicales",0,1,0,1,0,NA
"Glaucosciadium","Apiaceae","Apiales",0,0,0,2,0,NA
"Glaziophyton","Poaceae","Poales",0,0,0,1,0,NA
"Gleadovia","Orobanchaceae","Lamiales",0,0,0,4,0,NA
"Gleasonia","Rubiaceae","Gentianales",0,0,0,5,0,NA
"Glebionis","Asteraceae","Asterales",0,0,0,2,0,NA
"Glechoma","Lamiaceae","Lamiales",0,0,1,8,1,0
"Glechon","Lamiaceae","Lamiales",0,0,0,8,0,NA
"Gleditsia","Fabaceae","Fabales",10,0,0,15,10,1
"Glehnia","Apiaceae","Apiales",0,0,1,1,1,0
"Gleichenella","Gleicheniaceae","Gleicheniales",0,0,0,1,0,NA
"Gleichenia","Gleicheniaceae","Gleicheniales",0,0,5,17,5,0
"Glekia","Scrophulariaceae","Lamiales",0,0,1,1,1,0
"Glenniea","Sapindaceae","Sapindales",1,0,0,8,1,1
"Glia","Apiaceae","Apiales",0,0,0,3,0,NA
"Glinus","Molluginaceae","Caryophyllales",0,0,0,10,0,NA
"Glionnetia","Rubiaceae","Gentianales",0,0,0,1,0,NA
"Gliricidia","Fabaceae","Fabales",3,0,0,4,3,1
"Glischrocaryon","Haloragaceae","Saxifragales",0,0,0,5,0,NA
"Glischrocolla","Penaeaceae","Myrtales",1,0,0,1,1,1
"Glischrothamnus","Molluginaceae","Caryophyllales",0,0,0,1,0,NA
"Globba","Zingiberaceae","Zingiberales",0,0,3,98,3,0
"Globimetula","Loranthaceae","Santalales",1,0,0,13,1,1
"Globularia","Plantaginaceae","Lamiales",3,0,2,31,5,0.6
"Globulariopsis","Scrophulariaceae","Lamiales",0,0,0,7,0,NA
"Glochidion","Phyllanthaceae","Malpighiales",21,0,0,273,21,1
"Glochidotheca","Apiaceae","Apiales",0,0,0,1,0,NA
"Gloeocarpus","Sapindaceae","Sapindales",1,0,0,1,1,1
"Gloeospermum","Violaceae","Malpighiales",2,0,0,18,2,1
"Glomera","Orchidaceae","Asparagales",0,0,1,131,1,0
"Glomeropitcairnia","Bromeliaceae","Poales",0,0,2,2,2,0
"Gloriosa","Colchicaceae","Liliales",0,0,0,10,0,NA
"Glossarion","Asteraceae","Asterales",0,0,0,2,0,NA
"Glossocalyx","Siparunaceae","Laurales",1,0,0,1,1,1
"Glossocardia","Asteraceae","Asterales",0,0,0,12,0,NA
"Glossocarya","Lamiaceae","Lamiales",2,0,0,10,2,1
"Glossochilus","Acanthaceae","Lamiales",0,0,0,2,0,NA
"Glossodia","Orchidaceae","Asparagales",0,0,2,2,2,0
"Glossogyne","Asteraceae","Asterales",0,0,0,2,0,NA
"Glossoloma","Gesneriaceae","Lamiales",2,0,0,27,2,1
"Glossonema","Apocynaceae","Gentianales",0,0,0,4,0,NA
"Glossopappus","Asteraceae","Asterales",0,0,0,1,0,NA
"Glossopetalon","Crossosomataceae","Crossosomatales",2,0,0,4,2,1
"Glossostelma","Apocynaceae","Gentianales",0,0,0,12,0,NA
"Glossostemon","Malvaceae","Malvales",1,0,0,1,1,1
"Glossostigma","Phrymaceae","Lamiales",0,0,0,6,0,NA
"Glossostipula","Rubiaceae","Gentianales",1,0,0,3,1,1
"Glottidium","Fabaceae","Fabales",0,0,0,1,0,NA
"Glottiphyllum","Aizoaceae","Caryophyllales",0,0,0,19,0,NA
"Gloxinella","Gesneriaceae","Lamiales",0,0,0,1,0,NA
"Gloxinia","Gesneriaceae","Lamiales",0,0,1,4,1,0
"Gloxiniopsis","Gesneriaceae","Lamiales",0,0,0,1,0,NA
"Gluema","Sapotaceae","Ericales",1,0,0,2,1,1
"Glumicalyx","Scrophulariaceae","Lamiales",0,0,0,6,0,NA
"Gluta","Anacardiaceae","Sapindales",18,0,0,34,18,1
"Glyceria","Poaceae","Poales",0,0,13,47,13,0
"Glycine","Fabaceae","Fabales",1,0,4,16,5,0.2
"Glycinopsis","Fabaceae","Fabales",0,0,0,4,0,NA
"Glycosmis","Rutaceae","Sapindales",2,0,0,51,2,1
"Glycydendron","Euphorbiaceae","Malpighiales",1,0,0,2,1,1
"Glycyrrhiza","Fabaceae","Fabales",0,0,7,21,7,0
"Glycyrrhizopsis","Fabaceae","Fabales",0,0,0,1,0,NA
"Glyphaea","Malvaceae","Malvales",1,0,0,2,1,1
"Glyphochloa","Poaceae","Poales",0,0,0,9,0,NA
"Glyphotaenium","Polypodiaceae","Polypodiales",0,0,0,1,0,NA
"Glyptopetalum","Celastraceae","Celastrales",0,0,0,34,0,NA
"Glyptopleura","Asteraceae","Asterales",0,0,0,2,0,NA
"Glyptostrobus","Cupressaceae","Cupressales",1,0,0,1,1,1
"Gmelina","Lamiaceae","Lamiales",12,0,0,38,12,1
"Gnaphalium","Asteraceae","Asterales",0,0,4,122,4,0
"Gnephosis","Asteraceae","Asterales",0,0,2,17,2,0
"Gnetum","Gnetaceae","Gnetales",16,0,0,41,16,1
"Gnidia","Thymelaeaceae","Malvales",16,0,0,153,16,1
"Gnomophalium","Asteraceae","Asterales",0,0,0,1,0,NA
"Gochnatia","Asteraceae","Asterales",3,0,0,69,3,1
"Godmania","Bignoniaceae","Lamiales",1,0,0,2,1,1
"Godoya","Ochnaceae","Malpighiales",0,0,0,2,0,NA
"Goerkemia","Brassicaceae","Brassicales",0,0,0,1,0,NA
"Goethalsia","Malvaceae","Malvales",1,0,0,1,1,1
"Goetzea","Solanaceae","Solanales",2,0,0,2,2,1
"Goldbachia","Brassicaceae","Brassicales",0,0,1,7,1,0
"Goldmanella","Asteraceae","Asterales",0,0,0,1,0,NA
"Gomesa","Orchidaceae","Asparagales",0,0,1,124,1,0
"Gomidesia","Myrtaceae","Myrtales",0,0,0,1,0,NA
"Gomortega","Gomortegaceae","Laurales",1,0,0,1,1,1
"Gomphandra","Stemonuraceae","Aquifoliales",5,0,0,37,5,1
"Gomphia","Ochnaceae","Malpighiales",2,0,0,28,2,1
"Gomphichis","Orchidaceae","Asparagales",0,0,0,24,0,NA
"Gomphocalyx","Rubiaceae","Gentianales",0,0,0,1,0,NA
"Gomphocarpus","Apocynaceae","Gentianales",0,0,2,21,2,0
"Gomphogyne","Cucurbitaceae","Cucurbitales",0,0,0,6,0,NA
"Gompholobium","Fabaceae","Fabales",6,0,0,35,6,1
"Gomphostemma","Lamiaceae","Lamiales",0,0,1,39,1,0
"Gomphostigma","Scrophulariaceae","Lamiales",0,0,1,2,1,0
"Gomphrena","Amaranthaceae","Caryophyllales",0,0,6,133,6,0
"Gonatogyne","Phyllanthaceae","Malpighiales",1,0,0,1,1,1
"Gonatopus","Araceae","Alismatales",0,0,2,5,2,0
"Gonatostylis","Orchidaceae","Asparagales",0,0,1,2,1,0
"Gongora","Orchidaceae","Asparagales",0,0,8,74,8,0
"Gongrodiscus","Sapindaceae","Sapindales",0,0,0,3,0,NA
"Gongronema","Apocynaceae","Gentianales",0,0,0,16,0,NA
"Gongrospermum","Sapindaceae","Sapindales",0,0,0,1,0,NA
"Gongrostylus","Asteraceae","Asterales",0,0,0,2,0,NA
"Gongrothamnus","Asteraceae","Asterales",0,0,0,1,0,NA
"Gongylocarpus","Onagraceae","Myrtales",0,0,0,2,0,NA
"Gongylolepis","Asteraceae","Asterales",0,0,0,15,0,NA
"Gongylosciadium","Apiaceae","Apiales",0,0,0,1,0,NA
"Gongylotaxis","Apiaceae","Apiales",0,0,0,1,0,NA
"Goniocaulon","Asteraceae","Asterales",0,0,0,1,0,NA
"Goniodiscus","Celastraceae","Celastrales",1,0,0,1,1,1
"Goniolimon","Plumbaginaceae","Caryophyllales",0,0,1,20,1,0
"Gonioma","Apocynaceae","Gentianales",1,0,0,2,1,1
"Goniophlebium","Polypodiaceae","Polypodiales",0,0,0,14,0,NA
"Goniopteris","Thelypteridaceae","Polypodiales",0,0,0,7,0,NA
"Goniorrhachis","Fabaceae","Fabales",1,0,0,1,1,1
"Goniostemma","Apocynaceae","Gentianales",0,0,0,2,0,NA
"Goniothalamus","Annonaceae","Magnoliales",10,0,0,133,10,1
"Gonocalyx","Ericaceae","Ericales",0,0,0,11,0,NA
"Gonocarpus","Haloragaceae","Saxifragales",1,0,4,42,5,0.2
"Gonocaryum","Cardiopteridaceae","Aquifoliales",2,0,0,11,2,1
"Gonocormus","Hymenophyllaceae","Hymenophyllales",0,0,0,2,0,NA
"Gonocrypta","Apocynaceae","Gentianales",0,0,0,1,0,NA
"Gonocytisus","Fabaceae","Fabales",1,0,0,3,1,1
"Gonolobus","Apocynaceae","Gentianales",0,0,0,132,0,NA
"Gonospermum","Asteraceae","Asterales",0,0,0,5,0,NA
"Gonostegia","Urticaceae","Rosales",0,0,0,4,0,NA
"Gonostemon","Apocynaceae","Gentianales",0,0,0,3,0,NA
"Gontscharovia","Lamiaceae","Lamiales",0,0,0,1,0,NA
"Gonystylus","Thymelaeaceae","Malvales",13,0,0,32,13,1
"Gonzalagunia","Rubiaceae","Gentianales",2,0,0,40,2,1
"Goodallia","Thymelaeaceae","Malvales",0,0,0,1,0,NA
"Goodenia","Goodeniaceae","Asterales",1,0,81,201,82,0.0121951219512195
"Goodia","Fabaceae","Fabales",1,0,0,2,1,1
"Goodmania","Polygonaceae","Caryophyllales",0,0,0,1,0,NA
"Goodyera","Orchidaceae","Asparagales",0,0,3,99,3,0
"Gorceixia","Asteraceae","Asterales",0,0,0,1,0,NA
"Gordonia","Theaceae","Ericales",12,0,0,62,12,1
"Gorgonidium","Araceae","Alismatales",0,0,3,8,3,0
"Gorodkovia","Brassicaceae","Brassicales",0,0,0,1,0,NA
"Gorteria","Asteraceae","Asterales",0,0,1,3,1,0
"Gosela","Scrophulariaceae","Lamiales",0,0,0,1,0,NA
"Gossia","Myrtaceae","Myrtales",5,0,0,37,5,1
"Gossweilera","Asteraceae","Asterales",0,0,0,2,0,NA
"Gossweilerodendron","Fabaceae","Fabales",2,0,0,2,2,1
"Gossypioides","Malvaceae","Malvales",1,0,0,2,1,1
"Gossypium","Malvaceae","Malvales",15,1,1,54,16,0.9375
"Gouania","Rhamnaceae","Rosales",3,0,0,73,3,1
"Gouinia","Poaceae","Poales",0,0,0,14,0,NA
"Goupia","Goupiaceae","Malpighiales",1,0,0,2,1,1
"Govenia","Orchidaceae","Asparagales",0,0,1,24,1,0
"Goyazia","Gesneriaceae","Lamiales",0,0,1,2,1,0
"Goyazianthus","Asteraceae","Asterales",0,0,0,1,0,NA
"Goydera","Apocynaceae","Gentianales",0,0,0,1,0,NA
"Grabowskia","Solanaceae","Solanales",1,0,0,5,1,1
"Graderia","Orobanchaceae","Lamiales",1,0,0,4,1,1
"Graellsia","Brassicaceae","Brassicales",0,0,1,8,1,0
"Graffenrieda","Melastomataceae","Myrtales",2,1,0,54,2,1
"Grafia","Apiaceae","Apiales",0,0,0,1,0,NA
"Grahamia","Anacampserotaceae","Caryophyllales",0,0,1,2,1,0
"Grajalesia","Nyctaginaceae","Caryophyllales",0,0,0,1,0,NA
"Grammangis","Orchidaceae","Asparagales",0,0,0,2,0,NA
"Grammatophyllum","Orchidaceae","Asparagales",0,0,1,12,1,0
"Grammatotheca","Campanulaceae","Asterales",0,0,1,1,1,0
"Grammica","Convolvulaceae","Solanales",0,0,0,14,0,NA
"Grammitis","Polypodiaceae","Polypodiales",0,0,0,112,0,NA
"Grammosciadium","Apiaceae","Apiales",0,0,0,8,0,NA
"Grammosolen","Solanaceae","Solanales",2,0,0,2,2,1
"Granatum","Meliaceae","Sapindales",0,0,0,1,0,NA
"Grandidiera","Achariaceae","Malpighiales",0,0,0,1,0,NA
"Grandiphyllum","Orchidaceae","Asparagales",0,0,0,7,0,NA
"Grangea","Asteraceae","Asterales",0,0,0,8,0,NA
"Grangeopsis","Asteraceae","Asterales",0,0,0,1,0,NA
"Grangeria","Chrysobalanaceae","Malpighiales",2,0,0,2,2,1
"Granitites","Rhamnaceae","Rosales",1,0,0,1,1,1
"Grantia","Asteraceae","Asterales",0,0,0,2,0,NA
"Graphandra","Acanthaceae","Lamiales",0,0,0,1,0,NA
"Graphephorum","Poaceae","Poales",0,0,0,2,0,NA
"Graphistemma","Apocynaceae","Gentianales",0,0,0,1,0,NA
"Graphistylis","Asteraceae","Asterales",1,0,0,9,1,1
"Graphorchis","Orchidaceae","Asparagales",0,0,0,2,0,NA
"Graphorkis","Orchidaceae","Asparagales",0,0,1,4,1,0
"Graptopetalum","Crassulaceae","Saxifragales",0,0,0,18,0,NA
"Graptophyllum","Acanthaceae","Lamiales",1,0,0,15,1,1
"Graptoveria","Crassulaceae","Saxifragales",0,0,0,2,0,NA
"Grastidium","Orchidaceae","Asparagales",0,0,0,1,0,NA
"Gratiola","Plantaginaceae","Lamiales",0,0,7,28,7,0
"Gratwickia","Asteraceae","Asterales",0,0,0,1,0,NA
"Grauanthus","Asteraceae","Asterales",0,0,0,2,0,NA
"Gravesia","Melastomataceae","Myrtales",1,0,0,109,1,1
"Grayia","Amaranthaceae","Caryophyllales",1,0,0,3,1,1
"Grazielanthus","Monimiaceae","Laurales",0,0,0,1,0,NA
"Grazielia","Asteraceae","Asterales",1,0,0,10,1,1
"Grazielodendron","Fabaceae","Fabales",0,0,0,1,0,NA
"Greenea","Rubiaceae","Gentianales",0,0,0,9,0,NA
"Greeniopsis","Rubiaceae","Gentianales",0,0,0,6,0,NA
"Greenmaniella","Asteraceae","Asterales",1,0,0,1,1,1
"Greenwayodendron","Annonaceae","Magnoliales",2,0,0,2,2,1
"Greigia","Bromeliaceae","Poales",0,0,2,35,2,0
"Grenacheria","Primulaceae","Ericales",0,0,0,12,0,NA
"Greslania","Poaceae","Poales",0,0,0,4,0,NA
"Grevea","Montiniaceae","Solanales",0,0,0,3,0,NA
"Grevillea","Proteaceae","Proteales",355,0,0,372,355,1
"Grewia","Malvaceae","Malvales",28,0,0,321,28,1
"Greyia","Melianthaceae","Geraniales",1,0,0,3,1,1
"Grias","Lecythidaceae","Ericales",5,0,0,9,5,1
"Grielum","Neuradaceae","Malvales",0,0,1,4,1,0
"Griffinia","Amaryllidaceae","Asparagales",0,0,2,21,2,0
"Griffithsochloa","Poaceae","Poales",0,0,0,1,0,NA
"Griffonia","Fabaceae","Fabales",0,0,0,4,0,NA
"Grimaldia","Fabaceae","Fabales",0,0,0,1,0,NA
"Grimmeodendron","Euphorbiaceae","Malpighiales",1,0,0,2,1,1
"Grindelia","Asteraceae","Asterales",1,0,0,65,1,1
"Grisebachia","Ericaceae","Ericales",0,0,0,8,0,NA
"Grisebachianthus","Asteraceae","Asterales",0,0,0,8,0,NA
"Griselinia","Cornaceae","Cornales",4,0,0,7,4,1
"Grisollea","Stemonuraceae","Aquifoliales",0,0,0,2,0,NA
"Grobya","Orchidaceae","Asparagales",0,0,1,5,1,0
"Groenlandia","Potamogetonaceae","Alismatales",0,0,1,1,1,0
"Gronovia","Loasaceae","Cornales",0,0,1,2,1,0
"Grosourdya","Orchidaceae","Asparagales",0,0,1,11,1,0
"Grossera","Euphorbiaceae","Malpighiales",1,0,0,8,1,1
"Grossularia","Grossulariaceae","Saxifragales",0,0,0,1,0,NA
"Grosvenoria","Asteraceae","Asterales",0,0,0,7,0,NA
"Grubbia","Grubbiaceae","Cornales",3,0,0,3,3,1
"Grusonia","Cactaceae","Caryophyllales",0,0,0,3,0,NA
"Guacamaya","Rapateaceae","Poales",0,0,1,1,1,0
"Guadua","Poaceae","Poales",2,0,0,27,2,1
"Guaduella","Poaceae","Poales",0,0,0,7,0,NA
"Guaiacum","Zygophyllaceae","Zygophyllales",3,0,0,5,3,1
"Guanchezia","Orchidaceae","Asparagales",0,0,0,1,0,NA
"Guapira","Nyctaginaceae","Caryophyllales",7,0,0,69,7,1
"Guardiola","Asteraceae","Asterales",0,0,1,14,1,0
"Guarea","Meliaceae","Sapindales",34,0,0,72,34,1
"Guarianthe","Orchidaceae","Asparagales",0,0,2,5,2,0
"Guatteria","Annonaceae","Magnoliales",96,0,0,254,96,1
"Guayania","Asteraceae","Asterales",0,0,0,6,0,NA
"Guazuma","Malvaceae","Malvales",2,0,0,3,2,1
"Gueldenstaedtia","Fabaceae","Fabales",0,0,0,12,0,NA
"Guettarda","Rubiaceae","Gentianales",14,0,0,158,14,1
"Guevaria","Asteraceae","Asterales",0,0,0,5,0,NA
"Guianodendron","Fabaceae","Fabales",0,0,0,1,0,NA
"Guibourtia","Fabaceae","Fabales",10,0,0,16,10,1
"Guichenotia","Malvaceae","Malvales",1,0,0,17,1,1
"Guiera","Combretaceae","Myrtales",1,0,0,1,1,1
"Guihaia","Arecaceae","Arecales",1,0,0,2,1,1
"Guihaiothamnus","Rubiaceae","Gentianales",0,0,0,1,0,NA
"Guilandina","Fabaceae","Fabales",0,0,0,3,0,NA
"Guilfoylia","Surianaceae","Fabales",1,0,0,1,1,1
"Guillandinodes","Fabaceae","Fabales",0,0,0,1,0,NA
"Guilleminea","Amaranthaceae","Caryophyllales",0,0,1,8,1,0
"Guillenia","Brassicaceae","Brassicales",0,0,0,3,0,NA
"Guillonea","Apiaceae","Apiales",0,0,0,1,0,NA
"Guindilia","Sapindaceae","Sapindales",1,0,0,3,1,1
"Guinetia","Fabaceae","Fabales",0,0,0,1,0,NA
"Guioa","Sapindaceae","Sapindales",9,0,0,73,9,1
"Guiraoa","Brassicaceae","Brassicales",0,0,0,1,0,NA
"Guizotia","Asteraceae","Asterales",0,0,0,9,0,NA
"Gundelia","Asteraceae","Asterales",0,0,1,2,1,0
"Gundlachia","Asteraceae","Asterales",0,0,0,9,0,NA
"Gunillaea","Campanulaceae","Asterales",0,0,0,2,0,NA
"Gunnarella","Orchidaceae","Asparagales",0,0,1,9,1,0
"Gunnera","Gunneraceae","Gunnerales",0,0,13,69,13,0
"Gunnessia","Apocynaceae","Gentianales",0,0,0,1,0,NA
"Gunniopsis","Aizoaceae","Caryophyllales",0,0,0,13,0,NA
"Gurania","Cucurbitaceae","Cucurbitales",3,0,1,72,4,0.75
"Guraniopsis","Cucurbitaceae","Cucurbitales",0,0,1,1,1,0
"Gustavia","Lecythidaceae","Ericales",27,0,0,41,27,1
"Gutenbergia","Asteraceae","Asterales",0,0,1,27,1,0
"Guthriea","Achariaceae","Malpighiales",0,0,1,1,1,0
"Gutierrezia","Asteraceae","Asterales",1,0,1,33,2,0.5
"Guynesomia","Asteraceae","Asterales",0,0,0,1,0,NA
"Guyonia","Melastomataceae","Myrtales",0,0,0,1,0,NA
"Guzmania","Bromeliaceae","Poales",0,0,16,218,16,0
"Gyminda","Celastraceae","Celastrales",1,0,0,4,1,1
"Gymnacranthera","Myristicaceae","Magnoliales",4,0,0,7,4,1
"Gymnadenia","Orchidaceae","Asparagales",0,0,2,34,2,0
"Gymnaglossum","Orchidaceae","Asparagales",0,0,0,1,0,NA
"Gymnanacamptis","Orchidaceae","Asparagales",0,0,0,2,0,NA
"Gymnanthemum","Asteraceae","Asterales",1,0,0,38,1,1
"Gymnanthera","Apocynaceae","Gentianales",1,0,0,2,1,1
"Gymnanthes","Euphorbiaceae","Malpighiales",7,0,0,25,7,1
"Gymnarrhena","Asteraceae","Asterales",0,0,1,1,1,0
"Gymnaster","Asteraceae","Asterales",0,0,0,2,0,NA
"Gymnema","Apocynaceae","Gentianales",0,0,0,51,0,NA
"Gymnemopsis","Apocynaceae","Gentianales",0,0,0,2,0,NA
"Gymnocalycium","Cactaceae","Caryophyllales",0,0,0,77,0,NA
"Gymnocarpium","Cystopteridaceae","Polypodiales",0,0,2,9,2,0
"Gymnocarpos","Caryophyllaceae","Caryophyllales",1,0,0,11,1,1
"Gymnocladus","Fabaceae","Fabales",2,0,0,5,2,1
"Gymnocondylus","Asteraceae","Asterales",0,0,0,1,0,NA
"Gymnocoronis","Asteraceae","Asterales",0,0,0,5,0,NA
"Gymnodiscus","Asteraceae","Asterales",0,0,1,3,1,0
"Gymnogramma","Pteridaceae","Polypodiales",0,0,0,9,0,NA
"Gymnogrammitis","Polypodiaceae","Polypodiales",0,0,0,1,0,NA
"Gymnolaena","Asteraceae","Asterales",0,0,0,3,0,NA
"Gymnolomia","Asteraceae","Asterales",0,0,0,4,0,NA
"Gymnopentzia","Asteraceae","Asterales",0,0,0,1,0,NA
"Gymnopetalum","Cucurbitaceae","Cucurbitales",0,0,0,4,0,NA
"Gymnophragma","Acanthaceae","Lamiales",0,0,0,1,0,NA
"Gymnophyton","Apiaceae","Apiales",1,0,0,6,1,1
"Gymnopodium","Polygonaceae","Caryophyllales",1,0,0,2,1,1
"Gymnopogon","Poaceae","Poales",0,0,2,14,2,0
"Gymnopsis","Asteraceae","Asterales",0,0,0,1,0,NA
"Gymnopteris","Pteridaceae","Polypodiales",0,0,0,1,0,NA
"Gymnoschoenus","Cyperaceae","Poales",0,0,1,2,1,0
"Gymnosiphon","Burmanniaceae","Dioscoreales",0,0,1,30,1,0
"Gymnospermium","Berberidaceae","Ranunculales",0,0,1,13,1,0
"Gymnosphaera","Cyatheaceae","Cyatheales",0,0,0,20,0,NA
"Gymnosporia","Celastraceae","Celastrales",6,0,0,102,6,1
"Gymnostachys","Araceae","Alismatales",0,0,1,1,1,0
"Gymnostachyum","Acanthaceae","Lamiales",0,0,0,50,0,NA
"Gymnostemon","Simaroubaceae","Sapindales",1,0,0,1,1,1
"Gymnostephium","Asteraceae","Asterales",0,0,0,8,0,NA
"Gymnosteris","Polemoniaceae","Ericales",0,0,0,2,0,NA
"Gymnostoma","Casuarinaceae","Fagales",14,0,0,14,14,1
"Gymnotheca","Saururaceae","Piperales",0,0,2,3,2,0
"Gymnotraunsteinera","Orchidaceae","Asparagales",0,0,0,1,0,NA
"Gymplatanthera","Orchidaceae","Asparagales",0,0,0,2,0,NA
"Gynandropsis","Cleomaceae","Brassicales",0,0,0,2,0,NA
"Gynerium","Poaceae","Poales",0,0,1,1,1,0
"Gynocardia","Achariaceae","Malpighiales",1,0,0,1,1,1
"Gynochthodes","Rubiaceae","Gentianales",2,0,0,22,2,1
"Gynocraterium","Acanthaceae","Lamiales",0,0,0,1,0,NA
"Gynoglottis","Orchidaceae","Asparagales",0,0,0,1,0,NA
"Gynophorea","Brassicaceae","Brassicales",0,0,0,1,0,NA
"Gynostemma","Cucurbitaceae","Cucurbitales",0,0,1,19,1,0
"Gynotroches","Rhizophoraceae","Malpighiales",1,0,0,1,1,1
"Gynoxys","Asteraceae","Asterales",0,0,0,128,0,NA
"Gynura","Asteraceae","Asterales",0,0,0,46,0,NA
"Gypothamnium","Asteraceae","Asterales",0,0,0,1,0,NA
"Gypsacanthus","Acanthaceae","Lamiales",0,0,0,1,0,NA
"Gypsophila","Caryophyllaceae","Caryophyllales",0,0,2,152,2,0
"Gyptidium","Asteraceae","Asterales",0,0,0,2,0,NA
"Gyptis","Asteraceae","Asterales",0,0,0,7,0,NA
"Gyrandra","Daphniphyllaceae","Saxifragales",0,0,0,5,0,NA
"Gyranthera","Malvaceae","Malvales",1,0,0,2,1,1
"Gyrinops","Thymelaeaceae","Malvales",0,0,0,9,0,NA
"Gyrocarpus","Hernandiaceae","Laurales",2,0,0,5,2,1
"Gyrocaryum","Boraginaceae","UnknownOrder-Boraginaceae",0,0,0,1,0,NA
"Gyrocheilos","Gesneriaceae","Lamiales",0,0,0,4,0,NA
"Gyrodoma","Asteraceae","Asterales",0,0,0,1,0,NA
"Gyrogyne","Gesneriaceae","Lamiales",0,0,0,1,0,NA
"Gyroptera","Amaranthaceae","Caryophyllales",0,0,0,3,0,NA
"Gyrosorium","Polypodiaceae","Polypodiales",0,0,0,1,0,NA
"Gyrostachys","Orchidaceae","Asparagales",0,0,0,1,0,NA
"Gyrostemon","Gyrostemonaceae","Brassicales",7,0,0,13,7,1
"Gyrostipula","Rubiaceae","Gentianales",1,0,0,3,1,1
"Gyrotaenia","Urticaceae","Rosales",2,0,0,5,2,1
"Haageocereus","Cactaceae","Caryophyllales",0,0,0,29,0,NA
"Haastia","Asteraceae","Asterales",0,0,0,4,0,NA
"Habenaria","Orchidaceae","Asparagales",0,0,5,837,5,0
"Haberlea","Gesneriaceae","Lamiales",0,0,0,1,0,NA
"Habracanthus","Acanthaceae","Lamiales",0,0,0,14,0,NA
"Habranthus","Amaryllidaceae","Asparagales",0,0,3,83,3,0
"Habrochloa","Poaceae","Poales",0,0,0,1,0,NA
"Habroneuron","Rubiaceae","Gentianales",0,0,0,1,0,NA
"Habropetalum","Dioncophyllaceae","Caryophyllales",0,0,0,1,0,NA
"Hackelia","Boraginaceae","UnknownOrder-Boraginaceae",0,0,0,50,0,NA
"Hackelochloa","Poaceae","Poales",0,0,0,2,0,NA
"Hacquetia","Apiaceae","Apiales",0,0,0,1,0,NA
"Haeckeria","Asteraceae","Asterales",0,0,0,3,0,NA
"Haegiela","Asteraceae","Asterales",0,0,0,1,0,NA
"Haemanthus","Amaryllidaceae","Asparagales",0,0,1,22,1,0
"Haematodendron","Myristicaceae","Magnoliales",1,0,0,1,1,1
"Haematostaphis","Anacardiaceae","Sapindales",1,0,0,1,1,1
"Haematostemon","Euphorbiaceae","Malpighiales",0,0,0,2,0,NA
"Haematoxylum","Fabaceae","Fabales",3,0,0,4,3,1
"Haemodorum","Haemodoraceae","Commelinales",0,0,10,20,10,0
"Haenianthus","Oleaceae","Lamiales",2,0,0,3,2,1
"Hagenbachia","Asparagaceae","Asparagales",0,0,0,6,0,NA
"Hagsatera","Orchidaceae","Asparagales",0,0,1,2,1,0
"Hainanecio","Asteraceae","Asterales",0,0,0,1,0,NA
"Hainardia","Poaceae","Poales",0,0,1,1,1,0
"Hainardiopholis","Poaceae","Poales",0,0,0,1,0,NA
"Haitimimosa","Fabaceae","Fabales",0,0,0,1,0,NA
"Hakea","Proteaceae","Proteales",6,0,0,6,6,1
"Hakonechloa","Poaceae","Poales",0,0,0,1,0,NA
"Halacsya","Boraginaceae","UnknownOrder-Boraginaceae",0,0,0,1,0,NA
"Halanthium","Amaranthaceae","Caryophyllales",0,0,0,2,0,NA
"Halarchon","Amaranthaceae","Caryophyllales",0,0,0,1,0,NA
"Haldina","Rubiaceae","Gentianales",1,0,0,1,1,1
"Halenia","Gentianaceae","Gentianales",0,0,1,76,1,0
"Halerpestes","Ranunculaceae","Ranunculales",0,0,3,8,3,0
"Halesia","Styracaceae","Ericales",4,0,0,4,4,1
"Halimium","Cistaceae","Malvales",2,0,0,13,2,1
"Halimocnemis","Amaranthaceae","Caryophyllales",0,0,0,6,0,NA
"Halimodendron","Fabaceae","Fabales",1,0,0,1,1,1
"Halimolobos","Brassicaceae","Brassicales",0,0,0,11,0,NA
"Halleorchis","Orchidaceae","Asparagales",0,0,0,1,0,NA
"Halleria","Stilbaceae","Lamiales",2,0,0,4,2,1
"Hallianthus","Aizoaceae","Caryophyllales",0,0,0,1,0,NA
"Halocarpus","Podocarpaceae","Araucariales",3,0,0,3,3,1
"Halocharis","Amaranthaceae","Caryophyllales",0,0,0,4,0,NA
"Halocnemum","Amaranthaceae","Caryophyllales",1,0,0,2,1,1
"Halodule","Cymodoceaceae","Alismatales",0,0,3,6,3,0
"Halogeton","Amaranthaceae","Caryophyllales",0,0,1,4,1,0
"Halopegia","Marantaceae","Zingiberales",0,0,2,3,2,0
"Halopeplis","Amaranthaceae","Caryophyllales",1,0,0,3,1,1
"Halophila","Hydrocharitaceae","Alismatales",0,0,3,20,3,0
"Halophytum","Halophytaceae","Caryophyllales",0,0,1,1,1,0
"Halopyrum","Poaceae","Poales",0,0,0,1,0,NA
"Haloragis","Haloragaceae","Saxifragales",1,0,1,6,2,0.5
"Haloragodendron","Haloragaceae","Saxifragales",0,0,0,1,0,NA
"Halosarcia","Amaranthaceae","Caryophyllales",0,0,1,6,1,0
"Halosciastrum","Apiaceae","Apiales",0,0,0,1,0,NA
"Halosicyos","Cucurbitaceae","Cucurbitales",0,0,1,1,1,0
"Halostachys","Amaranthaceae","Caryophyllales",1,0,0,1,1,1
"Halothamnus","Amaranthaceae","Caryophyllales",1,0,0,10,1,1
"Halotis","Amaranthaceae","Caryophyllales",0,0,0,1,0,NA
"Haloxylon","Amaranthaceae","Caryophyllales",4,0,0,9,4,1
"Hamadryas","Ranunculaceae","Ranunculales",0,0,0,5,0,NA
"Hamamelis","Hamamelidaceae","Saxifragales",2,0,0,2,2,1
"Hamatocactus","Cactaceae","Caryophyllales",0,0,0,1,0,NA
"Hamelia","Rubiaceae","Gentianales",6,0,0,17,6,1
"Hamilcoa","Euphorbiaceae","Malpighiales",0,0,0,1,0,NA
"Hammada","Amaranthaceae","Caryophyllales",0,0,0,3,0,NA
"Hammarbya","Orchidaceae","Asparagales",0,0,0,1,0,NA
"Hammatolobium","Fabaceae","Fabales",0,0,0,2,0,NA
"Hammeria","Aizoaceae","Caryophyllales",0,0,0,1,0,NA
"Hampea","Malvaceae","Malvales",2,0,0,22,2,1
"Hanabusaya","Campanulaceae","Asterales",0,0,0,1,0,NA
"Hanburia","Cucurbitaceae","Cucurbitales",0,0,1,2,1,0
"Hancea","Euphorbiaceae","Malpighiales",3,0,0,17,3,1
"Hanceola","Lamiaceae","Lamiales",0,0,0,8,0,NA
"Hancockia","Orchidaceae","Asparagales",0,0,0,1,0,NA
"Hancornia","Apocynaceae","Gentianales",1,0,0,1,1,1
"Handelia","Asteraceae","Asterales",0,0,0,1,0,NA
"Handeliodendron","Sapindaceae","Sapindales",1,0,0,1,1,1
"Handroanthus","Bignoniaceae","Lamiales",11,0,0,30,11,1
"Hanghomia","Apocynaceae","Gentianales",0,0,0,1,0,NA
"Hanguana","Hanguanaceae","Commelinales",0,0,1,10,1,0
"Haniffia","Zingiberaceae","Zingiberales",0,0,0,3,0,NA
"Hannonia","Amaryllidaceae","Asparagales",0,0,1,1,1,0
"Hansenia","Apiaceae","Apiales",0,0,0,1,0,NA
"Hanslia","Fabaceae","Fabales",0,0,0,2,0,NA
"Hansteinia","Acanthaceae","Lamiales",1,0,0,5,1,1
"Hapaline","Araceae","Alismatales",0,0,0,8,0,NA
"Hapalorchis","Orchidaceae","Asparagales",0,0,0,12,0,NA
"Haplocarpha","Asteraceae","Asterales",0,0,6,12,6,0
"Haplochorema","Zingiberaceae","Zingiberales",0,0,0,6,0,NA
"Haploclathra","Calophyllaceae","Malpighiales",2,0,0,4,2,1
"Haplocoelopsis","Sapindaceae","Sapindales",1,0,0,1,1,1
"Haplocoelum","Sapindaceae","Sapindales",2,0,0,6,2,1
"Haplodiscus","Asteraceae","Asterales",0,0,0,1,0,NA
"Haploesthes","Asteraceae","Asterales",0,0,0,3,0,NA
"Haplolobus","Burseraceae","Sapindales",1,0,0,1,1,1
"Haplopappus","Asteraceae","Asterales",2,0,0,71,2,1
"Haplophyllum","Rutaceae","Sapindales",0,0,1,2,1,0
"Haplophyton","Apocynaceae","Gentianales",0,0,0,1,0,NA
"Haplopteris","Pteridaceae","Polypodiales",0,0,0,20,0,NA
"Haplorhus","Anacardiaceae","Sapindales",1,0,0,1,1,1
"Haplormosia","Fabaceae","Fabales",1,0,0,1,1,1
"Haplosciadium","Apiaceae","Apiales",0,0,0,1,0,NA
"Haplosphaera","Apiaceae","Apiales",0,0,0,2,0,NA
"Haplostachys","Lamiaceae","Lamiales",0,0,1,5,1,0
"Haplostichanthus","Annonaceae","Magnoliales",2,0,0,4,2,1
"Haplothismia","Burmanniaceae","Dioscoreales",0,0,0,1,0,NA
"Haptanthus","Haptanthaceae","Buxales",0,0,0,1,0,NA
"Haptocarpum","Cleomaceae","Brassicales",0,0,0,1,0,NA
"Haptotrichion","Asteraceae","Asterales",0,0,1,2,1,0
"Haraella","Orchidaceae","Asparagales",0,0,1,1,1,0
"Harbouria","Apiaceae","Apiales",0,0,0,1,0,NA
"Hardenbergia","Fabaceae","Fabales",1,0,0,3,1,1
"Hardwickia","Fabaceae","Fabales",1,0,0,2,1,1
"Harfordia","Polygonaceae","Caryophyllales",0,0,0,1,0,NA
"Hariota","Cactaceae","Caryophyllales",0,0,0,1,0,NA
"Harleya","Asteraceae","Asterales",0,0,0,1,0,NA
"Harleyodendron","Fabaceae","Fabales",0,0,0,1,0,NA
"Harmogia","Myrtaceae","Myrtales",1,0,0,1,1,1
"Harmonia","Asteraceae","Asterales",0,0,0,5,0,NA
"Harmsia","Malvaceae","Malvales",0,0,0,1,0,NA
"Harmsiodoxa","Brassicaceae","Brassicales",0,0,2,3,2,0
"Harmsiopanax","Araliaceae","Apiales",0,0,0,3,0,NA
"Harnackia","Asteraceae","Asterales",0,0,0,1,0,NA
"Harpachne","Poaceae","Poales",0,0,0,3,0,NA
"Harpagocarpus","Polygonaceae","Caryophyllales",0,0,0,1,0,NA
"Harpagonella","Boraginaceae","UnknownOrder-Boraginaceae",0,0,0,1,0,NA
"Harpalyce","Fabaceae","Fabales",0,0,0,30,0,NA
"Harpephyllum","Anacardiaceae","Sapindales",1,0,0,1,1,1
"Harperia","Restionaceae","Poales",0,0,1,4,1,0
"Harpochilus","Acanthaceae","Lamiales",0,0,0,1,0,NA
"Harpochloa","Poaceae","Poales",0,0,1,2,1,0
"Harpullia","Sapindaceae","Sapindales",3,0,0,3,3,1
"Harrimanella","Ericaceae","Ericales",1,0,0,1,1,1
"Harrisia","Cactaceae","Caryophyllales",0,0,0,17,0,NA
"Harrisonia","Rutaceae","Sapindales",1,0,0,2,1,1
"Harrysmithia","Apiaceae","Apiales",0,0,0,2,0,NA
"Hartia","Theaceae","Ericales",0,0,0,1,0,NA
"Hartleya","Stemonuraceae","Aquifoliales",1,0,0,1,1,1
"Hartliella","Linderniaceae","Lamiales",0,0,0,4,0,NA
"Hartmannia","Onagraceae","Myrtales",0,0,0,3,0,NA
"Hartwrightia","Asteraceae","Asterales",0,0,0,1,0,NA
"Harungana","Hypericaceae","Malpighiales",1,0,0,4,1,1
"Harveya","Orobanchaceae","Lamiales",0,0,9,27,9,0
"Haselhoffia","Acanthaceae","Lamiales",0,0,0,1,0,NA
"Hasseltia","Salicaceae","Malpighiales",2,0,0,3,2,1
"Hasseltiopsis","Salicaceae","Malpighiales",0,0,0,1,0,NA
"Hasteola","Asteraceae","Asterales",0,0,0,3,0,NA
"Hastingia","Lamiaceae","Lamiales",0,0,0,1,0,NA
"Hastingsia","Asparagaceae","Asparagales",0,0,1,4,1,0
"Hatiora","Cactaceae","Caryophyllales",1,0,0,8,1,1
"Hatschbachiella","Asteraceae","Asterales",0,0,0,2,0,NA
"Haumania","Marantaceae","Zingiberales",0,0,2,5,2,0
"Haumaniastrum","Lamiaceae","Lamiales",0,0,0,35,0,NA
"Hauya","Onagraceae","Myrtales",0,0,0,1,0,NA
"Havardia","Fabaceae","Fabales",3,0,0,7,3,1
"Havetiopsis","Clusiaceae","Malpighiales",0,0,0,3,0,NA
"Hawkesiophyton","Solanaceae","Solanales",1,0,0,3,1,1
"Haworthia","Xanthorrhoeaceae","Asparagales",0,0,23,166,23,0
"Haydenia","Celastraceae","Celastrales",0,0,0,3,0,NA
"Haynaldoticum","Poaceae","Poales",0,0,0,1,0,NA
"Hazardia","Asteraceae","Asterales",6,0,0,11,6,1
"Hebanthe","Amaranthaceae","Caryophyllales",1,0,0,6,1,1
"Hebe","Plantaginaceae","Lamiales",1,0,0,13,1,1
"Hebecarpa","Polygalaceae","Fabales",0,0,0,7,0,NA
"Hebecladus","Solanaceae","Solanales",0,0,0,1,0,NA
"Hebeclinium","Asteraceae","Asterales",0,0,0,26,0,NA
"Hebenstretia","Scrophulariaceae","Lamiales",0,0,2,23,2,0
"Hebepetalum","Linaceae","Malpighiales",1,0,0,3,1,1
"Heberdenia","Primulaceae","Ericales",1,0,0,1,1,1
"Hebestigma","Fabaceae","Fabales",1,0,0,1,1,1
"Hecastocleis","Asteraceae","Asterales",0,0,0,1,0,NA
"Hecatostemon","Salicaceae","Malpighiales",1,0,0,1,1,1
"Hechtia","Bromeliaceae","Poales",0,0,10,60,10,0
"Hecistopteris","Pteridaceae","Polypodiales",0,0,1,3,1,0
"Heckeldora","Meliaceae","Sapindales",1,0,0,2,1,1
"Hectorella","Montiaceae","Caryophyllales",0,0,1,1,1,0
"Hedbergia","Orobanchaceae","Lamiales",0,0,0,1,0,NA
"Hedeoma","Lamiaceae","Lamiales",0,0,4,44,4,0
"Hedera","Araliaceae","Apiales",3,0,0,17,3,1
"Hederorkis","Orchidaceae","Asparagales",0,0,0,2,0,NA
"Hedosyne","Asteraceae","Asterales",0,0,0,1,0,NA
"Hedstromia","Rubiaceae","Gentianales",0,0,0,1,0,NA
"Hedycarya","Monimiaceae","Laurales",2,0,0,2,2,1
"Hedychium","Zingiberaceae","Zingiberales",0,0,10,93,10,0
"Hedyosmum","Chloranthaceae","Chloranthales",6,0,0,44,6,1
"Hedyotis","Rubiaceae","Gentianales",3,0,2,158,5,0.6
"Hedypnois","Asteraceae","Asterales",0,0,1,4,1,0
"Hedysarum","Fabaceae","Fabales",3,0,8,201,11,0.272727272727273
"Hedyscepe","Arecaceae","Arecales",1,0,0,1,1,1
"Hedythyrsus","Rubiaceae","Gentianales",0,0,0,2,0,NA
"Heeria","Anacardiaceae","Sapindales",1,0,0,1,1,1
"Heeria","Melastomataceae",NA,0,0,0,1,0,NA
"Hegnera","Fabaceae","Fabales",0,0,0,1,0,NA
"Heimia","Lythraceae","Myrtales",2,0,0,4,2,1
"Heinekenia","Fabaceae","Fabales",0,0,0,3,0,NA
"Heinsenia","Rubiaceae","Gentianales",1,0,0,1,1,1
"Heinsia","Rubiaceae","Gentianales",1,0,0,5,1,1
"Heisteria","Olacaceae","Santalales",30,0,0,36,30,1
"Hekistocarpa","Rubiaceae","Gentianales",0,0,1,1,1,0
"Heladena","Malpighiaceae","Malpighiales",1,0,0,1,1,1
"Helanthium","Alismataceae","Alismatales",0,0,1,3,1,0
"Heldreichia","Brassicaceae","Brassicales",0,0,0,4,0,NA
"Helenium","Asteraceae","Asterales",0,0,1,39,1,0
"Heleocharis","Cyperaceae","Poales",0,0,0,3,0,NA
"Helia","Gentianaceae","Gentianales",0,0,0,3,0,NA
"Heliamphora","Sarraceniaceae","Ericales",0,0,1,10,1,0
"Heliantheae","Asteraceae","Asterales",0,0,0,3,0,NA
"Helianthella","Asteraceae","Asterales",0,0,0,10,0,NA
"Helianthemum","Cistaceae","Malvales",4,0,0,73,4,1
"Helianthostylis","Moraceae","Rosales",1,0,0,2,1,1
"Helianthus","Asteraceae","Asterales",0,0,9,71,9,0
"Helicanthes","Loranthaceae","Santalales",0,0,0,1,0,NA
"Helichrysopsis","Asteraceae","Asterales",0,0,0,1,0,NA
"Helichrysum","Asteraceae","Asterales",4,1,6,506,10,0.4
"Helicia","Proteaceae","Proteales",7,0,0,27,7,1
"Heliciopsis","Proteaceae","Proteales",1,0,0,4,1,1
"Helicodiceros","Araceae","Alismatales",0,0,1,1,1,0
"Heliconia","Heliconiaceae","Zingiberales",0,0,81,204,81,0
"Helicostylis","Moraceae","Rosales",6,0,0,7,6,1
"Helicotropis","Fabaceae","Fabales",0,0,0,4,0,NA
"Helicteres","Malvaceae","Malvales",4,0,0,56,4,1
"Helicteropsis","Malvaceae","Malvales",1,0,0,1,1,1
"Helictonema","Celastraceae","Celastrales",0,0,0,1,0,NA
"Helictotrichon","Poaceae","Poales",0,0,9,90,9,0
"Helietta","Rutaceae","Sapindales",2,0,0,7,2,1
"Helinus","Rhamnaceae","Rosales",1,0,0,5,1,1
"Heliocarpus","Malvaceae","Malvales",5,0,0,13,5,1
"Heliocauta","Asteraceae","Asterales",0,0,0,1,0,NA
"Heliocereus","Cactaceae","Caryophyllales",0,0,0,2,0,NA
"Heliohebe","Plantaginaceae","Lamiales",1,0,0,4,1,1
"Heliomeris","Asteraceae","Asterales",0,0,0,8,0,NA
"Heliophila","Brassicaceae","Brassicales",0,1,0,83,0,NA
"Heliopsis","Asteraceae","Asterales",0,0,1,15,1,0
"Heliotropium","Boraginaceae","UnknownOrder-Boraginaceae",12,5,4,156,16,0.75
"Helipterum","Asteraceae","Asterales",0,0,1,33,1,0
"Helixanthera","Loranthaceae","Santalales",4,0,0,26,4,1
"Helleborine","Orchidaceae","Asparagales",0,0,0,2,0,NA
"Helleborus","Ranunculaceae","Ranunculales",2,0,8,13,10,0.2
"Helleriella","Orchidaceae","Asparagales",0,0,1,2,1,0
"Hellmuthia","Cyperaceae","Poales",0,0,1,1,1,0
"Helmholtzia","Philydraceae","Commelinales",0,0,2,3,2,0
"Helminthostachys","Ophioglossaceae","Ophioglossales",0,0,0,2,0,NA
"Helminthotheca","Asteraceae","Asterales",0,0,0,5,0,NA
"Helmiopsiella","Malvaceae","Malvales",1,0,0,2,1,1
"Helmiopsis","Malvaceae","Malvales",0,0,0,9,0,NA
"Helmontia","Cucurbitaceae","Cucurbitales",0,1,0,4,0,NA
"Helogyne","Asteraceae","Asterales",0,0,0,8,0,NA
"Helonias","Melanthiaceae","Liliales",0,0,1,1,1,0
"Heloniopsis","Melanthiaceae","Liliales",0,0,6,6,6,0
"Helonoma","Orchidaceae","Asparagales",0,0,0,4,0,NA
"Helosis","Balanophoraceae","Santalales",0,0,0,1,0,NA
"Helwingia","Helwingiaceae","Aquifoliales",3,0,0,4,3,1
"Hemandradenia","Connaraceae","Oxalidales",1,0,0,2,1,1
"Hemarthria","Poaceae","Poales",0,0,2,12,2,0
"Hemerocallis","Xanthorrhoeaceae","Asparagales",0,0,5,20,5,0
"Hemesteum","Dryopteridaceae","Polypodiales",0,0,0,1,0,NA
"Hemiadelphis","Acanthaceae","Lamiales",0,0,0,1,0,NA
"Hemiandra","Lamiaceae","Lamiales",0,0,0,7,0,NA
"Hemianemia","Anemiaceae","Schizaeales",0,0,0,11,0,NA
"Hemianthus","Plantaginaceae","Lamiales",0,0,0,4,0,NA
"Hemiarrhena","Linderniaceae","Lamiales",0,0,0,1,0,NA
"Hemiboea","Gesneriaceae","Lamiales",0,0,0,26,0,NA
"Hemichaena","Phrymaceae","Lamiales",0,0,0,2,0,NA
"Hemichroa","Amaranthaceae","Caryophyllales",0,0,0,1,0,NA
"Hemicrambe","Brassicaceae","Brassicales",0,0,0,3,0,NA
"Hemidesmus","Apocynaceae","Gentianales",0,0,0,2,0,NA
"Hemidictyum","Diplaziopsidaceae","Polypodiales",0,0,0,1,0,NA
"Hemieva","Saxifragaceae","Saxifragales",0,0,0,2,0,NA
"Hemigenia","Lamiaceae","Lamiales",1,0,0,51,1,1
"Hemigramma","Tectariaceae","Polypodiales",0,0,0,3,0,NA
"Hemigraphis","Acanthaceae","Lamiales",0,0,0,22,0,NA
"Hemilophia","Brassicaceae","Brassicales",0,0,0,5,0,NA
"Hemimeris","Scrophulariaceae","Lamiales",0,0,2,7,2,0
"Hemionanthes","Pteridaceae","Polypodiales",0,0,0,1,0,NA
"Hemionitis","Pteridaceae","Polypodiales",0,0,0,8,0,NA
"Hemiorchis","Zingiberaceae","Zingiberales",0,0,0,3,0,NA
"Hemiphlebium","Hymenophyllaceae","Hymenophyllales",0,0,0,2,0,NA
"Hemiphora","Lamiaceae","Lamiales",0,0,0,5,0,NA
"Hemiphragma","Plantaginaceae","Lamiales",0,0,1,1,1,0
"Hemiphylacus","Asparagaceae","Asparagales",0,0,1,5,1,0
"Hemipilia","Orchidaceae","Asparagales",0,0,0,11,0,NA
"Hemipiliopsis","Orchidaceae","Asparagales",0,0,0,1,0,NA
"Hemipogon","Apocynaceae","Gentianales",0,0,0,12,0,NA
"Hemiptelea","Ulmaceae","Rosales",1,0,0,1,1,1
"Hemisorghum","Poaceae","Poales",0,0,0,2,0,NA
"Hemistachyum","Polypodiaceae","Polypodiales",0,0,0,1,0,NA
"Hemistegia","Cyatheaceae","Cyatheales",0,0,0,1,0,NA
"Hemistepta","Asteraceae","Asterales",0,0,1,1,1,0
"Hemisteptia","Asteraceae","Asterales",0,0,0,1,0,NA
"Hemistylus","Urticaceae","Rosales",0,0,0,3,0,NA
"Hemitelia","Cyatheaceae","Cyatheales",0,0,0,12,0,NA
"Hemithrinax","Arecaceae","Arecales",1,0,0,3,1,1
"Hemitomes","Ericaceae","Ericales",0,0,0,1,0,NA
"Hemizonella","Asteraceae","Asterales",0,0,0,1,0,NA
"Hemizonia","Asteraceae","Asterales",0,0,0,12,0,NA
"Hemizygia","Lamiaceae","Lamiales",0,0,0,2,0,NA
"Hemsleya","Cucurbitaceae","Cucurbitales",0,0,0,27,0,NA
"Hemsleyna","Malpighiaceae","Malpighiales",0,0,0,1,0,NA
"Henckelia","Gesneriaceae","Lamiales",0,0,0,69,0,NA
"Henleophytum","Malpighiaceae","Malpighiales",0,0,0,1,0,NA
"Hennecartia","Monimiaceae","Laurales",1,0,0,1,1,1
"Henonia","Amaranthaceae","Caryophyllales",0,0,0,1,0,NA
"Henophyton","Brassicaceae","Brassicales",0,0,0,2,0,NA
"Henrardia","Poaceae","Poales",0,0,1,2,1,0
"Henricksonia","Asteraceae","Asterales",0,0,0,1,0,NA
"Henriettea","Melastomataceae","Myrtales",3,0,0,63,3,1
"Henriettella","Melastomataceae","Myrtales",2,0,0,17,2,1
"Henriquezia","Rubiaceae","Gentianales",1,0,0,3,1,1
"Henrya","Acanthaceae","Lamiales",0,0,0,2,0,NA
"Hensmania","Xanthorrhoeaceae","Asparagales",0,0,1,3,1,0
"Hepatica","Ranunculaceae","Ranunculales",0,0,1,1,1,0
"Heppiantha","Gesneriaceae","Lamiales",0,0,0,1,0,NA
"Heppiella","Gesneriaceae","Lamiales",1,0,0,4,1,1
"Heptacodium","Caprifoliaceae","Dipsacales",1,0,0,1,1,1
"Heptanthus","Asteraceae","Asterales",0,0,0,7,0,NA
"Heptaptera","Apiaceae","Apiales",0,0,0,4,0,NA
"Heracleum","Apiaceae","Apiales",0,0,5,52,5,0
"Herbertia","Iridaceae","Asparagales",0,0,2,9,2,0
"Herbstia","Amaranthaceae","Caryophyllales",0,0,0,1,0,NA
"Herderia","Asteraceae","Asterales",0,0,0,1,0,NA
"Hereroa","Aizoaceae","Caryophyllales",0,0,0,29,0,NA
"Herissantia","Malvaceae","Malvales",0,0,0,6,0,NA
"Heritiera","Malvaceae","Malvales",9,0,0,9,9,1
"Hermannia","Malvaceae","Malvales",2,0,0,153,2,1
"Hermas","Apiaceae","Apiales",0,0,1,7,1,0
"Hermbstaedtia","Amaranthaceae","Caryophyllales",0,0,1,13,1,0
"Hermesias","Fabaceae","Fabales",0,0,0,1,0,NA
"Herminium","Orchidaceae","Asparagales",0,0,0,22,0,NA
"Herminorchis","Orchidaceae","Asparagales",0,0,0,1,0,NA
"Hernandia","Hernandiaceae","Laurales",8,0,0,14,8,1
"Herniaria","Caryophyllaceae","Caryophyllales",0,0,1,33,1,0
"Herodotia","Asteraceae","Asterales",0,0,0,1,0,NA
"Herpestis","Plantaginaceae","Lamiales",0,0,0,2,0,NA
"Herpetacanthus","Acanthaceae","Lamiales",0,0,1,7,1,0
"Herpetica","Fabaceae","Fabales",0,0,0,1,0,NA
"Herpetophytum","Orchidaceae","Asparagales",0,0,0,1,0,NA
"Herpetospermum","Cucurbitaceae","Cucurbitales",0,0,1,2,1,0
"Herpolirion","Xanthorrhoeaceae","Asparagales",0,0,1,1,1,0
"Herpothamnus","Ericaceae","Ericales",0,0,0,1,0,NA
"Herpysma","Orchidaceae","Asparagales",0,0,0,1,0,NA
"Herpyza","Fabaceae","Fabales",0,0,0,1,0,NA
"Herrania","Malvaceae","Malvales",3,0,0,17,3,1
"Herrea","Aizoaceae","Caryophyllales",0,0,0,24,0,NA
"Herreanthus","Aizoaceae","Caryophyllales",0,0,0,1,0,NA
"Herreranthus","Asteraceae","Asterales",0,0,0,1,0,NA
"Herreria","Asparagaceae","Asparagales",0,0,2,9,2,0
"Herreriopsis","Asparagaceae","Asparagales",0,0,0,1,0,NA
"Herrickia","Asteraceae","Asterales",0,0,0,4,0,NA
"Herschelia","Solanaceae","Solanales",0,0,0,1,0,NA
"Hertia","Asteraceae","Asterales",0,0,0,9,0,NA
"Hesperalbizia","Fabaceae","Fabales",1,0,0,1,1,1
"Hesperalcea","Malvaceae","Malvales",0,0,0,1,0,NA
"Hesperaloe","Asparagaceae","Asparagales",0,0,1,8,1,0
"Hesperantha","Iridaceae","Asparagales",0,0,34,84,34,0
"Hesperelaea","Oleaceae","Lamiales",1,0,0,1,1,1
"Hesperethusa","Rutaceae","Sapindales",0,0,0,1,0,NA
"Hesperevax","Asteraceae","Asterales",0,0,0,3,0,NA
"Hesperhodos","Rosaceae","Rosales",0,0,0,1,0,NA
"Hesperidanthus","Brassicaceae","Brassicales",0,0,0,5,0,NA
"Hesperis","Brassicaceae","Brassicales",0,0,1,51,1,0
"Hesperocallis","Asparagaceae","Asparagales",0,0,1,1,1,0
"Hesperochiron","Boraginaceae","UnknownOrder-Boraginaceae",0,0,0,4,0,NA
"Hesperocnide","Urticaceae","Rosales",0,0,1,2,1,0
"Hesperolaburnum","Fabaceae","Fabales",0,0,0,1,0,NA
"Hesperolinon","Linaceae","Malpighiales",0,0,0,13,0,NA
"Hesperomannia","Asteraceae","Asterales",1,0,0,3,1,1
"Hesperomecon","Papaveraceae","Ranunculales",0,0,0,1,0,NA
"Hesperomeles","Rosaceae","Rosales",2,0,0,12,2,1
"Hesperonia","Nyctaginaceae","Caryophyllales",0,0,0,1,0,NA
"Hesperothamnus","Fabaceae","Fabales",1,0,0,5,1,1
"Hesperoxiphion","Iridaceae","Asparagales",0,0,4,6,4,0
"Hesperoyucca","Asparagaceae","Asparagales",0,0,1,2,1,0
"Hesperozygis","Lamiaceae","Lamiales",0,0,0,7,0,NA
"Hessea","Amaryllidaceae","Asparagales",0,0,1,21,1,0
"Hestia","Araceae","Alismatales",0,0,0,1,0,NA
"Hetaeria","Orchidaceae","Asparagales",0,0,0,30,0,NA
"Heterachne","Poaceae","Poales",0,0,0,3,0,NA
"Heteracia","Asteraceae","Asterales",0,0,0,1,0,NA
"Heteradelphia","Acanthaceae","Lamiales",0,0,0,2,0,NA
"Heteranthelium","Poaceae","Poales",0,0,1,1,1,0
"Heteranthemis","Asteraceae","Asterales",0,0,0,1,0,NA
"Heteranthera","Pontederiaceae","Commelinales",0,0,9,12,9,0
"Heteranthia","Solanaceae","Solanales",0,0,0,1,0,NA
"Heteranthoecia","Poaceae","Poales",0,0,0,1,0,NA
"Heterisia","Saxifragaceae","Saxifragales",0,0,0,1,0,NA
"Heterocaryum","Boraginaceae","UnknownOrder-Boraginaceae",0,0,0,3,0,NA
"Heterocentron","Melastomataceae","Myrtales",1,0,0,17,1,1
"Heterochaenia","Campanulaceae","Asterales",0,0,0,4,0,NA
"Heterocodon","Campanulaceae","Asterales",0,0,1,1,1,0
"Heterocoma","Asteraceae","Asterales",0,0,0,1,0,NA
"Heterocondylus","Asteraceae","Asterales",0,0,1,13,1,0
"Heterocypsela","Asteraceae","Asterales",0,0,0,1,0,NA
"Heterodanaea","Marattiaceae","Marattiales",0,0,1,1,1,0
"Heteroderis","Asteraceae","Asterales",0,0,0,1,0,NA
"Heteroflorum","Fabaceae","Fabales",1,0,0,1,1,1
"Heterogonium","Tectariaceae","Polypodiales",0,0,0,13,0,NA
"Heterolamium","Lamiaceae","Lamiales",0,0,0,2,0,NA
"Heterolepis","Asteraceae","Asterales",1,0,0,3,1,1
"Heteromera","Asteraceae","Asterales",0,0,0,2,0,NA
"Heteromma","Asteraceae","Asterales",0,0,0,3,0,NA
"Heteromorpha","Apiaceae","Apiales",1,0,0,9,1,1
"Heteroneurum","Dryopteridaceae","Polypodiales",0,0,0,1,0,NA
"Heteronoma","Melastomataceae","Myrtales",0,0,0,2,0,NA
"Heteropanax","Araliaceae","Apiales",1,0,0,8,1,1
"Heteropappus","Asteraceae","Asterales",0,0,2,13,2,0
"Heteropetalum","Annonaceae","Magnoliales",1,0,0,1,1,1
"Heteropholis","Poaceae","Poales",0,0,0,4,0,NA
"Heterophragma","Bignoniaceae","Lamiales",2,0,0,2,2,1
"Heterophyllaea","Rubiaceae","Gentianales",0,0,0,3,0,NA
"Heteroplexis","Asteraceae","Asterales",0,0,0,2,0,NA
"Heteropogon","Poaceae","Poales",0,0,2,6,2,0
"Heteropolygonatum","Asparagaceae","Asparagales",0,0,1,6,1,0
"Heteropsis","Araceae","Alismatales",0,0,2,17,2,0
"Heteropterys","Malpighiaceae","Malpighiales",20,0,0,141,20,1
"Heteroptilis","Apiaceae","Apiales",0,0,0,1,0,NA
"Heteropyxis","Myrtaceae","Myrtales",1,0,0,3,1,1
"Heterorhachis","Asteraceae","Asterales",0,0,0,1,0,NA
"Heterosamara","Polygalaceae","Fabales",0,0,0,5,0,NA
"Heterosavia","Phyllanthaceae","Malpighiales",1,0,0,4,1,1
"Heterosmilax","Smilacaceae","Liliales",0,0,0,13,0,NA
"Heterospathe","Arecaceae","Arecales",1,0,0,39,1,1
"Heterosperma","Asteraceae","Asterales",0,0,0,6,0,NA
"Heterostachys","Amaranthaceae","Caryophyllales",0,0,1,2,1,0
"Heterostemma","Apocynaceae","Gentianales",0,0,0,13,0,NA
"Heterostemon","Fabaceae","Fabales",1,0,0,7,1,1
"Heterotaxis","Orchidaceae","Asparagales",0,0,11,13,11,0
"Heterothalamus","Asteraceae","Asterales",1,0,0,2,1,1
"Heterotheca","Asteraceae","Asterales",0,0,0,25,0,NA
"Heterothrix","Brassicaceae","Brassicales",0,0,0,1,0,NA
"Heterotis","Melastomataceae","Myrtales",0,0,0,7,0,NA
"Heterotoma","Campanulaceae","Asterales",0,0,0,1,0,NA
"Heterotrichum","Melastomataceae","Myrtales",1,0,0,3,1,1
"Heterotristicha","Podostemaceae","Malpighiales",0,0,0,1,0,NA
"Heterotropa","Aristolochiaceae","Piperales",0,0,0,2,0,NA
"Heterozostera","Zosteraceae","Alismatales",0,0,0,1,0,NA
"Heuchera","Saxifragaceae","Saxifragales",0,0,15,58,15,0
"Hevea","Euphorbiaceae","Malpighiales",6,0,0,9,6,1
"Hewittia","Convolvulaceae","Solanales",0,0,1,3,1,0
"Hexacyrtis","Colchicaceae","Liliales",0,0,1,1,1,0
"Hexalectris","Orchidaceae","Asparagales",0,0,1,10,1,0
"Hexalobus","Annonaceae","Magnoliales",2,0,0,6,2,1
"Hexapterella","Burmanniaceae","Dioscoreales",0,0,0,2,0,NA
"Hexaspora","Celastraceae","Celastrales",0,0,0,1,0,NA
"Hexastylis","Aristolochiaceae","Piperales",0,0,0,1,0,NA
"Heynea","Meliaceae","Sapindales",0,0,0,2,0,NA
"Heywoodia","Phyllanthaceae","Malpighiales",1,0,0,1,1,1
"Hibbertia","Dilleniaceae","Dilleniales",3,0,0,9,3,1
"Hibiscadelphus","Malvaceae","Malvales",0,0,0,6,0,NA
"Hibiscus","Malvaceae","Malvales",17,2,12,241,29,0.586206896551724
"Hickelia","Poaceae","Poales",1,0,0,4,1,1
"Hicoria","Juglandaceae","Fagales",0,0,0,3,0,NA
"Hicorius","Juglandaceae","Fagales",0,0,0,2,0,NA
"Hicriopteris","Gleicheniaceae","Gleicheniales",0,0,0,1,0,NA
"Hidalgoa","Asteraceae","Asterales",0,0,0,3,0,NA
"Hiepia","Apocynaceae","Gentianales",0,0,0,1,0,NA
"Hieracium","Asteraceae","Asterales",0,0,26,2241,26,0
"Hieris","Bignoniaceae","Lamiales",0,0,0,1,0,NA
"Hiernia","Orobanchaceae","Lamiales",0,0,0,1,0,NA
"Hierobotana","Verbenaceae","Lamiales",0,0,0,1,0,NA
"Hierochloe","Poaceae","Poales",0,0,10,33,10,0
"Hieronyma","Phyllanthaceae","Malpighiales",5,0,0,22,5,1
"Hieronymiella","Amaryllidaceae","Asparagales",0,0,1,8,1,0
"Hieronymusia","Saxifragaceae","Saxifragales",0,0,0,1,0,NA
"Hilairella","Ochnaceae","Malpighiales",0,0,0,1,0,NA
"Hilaria","Poaceae","Poales",0,0,1,10,1,0
"Hildebrandtia","Convolvulaceae","Solanales",2,0,0,3,2,1
"Hildegardia","Malvaceae","Malvales",1,0,0,7,1,1
"Hilgeria","Boraginaceae","UnknownOrder-Boraginaceae",0,0,0,1,0,NA
"Hillebrandia","Begoniaceae","Cucurbitales",0,0,1,1,1,0
"Hilleria","Phytolaccaceae","Caryophyllales",0,0,0,3,0,NA
"Hillia","Rubiaceae","Gentianales",2,0,0,24,2,1
"Hilliardia","Asteraceae","Asterales",0,0,0,1,0,NA
"Hilliardiella","Asteraceae","Asterales",0,0,0,8,0,NA
"Hilliella","Brassicaceae","Brassicales",0,0,0,11,0,NA
"Hilsenbergia","Boraginaceae","UnknownOrder-Boraginaceae",0,0,0,15,0,NA
"Himalaiella","Asteraceae","Asterales",0,0,2,13,2,0
"Himalayacalamus","Poaceae","Poales",0,0,0,8,0,NA
"Himalayopteris","Polypodiaceae","Polypodiales",0,0,0,1,0,NA
"Himalrandia","Rubiaceae","Gentianales",0,0,0,2,0,NA
"Himantochilus","Acanthaceae","Lamiales",0,0,0,1,0,NA
"Himantoglossum","Orchidaceae","Asparagales",0,0,1,12,1,0
"Himatanthus","Apocynaceae","Gentianales",5,0,0,13,5,1
"Hindsia","Rubiaceae","Gentianales",0,0,0,11,0,NA
"Hinterhubera","Asteraceae","Asterales",0,0,0,8,0,NA
"Hintonella","Orchidaceae","Asparagales",0,0,1,1,1,0
"Hintonia","Rubiaceae","Gentianales",1,0,0,3,1,1
"Hippeastrum","Amaryllidaceae","Asparagales",0,0,3,94,3,0
"Hippeophyllum","Orchidaceae","Asparagales",0,0,0,10,0,NA
"Hippia","Asteraceae","Asterales",0,0,0,8,0,NA
"Hippobroma","Campanulaceae","Asterales",0,0,1,1,1,0
"Hippobromus","Sapindaceae","Sapindales",1,0,0,1,1,1
"Hippochaete","Equisetaceae","Equisetales",0,0,0,1,0,NA
"Hippocratea","Celastraceae","Celastrales",5,0,0,16,5,1
"Hippocrepis","Fabaceae","Fabales",1,0,0,30,1,1
"Hippodamia","Gesneriaceae","Lamiales",0,0,0,1,0,NA
"Hippolytia","Asteraceae","Asterales",0,0,0,17,0,NA
"Hippomane","Euphorbiaceae","Malpighiales",1,0,0,3,1,1
"Hippophae","Elaeagnaceae","Rosales",2,0,0,6,2,1
"Hippotis","Rubiaceae","Gentianales",1,0,0,12,1,1
"Hippuris","Plantaginaceae","Lamiales",0,0,1,2,1,0
"Hiptage","Malpighiaceae","Malpighiales",2,0,0,13,2,1
"Hiraea","Malpighiaceae","Malpighiales",10,0,0,45,10,1
"Hirculus","Saxifragaceae","Saxifragales",0,0,0,3,0,NA
"Hirpicium","Asteraceae","Asterales",0,0,1,13,1,0
"Hirschfeldia","Brassicaceae","Brassicales",0,0,1,1,1,0
"Hirtella","Chrysobalanaceae","Malpighiales",25,0,0,109,25,1
"Hirtellina","Asteraceae","Asterales",0,0,0,2,0,NA
"Hispidella","Asteraceae","Asterales",0,0,1,1,1,0
"Histiopteris","Dennstaedtiaceae","Polypodiales",0,0,1,1,1,0
"Hitchcockella","Poaceae","Poales",0,0,0,1,0,NA
"Hitchenia","Zingiberaceae","Zingiberales",0,0,0,1,0,NA
"Hladnikia","Apiaceae","Apiales",0,0,0,1,0,NA
"Hochreutinera","Malvaceae","Malvales",0,0,0,2,0,NA
"Hockinia","Gentianaceae","Gentianales",0,0,0,1,0,NA
"Hodgkinsonia","Rubiaceae","Gentianales",1,0,0,2,1,1
"Hodgsonia","Cucurbitaceae","Cucurbitales",0,0,0,2,0,NA
"Hodgsoniola","Xanthorrhoeaceae","Asparagales",0,0,0,1,0,NA
"Hoehnea","Lamiaceae","Lamiales",0,0,0,4,0,NA
"Hoehneella","Orchidaceae","Asparagales",0,0,0,2,0,NA
"Hoehnephytum","Asteraceae","Asterales",0,0,0,3,0,NA
"Hoffmannia","Rubiaceae","Gentianales",2,0,0,131,2,1
"Hoffmanniella","Asteraceae","Asterales",0,0,0,1,0,NA
"Hoffmannseggia","Fabaceae","Fabales",0,2,18,29,18,0
"Hofmeisterella","Orchidaceae","Asparagales",0,0,1,2,1,0
"Hofmeisteria","Asteraceae","Asterales",0,0,1,12,1,0
"Hohenackeria","Apiaceae","Apiales",0,0,0,2,0,NA
"Hohenbergia","Bromeliaceae","Poales",0,0,1,62,1,0
"Hohenbergiopsis","Bromeliaceae","Poales",0,0,1,1,1,0
"Hohenmea","Bromeliaceae","Poales",0,0,0,1,0,NA
"Hoheria","Malvaceae","Malvales",4,0,0,7,4,1
"Hoita","Fabaceae","Fabales",0,0,0,2,0,NA
"Holacantha","Simaroubaceae","Sapindales",1,0,0,2,1,1
"Holarrhena","Apocynaceae","Gentianales",3,0,0,5,3,1
"Holboellia","Berberidaceae",NA,2,0,0,3,2,1
"Holboellia","Lardizabalaceae","Ranunculales",2,2,0,7,2,1
"Holcoglossum","Orchidaceae","Asparagales",0,0,1,14,1,0
"Holcolemma","Poaceae","Poales",0,0,0,3,0,NA
"Holcus","Poaceae","Poales",0,0,2,11,2,0
"Holigarna","Anacardiaceae","Sapindales",1,0,0,7,1,1
"Hollandaea","Proteaceae","Proteales",1,0,0,1,1,1
"Hollermayera","Brassicaceae","Brassicales",0,0,0,1,0,NA
"Hollisteria","Polygonaceae","Caryophyllales",0,0,0,1,0,NA
"Holmbergia","Amaranthaceae","Caryophyllales",1,0,0,1,1,1
"Holmgrenanthe","Plantaginaceae","Lamiales",0,0,0,1,0,NA
"Holmskioldia","Lamiaceae","Lamiales",1,0,0,1,1,1
"Holocalyx","Fabaceae","Fabales",1,0,0,1,1,1
"Holocarpha","Asteraceae","Asterales",0,0,0,4,0,NA
"Holocheila","Lamiaceae","Lamiales",0,0,0,1,0,NA
"Holocheilus","Asteraceae","Asterales",0,0,0,7,0,NA
"Holochlamys","Araceae","Alismatales",0,0,0,1,0,NA
"Holodictyum","Aspleniaceae","Polypodiales",0,0,0,1,0,NA
"Holodiscus","Rosaceae","Rosales",1,0,0,2,1,1
"Holographis","Acanthaceae","Lamiales",0,0,0,16,0,NA
"Hololeion","Asteraceae","Asterales",0,0,0,3,0,NA
"Hololepis","Asteraceae","Asterales",0,0,0,2,0,NA
"Holoptelea","Ulmaceae","Rosales",1,0,0,1,1,1
"Holoregmia","Martyniaceae","Lamiales",0,0,0,1,0,NA
"Holoschkuhria","Asteraceae","Asterales",0,0,0,1,0,NA
"Holostemma","Apocynaceae","Gentianales",0,0,0,1,0,NA
"Holosteum","Caryophyllaceae","Caryophyllales",0,0,0,1,0,NA
"Holostigma","Onagraceae","Myrtales",0,0,0,1,0,NA
"Holostylon","Lamiaceae","Lamiales",0,0,0,1,0,NA
"Holothrix","Orchidaceae","Asparagales",0,0,1,45,1,0
"Holozonia","Asteraceae","Asterales",0,0,0,1,0,NA
"Holstianthus","Rubiaceae","Gentianales",0,0,0,1,0,NA
"Holttumia","Pteridaceae","Polypodiales",0,0,0,1,0,NA
"Holttumochloa","Poaceae","Poales",0,0,0,3,0,NA
"Holubia","Pedaliaceae","Lamiales",0,0,0,1,0,NA
"Holzneria","Plantaginaceae","Lamiales",0,0,0,1,0,NA
"Homalanthus","Euphorbiaceae","Malpighiales",6,0,0,23,6,1
"Homalium","Salicaceae","Malpighiales",12,0,0,67,12,1
"Homalobus","Fabaceae","Fabales",0,0,0,4,0,NA
"Homalocalyx","Myrtaceae","Myrtales",3,0,0,11,3,1
"Homalocarpus","Apiaceae","Apiales",0,0,1,6,1,0
"Homalodiscus","Resedaceae","Brassicales",0,0,1,1,1,0
"Homalomena","Araceae","Alismatales",0,0,0,124,0,NA
"Homalopetalum","Orchidaceae","Asparagales",0,0,2,8,2,0
"Homalospermum","Myrtaceae","Myrtales",1,0,0,1,1,1
"Homeria","Iridaceae","Asparagales",0,0,2,2,2,0
"Homocodon","Campanulaceae","Asterales",0,0,0,2,0,NA
"Homogyne","Asteraceae","Asterales",0,0,2,2,2,0
"Homoianthus","Asteraceae","Asterales",0,0,0,1,0,NA
"Homolepis","Poaceae","Poales",0,0,1,5,1,0
"Homollea","Rubiaceae","Gentianales",0,0,0,3,0,NA
"Homolliella","Rubiaceae","Gentianales",0,0,0,1,0,NA
"Homonoia","Euphorbiaceae","Malpighiales",1,0,0,3,1,1
"Homopholis","Poaceae","Poales",0,0,0,1,0,NA
"Homoranthus","Myrtaceae","Myrtales",7,0,0,23,7,1
"Homozeugos","Poaceae","Poales",0,0,0,6,0,NA
"Honckenya","Caryophyllaceae","Caryophyllales",0,0,1,1,1,0
"Hoodia","Apocynaceae","Gentianales",0,0,0,27,0,NA
"Hoodiopsis","Apocynaceae","Gentianales",0,0,0,1,0,NA
"Hookerella","Loranthaceae","Santalales",0,0,0,1,0,NA
"Hoorebekia","Asteraceae","Asterales",0,0,0,3,0,NA
"Hopea","Dipterocarpaceae","Malvales",5,0,0,9,5,1
"Hopkinsia","Anarthriaceae","Poales",0,0,2,2,2,0
"Hopkirkia","Asteraceae","Asterales",0,0,0,1,0,NA
"Hoplestigma","Boraginaceae","UnknownOrder-Boraginaceae",0,0,0,1,0,NA
"Hoplophyllum","Asteraceae","Asterales",1,0,0,2,1,1
"Hoppea","Gentianaceae","Gentianales",0,0,0,2,0,NA
"Horaninovia","Amaranthaceae","Caryophyllales",0,0,1,2,1,0
"Horanthes","Cistaceae","Malvales",0,0,0,1,0,NA
"Hordelymus","Poaceae","Poales",0,0,1,1,1,0
"Hordeum","Poaceae","Poales",0,0,31,43,31,0
"Horichia","Orchidaceae","Asparagales",0,0,1,1,1,0
"Horkelia","Rosaceae","Rosales",0,0,0,10,0,NA
"Horkeliella","Rosaceae","Rosales",0,0,0,2,0,NA
"Hormathophylla","Brassicaceae","Brassicales",0,0,0,1,0,NA
"Horminum","Lamiaceae","Lamiales",0,0,1,1,1,0
"Hornschuchia","Annonaceae","Magnoliales",1,0,0,10,1,1
"Hornstedtia","Zingiberaceae","Zingiberales",0,0,0,33,0,NA
"Hornungia","Brassicaceae","Brassicales",0,0,3,5,3,0
"Horsfieldia","Myristicaceae","Magnoliales",9,0,0,19,9,1
"Horsfordia","Malvaceae","Malvales",0,0,0,4,0,NA
"Hortia","Rutaceae","Sapindales",3,0,0,11,3,1
"Horvatia","Orchidaceae","Asparagales",0,0,0,1,0,NA
"Horwoodia","Brassicaceae","Brassicales",0,0,0,1,0,NA
"Hosackia","Fabaceae","Fabales",0,0,0,15,0,NA
"Hosea","Lamiaceae","Lamiales",0,0,0,1,0,NA
"Hosiea","Icacinaceae","UnknownOrder-Icacinaceae",1,0,0,1,1,1
"Hoslundia","Lamiaceae","Lamiales",1,0,0,1,1,1
"Hosta","Asparagaceae","Asparagales",0,0,3,23,3,0
"Hottea","Myrtaceae","Myrtales",0,0,0,9,0,NA
"Hottonia","Primulaceae","Ericales",0,0,2,2,2,0
"Houlletia","Orchidaceae","Asparagales",0,0,3,9,3,0
"Houssayanthus","Sapindaceae","Sapindales",0,0,0,5,0,NA
"Houstonia","Rubiaceae","Gentianales",0,0,1,23,1,0
"Houttea","Gesneriaceae","Lamiales",0,0,0,1,0,NA
"Houttuynia","Saururaceae","Piperales",0,0,1,1,1,0
"Hovanella","Gesneriaceae","Lamiales",0,0,0,2,0,NA
"Hovea","Fabaceae","Fabales",5,0,0,38,5,1
"Hovenia","Rhamnaceae","Rosales",1,0,0,3,1,1
"Hoverdenia","Acanthaceae","Lamiales",0,0,0,1,0,NA
"Howea","Arecaceae","Arecales",2,0,0,2,2,1
"Howellanthus","Boraginaceae","UnknownOrder-Boraginaceae",0,0,0,1,0,NA
"Howellia","Campanulaceae","Asterales",0,0,0,1,0,NA
"Hoya","Apocynaceae","Gentianales",1,0,0,51,1,1
"Hua","Huaceae","Oxalidales",0,0,0,1,0,NA
"Huanaca","Apiaceae","Apiales",0,0,0,4,0,NA
"Huarpea","Asteraceae","Asterales",0,0,0,1,0,NA
"Hubbardia","Poaceae","Poales",0,0,0,1,0,NA
"Hubbardochloa","Poaceae","Poales",0,0,0,1,0,NA
"Huberia","Melastomataceae","Myrtales",0,0,0,15,0,NA
"Huberodendron","Malvaceae","Malvales",2,0,0,3,2,1
"Huberopappus","Asteraceae","Asterales",0,0,0,1,0,NA
"Hubertia","Asteraceae","Asterales",0,0,0,22,0,NA
"Hudsonia","Cistaceae","Malvales",1,0,0,5,1,1
"Hueblia","Plantaginaceae","Lamiales",0,0,0,1,0,NA
"Huernia","Apocynaceae","Gentianales",0,0,0,43,0,NA
"Huerniopsis","Apocynaceae","Gentianales",0,0,0,3,0,NA
"Huertea","Tapisciaceae","Huerteales",4,0,0,4,4,1
"Hufelandia","Lauraceae","Laurales",0,0,0,1,0,NA
"Hugelia","Polemoniaceae","Ericales",0,0,0,1,0,NA
"Hugeria","Ericaceae","Ericales",0,0,0,1,0,NA
"Hughesia","Asteraceae","Asterales",0,0,0,1,0,NA
"Hugonia","Linaceae","Malpighiales",1,0,0,24,1,1
"Hugueninia","Brassicaceae","Brassicales",0,0,0,1,0,NA
"Huidobria","Loasaceae","Cornales",1,0,1,2,2,0.5
"Huilaea","Melastomataceae","Myrtales",0,0,0,3,0,NA
"Hullettia","Moraceae","Rosales",0,0,0,1,0,NA
"Hullsia","Asteraceae","Asterales",0,0,0,1,0,NA
"Hulsea","Asteraceae","Asterales",0,0,1,7,1,0
"Hulteniella","Asteraceae","Asterales",0,0,0,1,0,NA
"Humata","Davalliaceae","Polypodiales",0,0,0,8,0,NA
"Humbertacalia","Asteraceae","Asterales",0,0,0,7,0,NA
"Humbertia","Convolvulaceae","Solanales",1,0,0,1,1,1
"Humbertiella","Malvaceae","Malvales",2,0,0,5,2,1
"Humbertiodendron","Trigoniaceae","Malpighiales",0,0,0,1,0,NA
"Humbertioturraea","Meliaceae","Sapindales",0,0,0,6,0,NA
"Humbertochloa","Poaceae","Poales",0,0,0,2,0,NA
"Humboldtia","Fabaceae","Fabales",0,0,0,7,0,NA
"Humboldtia","Orchidaceae",NA,0,0,0,2,0,NA
"Humeocline","Asteraceae","Asterales",0,0,0,1,0,NA
"Humiria","Humiriaceae","Malpighiales",1,0,0,4,1,1
"Humiriastrum","Humiriaceae","Malpighiales",8,0,0,16,8,1
"Humularia","Fabaceae","Fabales",0,0,0,33,0,NA
"Humulus","Cannabaceae","Rosales",0,0,1,3,1,0
"Hunga","Chrysobalanaceae","Malpighiales",6,0,0,11,6,1
"Hunnemannia","Papaveraceae","Ranunculales",0,0,0,2,0,NA
"Hunteria","Apocynaceae","Gentianales",1,0,0,12,1,1
"Huntleya","Orchidaceae","Asparagales",0,0,1,14,1,0
"Hunzikeria","Solanaceae","Solanales",0,0,0,3,0,NA
"Huodendron","Styracaceae","Ericales",2,0,0,3,2,1
"Huperzia","Lycopodiaceae","Lycopodiales",0,0,237,250,237,0
"Hura","Euphorbiaceae","Malpighiales",2,0,0,2,2,1
"Hutchinsia","Brassicaceae","Brassicales",0,0,0,2,0,NA
"Hutchinsonia","Rubiaceae","Gentianales",0,0,0,2,0,NA
"Huttonaea","Orchidaceae","Asparagales",0,0,0,5,0,NA
"Hyacinthella","Asparagaceae","Asparagales",0,0,2,17,2,0
"Hyacinthoides","Asparagaceae","Asparagales",0,0,1,12,1,0
"Hyacinthus","Asparagaceae","Asparagales",0,0,1,3,1,0
"Hyaenanche","Picrodendraceae","Malpighiales",1,0,0,1,1,1
"Hyalea","Asteraceae","Asterales",0,0,0,1,0,NA
"Hyalis","Asteraceae","Asterales",1,0,0,2,1,1
"Hyalocalyx","Passifloraceae","Malpighiales",0,0,0,1,0,NA
"Hyalochaete","Asteraceae","Asterales",0,0,0,1,0,NA
"Hyalochlamys","Asteraceae","Asterales",0,0,0,1,0,NA
"Hyalolaena","Apiaceae","Apiales",0,0,0,4,0,NA
"Hyaloseris","Asteraceae","Asterales",0,0,0,7,0,NA
"Hyalosperma","Asteraceae","Asterales",0,0,3,9,3,0
"Hybanthera","Apocynaceae","Gentianales",0,0,0,1,0,NA
"Hybanthopsis","Violaceae","Malpighiales",0,0,0,1,0,NA
"Hybanthus","Violaceae","Malpighiales",1,0,1,70,2,0.5
"Hybosema","Fabaceae","Fabales",2,0,0,2,2,1
"Hybridella","Asteraceae","Asterales",0,0,0,1,0,NA
"Hydatica","Saxifragaceae","Saxifragales",0,0,0,1,0,NA
"Hydnocarpus","Achariaceae","Malpighiales",1,0,0,6,1,1
"Hydnophytum","Rubiaceae","Gentianales",0,1,0,94,0,NA
"Hydnora","Hydnoraceae","Piperales",0,0,1,7,1,0
"Hydrangea","Hydrangeaceae","Cornales",11,0,0,52,11,1
"Hydrastis","Ranunculaceae","Ranunculales",0,0,1,1,1,0
"Hydriastele","Arecaceae","Arecales",8,0,0,48,8,1
"Hydrilla","Hydrocharitaceae","Alismatales",0,0,1,1,1,0
"Hydrobryopsis","Podostemaceae","Malpighiales",0,0,0,1,0,NA
"Hydrobryum","Podostemaceae","Malpighiales",0,0,2,5,2,0
"Hydrocera","Balsaminaceae","Ericales",0,0,0,1,0,NA
"Hydrocharis","Hydrocharitaceae","Alismatales",0,0,2,3,2,0
"Hydrochorea","Fabaceae","Fabales",2,0,0,3,2,1
"Hydrocleys","Alismataceae","Alismatales",0,0,1,5,1,0
"Hydrocotyle","Araliaceae","Apiales",4,0,6,99,10,0.4
"Hydrogaster","Malvaceae","Malvales",1,0,0,1,1,1
"Hydroidea","Asteraceae","Asterales",0,0,0,1,0,NA
"Hydrolea","Hydroleaceae","Solanales",0,0,2,11,2,0
"Hydropectis","Asteraceae","Asterales",0,0,0,3,0,NA
"Hydrophilus","Restionaceae","Poales",0,0,1,1,1,0
"Hydrophylax","Rubiaceae","Gentianales",0,0,0,2,0,NA
"Hydrophyllum","Boraginaceae","UnknownOrder-Boraginaceae",0,0,5,10,5,0
"Hydrostachys","Hydrostachyaceae","Cornales",0,0,2,19,2,0
"Hydrostemma","Nymphaeaceae","Nymphaeales",0,0,0,1,0,NA
"Hydrothauma","Poaceae","Poales",0,0,0,1,0,NA
"Hydrothrix","Pontederiaceae","Commelinales",0,0,1,1,1,0
"Hydrotriche","Plantaginaceae","Lamiales",0,0,1,3,1,0
"Hydrotrida","Plantaginaceae","Lamiales",0,0,0,2,0,NA
"Hygrochilus","Orchidaceae","Asparagales",0,0,1,1,1,0
"Hygrochloa","Poaceae","Poales",0,0,0,2,0,NA
"Hygrophila","Acanthaceae","Lamiales",0,0,6,46,6,0
"Hygroryza","Poaceae","Poales",0,0,0,1,0,NA
"Hylaea","Apocynaceae","Gentianales",0,0,0,2,0,NA
"Hylaeanthe","Marantaceae","Zingiberales",0,0,1,5,1,0
"Hylaeorchis","Orchidaceae","Asparagales",0,0,1,1,1,0
"Hylandia","Euphorbiaceae","Malpighiales",1,0,0,1,1,1
"Hylebates","Poaceae","Poales",0,0,0,2,0,NA
"Hylenaea","Celastraceae","Celastrales",2,0,0,3,2,1
"Hylocarpa","Humiriaceae","Malpighiales",0,0,0,1,0,NA
"Hylocereus","Cactaceae","Caryophyllales",0,0,0,15,0,NA
"Hylodendron","Fabaceae","Fabales",1,0,0,1,1,1
"Hylodesmum","Fabaceae","Fabales",0,0,0,16,0,NA
"Hylomecon","Papaveraceae","Ranunculales",0,0,0,2,0,NA
"Hylophila","Orchidaceae","Asparagales",0,0,0,7,0,NA
"Hylotelephium","Crassulaceae","Saxifragales",0,0,1,17,1,0
"Hymenachne","Poaceae","Poales",0,0,2,7,2,0
"Hymenaea","Fabaceae","Fabales",7,0,0,16,7,1
"Hymenandra","Primulaceae","Ericales",0,0,0,9,0,NA
"Hymenanthes","Ericaceae","Ericales",0,0,0,4,0,NA
"Hymenidium","Apiaceae","Apiales",0,0,0,2,0,NA
"Hymenocallis","Amaryllidaceae","Asparagales",0,0,4,66,4,0
"Hymenocardia","Phyllanthaceae","Malpighiales",3,0,0,6,3,1
"Hymenocarpos","Fabaceae","Fabales",0,0,0,1,0,NA
"Hymenocephalus","Asteraceae","Asterales",0,0,0,1,0,NA
"Hymenochlaena","Acanthaceae","Lamiales",0,0,0,1,0,NA
"Hymenoclea","Asteraceae","Asterales",0,0,0,1,0,NA
"Hymenocoleus","Rubiaceae","Gentianales",0,0,0,12,0,NA
"Hymenocrater","Lamiaceae","Lamiales",0,0,0,12,0,NA
"Hymenocyclus","Aizoaceae","Caryophyllales",0,0,0,1,0,NA
"Hymenodictyon","Rubiaceae","Gentianales",6,0,0,23,6,1
"Hymenoglossum","Hymenophyllaceae","Hymenophyllales",0,0,0,1,0,NA
"Hymenogyne","Aizoaceae","Caryophyllales",0,0,0,2,0,NA
"Hymenolepis","Asteraceae","Asterales",1,0,0,7,1,1
"Hymenolobium","Fabaceae","Fabales",7,0,0,15,7,1
"Hymenolyma","Apiaceae","Apiales",0,0,0,1,0,NA
"Hymenonema","Asteraceae","Asterales",0,0,0,3,0,NA
"Hymenopappus","Asteraceae","Asterales",0,1,0,13,0,NA
"Hymenophyllopsis","Cyatheaceae","Cyatheales",0,0,0,8,0,NA
"Hymenophyllum","Hymenophyllaceae","Hymenophyllales",0,0,6,172,6,0
"Hymenopyramis","Lamiaceae","Lamiales",0,0,0,7,0,NA
"Hymenorchis","Orchidaceae","Asparagales",0,0,1,12,1,0
"Hymenosicyos","Cucurbitaceae","Cucurbitales",0,0,0,2,0,NA
"Hymenostegia","Fabaceae","Fabales",2,0,0,16,2,1
"Hymenostemma","Asteraceae","Asterales",0,0,0,1,0,NA
"Hymenostephium","Asteraceae","Asterales",0,0,0,8,0,NA
"Hymenothrix","Asteraceae","Asterales",0,0,0,6,0,NA
"Hymenoxys","Asteraceae","Asterales",0,0,1,26,1,0
"Hyobanche","Orobanchaceae","Lamiales",0,0,4,8,4,0
"Hyophorbe","Arecaceae","Arecales",5,0,0,5,5,1
"Hyoscyamus","Solanaceae","Solanales",0,0,1,10,1,0
"Hyoseris","Asteraceae","Asterales",0,0,3,12,3,0
"Hyospathe","Arecaceae","Arecales",2,0,0,4,2,1
"Hypacanthium","Asteraceae","Asterales",0,0,0,2,0,NA
"Hypagophytum","Crassulaceae","Saxifragales",0,0,0,1,0,NA
"Hyparrhenia","Poaceae","Poales",0,0,2,56,2,0
"Hypechusa","Fabaceae","Fabales",0,0,0,5,0,NA
"Hypecoum","Papaveraceae","Ranunculales",0,0,1,15,1,0
"Hypelate","Sapindaceae","Sapindales",1,0,0,1,1,1
"Hypenia","Lamiaceae","Lamiales",0,0,0,25,0,NA
"Hyperacanthus","Rubiaceae","Gentianales",3,0,0,11,3,1
"Hyperbaena","Menispermaceae","Ranunculales",6,0,0,20,6,1
"Hypericophyllum","Asteraceae","Asterales",0,0,0,11,0,NA
"Hypericum","Hypericaceae","Malpighiales",5,0,14,458,19,0.263157894736842
"Hypertelis","Molluginaceae","Caryophyllales",0,1,0,7,0,NA
"Hyperthelia","Poaceae","Poales",0,0,0,7,0,NA
"Hyphaene","Arecaceae","Arecales",4,0,0,8,4,1
"Hypobathrum","Rubiaceae","Gentianales",2,0,0,30,2,1
"Hypocalymma","Myrtaceae","Myrtales",7,0,0,23,7,1
"Hypocalyptus","Fabaceae","Fabales",2,0,0,3,2,1
"Hypochaeris","Asteraceae","Asterales",0,0,18,85,18,0
"Hypochoeris","Asteraceae","Asterales",0,0,0,1,0,NA
"Hypocyrta","Gesneriaceae","Lamiales",0,0,0,1,0,NA
"Hypodaphnis","Lauraceae","Laurales",1,0,0,1,1,1
"Hypoderris","Tectariaceae","Polypodiales",0,0,0,1,0,NA
"Hypodiscus","Restionaceae","Poales",0,0,3,15,3,0
"Hypoestes","Acanthaceae","Lamiales",1,0,0,104,1,1
"Hypogomphia","Lamiaceae","Lamiales",0,0,0,3,0,NA
"Hypolaena","Restionaceae","Poales",0,0,2,7,2,0
"Hypolepis","Dennstaedtiaceae","Polypodiales",0,0,2,52,2,0
"Hypolobus","Apocynaceae","Gentianales",0,0,0,1,0,NA
"Hypolytrum","Cyperaceae","Poales",0,0,3,60,3,0
"Hypopeltis","Dryopteridaceae","Polypodiales",0,0,0,1,0,NA
"Hypopitys","Ericaceae","Ericales",0,0,0,3,0,NA
"Hypoxidia","Hypoxidaceae","Asparagales",0,0,0,2,0,NA
"Hypoxis","Hypoxidaceae","Asparagales",0,0,20,93,20,0
"Hypselandra","Capparaceae","Brassicales",0,0,0,1,0,NA
"Hypselodelphys","Marantaceae","Zingiberales",0,0,3,7,3,0
"Hypseocharis","Geraniaceae","Geraniales",0,0,1,8,1,0
"Hypseochloa","Poaceae","Poales",0,0,0,2,0,NA
"Hypserpa","Menispermaceae","Ranunculales",1,1,0,3,1,1
"Hyptianthera","Rubiaceae","Gentianales",0,0,0,1,0,NA
"Hyptidendron","Lamiaceae","Lamiales",1,0,0,16,1,1
"Hyptis","Lamiaceae","Lamiales",6,0,6,295,12,0.5
"Hyssopus","Lamiaceae","Lamiales",0,1,0,7,0,NA
"Hysterionica","Asteraceae","Asterales",1,0,0,14,1,1
"Hystrichophora","Asteraceae","Asterales",0,0,0,1,0,NA
"Hystrix","Poaceae","Poales",0,0,4,9,4,0
"Ianhedgea","Brassicaceae","Brassicales",0,0,1,1,1,0
"Ianthopappus","Asteraceae","Asterales",0,0,0,1,0,NA
"Iberidella","Brassicaceae","Brassicales",0,0,0,1,0,NA
"Iberis","Brassicaceae","Brassicales",0,1,2,29,2,0
"Ibervillea","Cucurbitaceae","Cucurbitales",1,3,0,6,1,1
"Ibicella","Martyniaceae","Lamiales",0,0,1,3,1,0
"Icacina","Icacinaceae","UnknownOrder-Icacinaceae",3,0,0,5,3,1
"Icaria","Melastomataceae","Myrtales",0,0,0,1,0,NA
"Ichnanthus","Poaceae","Poales",0,0,1,31,1,0
"Ichnocarpus","Apocynaceae","Gentianales",0,1,0,3,0,NA
"Ichthyothere","Asteraceae","Asterales",0,0,1,24,1,0
"Ichtyoselmis","Papaveraceae","Ranunculales",0,0,0,1,0,NA
"Icianthus","Brassicaceae","Brassicales",0,0,0,1,0,NA
"Icosinia","Malvaceae","Malvales",0,0,0,1,0,NA
"Icuria","Fabaceae","Fabales",0,0,0,1,0,NA
"Idahoa","Brassicaceae","Brassicales",0,0,1,1,1,0
"Idertia","Ochnaceae","Malpighiales",0,0,0,2,0,NA
"Idesia","Salicaceae","Malpighiales",1,0,0,1,1,1
"Idiopappus","Asteraceae","Asterales",1,0,0,1,1,1
"Idiopteris","Pteridaceae","Polypodiales",0,0,1,1,1,0
"Idiospermum","Calycanthaceae","Laurales",1,0,0,1,1,1
"Idiothamnus","Asteraceae","Asterales",0,0,0,4,0,NA
"Idria","Fouquieriaceae","Ericales",0,0,0,1,0,NA
"Ifloga","Asteraceae","Asterales",0,0,2,16,2,0
"Ignurbia","Asteraceae","Asterales",0,0,0,1,0,NA
"Iguanura","Arecaceae","Arecales",2,0,0,32,2,1
"Ihlenfeldtia","Aizoaceae","Caryophyllales",0,0,0,2,0,NA
"Ikonnikovia","Plumbaginaceae","Caryophyllales",0,0,0,1,0,NA
"Ildefonsia","Plantaginaceae","Lamiales",0,0,0,1,0,NA
"Ilex","Aquifoliaceae","Aquifoliales",123,0,0,475,123,1
"Iliamna","Malvaceae","Malvales",0,1,0,8,0,NA
"Iljinia","Amaranthaceae","Caryophyllales",1,0,0,1,1,1
"Illecebrum","Caryophyllaceae","Caryophyllales",0,0,1,1,1,0
"Illicium","Schisandraceae","Austrobaileyales",17,0,0,32,17,1
"Illigera","Hernandiaceae","Laurales",5,0,0,18,5,1
"Iltisia","Asteraceae","Asterales",0,0,0,2,0,NA
"Ilysanthes","Linderniaceae","Lamiales",0,0,0,5,0,NA
"Imeria","Asteraceae","Asterales",0,0,0,2,0,NA
"Imerinaea","Orchidaceae","Asparagales",0,0,0,1,0,NA
"Impatiens","Balsaminaceae","Ericales",1,0,27,487,28,0.0357142857142857
"Imperata","Poaceae","Poales",0,0,2,11,2,0
"Incarum","Araceae","Alismatales",0,0,1,1,1,0
"Incarvillea","Bignoniaceae","Lamiales",0,0,0,17,0,NA
"India","Orchidaceae","Asparagales",0,0,0,1,0,NA
"Indianthus","Marantaceae","Zingiberales",0,0,0,1,0,NA
"Indigastrum","Fabaceae","Fabales",0,0,0,9,0,NA
"Indigofera","Fabaceae","Fabales",3,0,5,674,8,0.375
"Indocalamus","Poaceae","Poales",2,0,0,28,2,1
"Indofevillea","Cucurbitaceae","Cucurbitales",0,1,0,1,0,NA
"Indopiptadenia","Fabaceae","Fabales",1,0,0,1,1,1
"Indopoa","Poaceae","Poales",0,0,0,1,0,NA
"Indorouchera","Linaceae","Malpighiales",0,0,0,1,0,NA
"Indosasa","Poaceae","Poales",0,0,0,20,0,NA
"Indoschulzia","Apiaceae","Apiales",0,0,0,2,0,NA
"Indosinia","Ochnaceae","Malpighiales",0,0,0,1,0,NA
"Indotristicha","Podostemaceae","Malpighiales",0,0,0,1,0,NA
"Inezia","Asteraceae","Asterales",0,0,0,2,0,NA
"Inga","Fabaceae","Fabales",92,0,0,381,92,1
"Inhambanella","Sapotaceae","Ericales",2,0,0,2,2,1
"Inkaliabum","Asteraceae","Asterales",0,0,0,1,0,NA
"Inocarpus","Fabaceae","Fabales",1,0,0,2,1,1
"Inopsidium","Brassicaceae","Brassicales",0,0,0,1,0,NA
"Inti","Orchidaceae","Asparagales",0,0,2,2,2,0
"Intsia","Fabaceae","Fabales",2,0,0,8,2,1
"Inula","Asteraceae","Asterales",1,0,9,110,10,0.1
"Inulanthera","Asteraceae","Asterales",0,0,0,10,0,NA
"Inuleae","Asteraceae","Asterales",0,0,0,2,0,NA
"Inuloides","Asteraceae","Asterales",0,0,0,1,0,NA
"Inulopsis","Asteraceae","Asterales",0,0,0,3,0,NA
"Inversodicraea","Podostemaceae","Malpighiales",0,0,0,4,0,NA
"Io","Asteraceae","Asterales",0,0,0,1,0,NA
"Iocenes","Asteraceae","Asterales",0,0,0,1,0,NA
"Iochroma","Solanaceae","Solanales",1,0,0,23,1,1
"Iodanthus","Brassicaceae","Brassicales",0,0,1,2,1,0
"Iodes","Icacinaceae","UnknownOrder-Icacinaceae",6,0,0,15,6,1
"Iodocephalopsis","Asteraceae","Asterales",0,0,0,1,0,NA
"Iodocephalus","Asteraceae","Asterales",0,0,0,1,0,NA
"Iogeton","Asteraceae","Asterales",0,0,0,1,0,NA
"Ionacanthus","Acanthaceae","Lamiales",0,0,0,1,0,NA
"Ionactis","Asteraceae","Asterales",0,0,0,5,0,NA
"Ionidium","Violaceae","Malpighiales",0,0,0,1,0,NA
"Ionopsis","Orchidaceae","Asparagales",0,0,3,6,3,0
"Iostephane","Asteraceae","Asterales",0,0,0,4,0,NA
"Iotasperma","Asteraceae","Asterales",0,0,0,2,0,NA
"Ipheion","Amaryllidaceae","Asparagales",0,0,2,2,2,0
"Iphigenia","Colchicaceae","Liliales",0,0,2,13,2,0
"Iphiona","Asteraceae","Asterales",0,0,0,9,0,NA
"Iphionopsis","Asteraceae","Asterales",0,0,0,1,0,NA
"Ipomoea","Convolvulaceae","Solanales",3,3,11,449,14,0.214285714285714
"Ipomopsis","Polemoniaceae","Ericales",1,0,0,29,1,1
"Ipsea","Orchidaceae","Asparagales",0,0,0,3,0,NA
"Iranecio","Asteraceae","Asterales",0,0,0,16,0,NA
"Irenella","Amaranthaceae","Caryophyllales",0,0,0,1,0,NA
"Irenepharsus","Brassicaceae","Brassicales",0,0,0,3,0,NA
"Iresine","Amaranthaceae","Caryophyllales",2,0,1,38,3,0.666666666666667
"Iriartea","Arecaceae","Arecales",1,0,0,1,1,1
"Iriartella","Arecaceae","Arecales",2,0,0,2,2,1
"Iridosma","Simaroubaceae","Sapindales",0,0,0,1,0,NA
"Iris","Iridaceae","Asparagales",0,0,211,362,211,0
"Irlbachia","Gentianaceae","Gentianales",0,0,0,14,0,NA
"Irvingbaileya","Stemonuraceae","Aquifoliales",1,0,0,1,1,1
"Irvingia","Irvingiaceae","Malpighiales",4,0,0,7,4,1
"Irwinia","Asteraceae","Asterales",0,0,0,1,0,NA
"Iryanthera","Myristicaceae","Magnoliales",11,0,0,21,11,1
"Isabelia","Orchidaceae","Asparagales",0,0,1,4,1,0
"Isachne","Poaceae","Poales",1,0,2,91,3,0.333333333333333
"Isandrina","Fabaceae","Fabales",0,0,0,1,0,NA
"Isanitella","Orchidaceae","Asparagales",0,0,0,1,0,NA
"Isatis","Brassicaceae","Brassicales",0,0,1,80,1,0
"Ischaemum","Poaceae","Poales",0,0,5,81,5,0
"Ischnea","Asteraceae","Asterales",0,0,0,5,0,NA
"Ischnogyne","Orchidaceae","Asparagales",0,0,0,1,0,NA
"Ischnolepis","Apocynaceae","Gentianales",0,0,0,1,0,NA
"Ischnosiphon","Marantaceae","Zingiberales",0,0,6,36,6,0
"Ischnostemma","Apocynaceae","Gentianales",0,0,0,1,0,NA
"Iseia","Convolvulaceae","Solanales",1,0,0,1,1,1
"Iseilema","Poaceae","Poales",0,0,0,25,0,NA
"Isertia","Rubiaceae","Gentianales",8,0,0,14,8,1
"Isexina","Capparaceae","Brassicales",0,0,0,1,0,NA
"Isgarum","Amaranthaceae","Caryophyllales",0,0,0,1,0,NA
"Isidorea","Rubiaceae","Gentianales",1,0,0,17,1,1
"Isidrogalvia","Tofieldiaceae","Alismatales",0,0,0,11,0,NA
"Iskandera","Brassicaceae","Brassicales",0,0,0,2,0,NA
"Islaya","Cactaceae","Caryophyllales",0,0,0,1,0,NA
"Ismelia","Asteraceae","Asterales",0,0,0,1,0,NA
"Ismene","Amaryllidaceae","Asparagales",0,0,3,11,3,0
"Isnardia","Onagraceae","Myrtales",0,0,0,3,0,NA
"Isoberlinia","Fabaceae","Fabales",4,0,0,5,4,1
"Isocarpha","Asteraceae","Asterales",0,0,0,5,0,NA
"Isochilus","Orchidaceae","Asparagales",0,0,2,13,2,0
"Isocoma","Asteraceae","Asterales",2,0,0,15,2,1
"Isodendrion","Violaceae","Malpighiales",0,0,0,12,0,NA
"Isodon","Lamiaceae","Lamiales",1,0,4,107,5,0.2
"Isoetella","Isoëtaceae","Isoetales",0,0,1,1,1,0
"Isoetes","Isoëtaceae","Isoetales",0,0,42,84,42,0
"Isoetopsis","Asteraceae","Asterales",0,0,1,1,1,0
"Isoglossa","Acanthaceae","Lamiales",1,1,1,48,2,0.5
"Isolatocereus","Cactaceae","Caryophyllales",0,0,0,1,0,NA
"Isolepis","Cyperaceae","Poales",0,0,44,77,44,0
"Isoleucas","Lamiaceae","Lamiales",0,0,0,2,0,NA
"Isoloba","Lentibulariaceae","Lamiales",0,0,0,2,0,NA
"Isoloma","Gesneriaceae",NA,0,0,0,1,0,NA
"Isoloma","Lindsaeaceae","Polypodiales",0,0,0,4,0,NA
"Isolona","Annonaceae","Magnoliales",4,0,0,14,4,1
"Isomacrolobium","Fabaceae","Fabales",0,0,0,13,0,NA
"Isometrum","Gesneriaceae","Lamiales",0,0,0,1,0,NA
"Isonandra","Sapotaceae","Ericales",1,0,0,10,1,1
"Isonema","Apocynaceae","Gentianales",1,0,0,3,1,1
"Isophysis","Iridaceae","Asparagales",0,0,1,1,1,0
"Isoplexis","Plantaginaceae","Lamiales",0,0,0,1,0,NA
"Isopogon","Proteaceae","Proteales",2,0,0,2,2,1
"Isopyrum","Ranunculaceae","Ranunculales",0,0,0,6,0,NA
"Isostigma","Asteraceae","Asterales",0,0,0,15,0,NA
"Isotheca","Acanthaceae","Lamiales",0,0,0,1,0,NA
"Isotoma","Campanulaceae","Asterales",0,0,9,13,9,0
"Isotria","Orchidaceae","Asparagales",0,0,2,2,2,0
"Isotropis","Fabaceae","Fabales",1,0,0,12,1,1
"Itasina","Apiaceae","Apiales",0,0,0,1,0,NA
"Itaya","Arecaceae","Arecales",1,0,0,1,1,1
"Itea","Iteaceae","Saxifragales",3,0,0,17,3,1
"Iteadaphne","Lauraceae","Laurales",1,0,0,1,1,1
"Ithycaulon","Saccolomataceae","Polypodiales",0,0,0,1,0,NA
"Itoa","Salicaceae","Malpighiales",0,0,0,1,0,NA
"Ituterion","Vitaceae","Vitales",0,0,0,1,0,NA
"Itzaea","Convolvulaceae","Solanales",0,1,0,1,0,NA
"Iva","Asteraceae","Asterales",0,1,0,12,0,NA
"Ivesia","Rosaceae","Rosales",0,0,0,6,0,NA
"Ivodea","Rutaceae","Sapindales",0,0,0,11,0,NA
"Ixanthus","Gentianaceae","Gentianales",0,0,0,1,0,NA
"Ixerba","Strasburgeriaceae","Crossosomatales",1,0,0,1,1,1
"Ixeridium","Asteraceae","Asterales",0,0,0,16,0,NA
"Ixeris","Asteraceae","Asterales",0,0,3,23,3,0
"Ixia","Iridaceae","Asparagales",0,0,41,66,41,0
"Ixianthes","Stilbaceae","Lamiales",1,0,0,1,1,1
"Ixidium","Santalaceae","Santalales",0,0,0,1,0,NA
"Ixiochlamys","Asteraceae","Asterales",0,0,0,4,0,NA
"Ixiolaena","Asteraceae","Asterales",0,0,0,1,0,NA
"Ixiolirion","Ixioliriaceae","Asparagales",0,0,1,4,1,0
"Ixoca","Caryophyllaceae","Caryophyllales",0,0,0,2,0,NA
"Ixocactus","Loranthaceae","Santalales",1,0,0,5,1,1
"Ixodia","Asteraceae","Asterales",0,0,0,1,0,NA
"Ixodonerium","Apocynaceae","Gentianales",0,0,0,1,0,NA
"Ixonanthes","Ixonanthaceae","Malpighiales",2,0,0,2,2,1
"Ixophorus","Poaceae","Poales",0,0,1,1,1,0
"Ixora","Rubiaceae","Gentianales",26,0,0,544,26,1
"Ixorhea","Boraginaceae","UnknownOrder-Boraginaceae",0,0,0,1,0,NA
"Ixtlania","Acanthaceae","Lamiales",0,0,0,1,0,NA
"Ixyophora","Orchidaceae","Asparagales",0,0,2,5,2,0
"Izozogia","Zygophyllaceae","Zygophyllales",0,0,0,1,0,NA
"Jablonskia","Phyllanthaceae","Malpighiales",1,0,0,1,1,1
"Jaborosa","Solanaceae","Solanales",0,0,0,24,0,NA
"Jacaranda","Bignoniaceae","Lamiales",17,0,0,48,17,1
"Jacaratia","Caricaceae","Brassicales",5,0,0,7,5,1
"Jacea","Asteraceae","Asterales",0,0,0,1,0,NA
"Jackiopsis","Rubiaceae","Gentianales",1,0,0,1,1,1
"Jacksonago","Fabaceae","Fabales",0,0,0,5,0,NA
"Jacksonia","Fabaceae","Fabales",2,0,0,37,2,1
"Jacmaia","Asteraceae","Asterales",0,0,0,1,0,NA
"Jacobaea","Asteraceae","Asterales",0,0,2,43,2,0
"Jacobinia","Acanthaceae","Lamiales",0,0,0,11,0,NA
"Jacobsenia","Aizoaceae","Caryophyllales",0,0,0,2,0,NA
"Jacquemontia","Convolvulaceae","Solanales",0,3,2,78,2,0
"Jacqueshuberia","Fabaceae","Fabales",1,0,0,7,1,1
"Jacquinia","Primulaceae","Ericales",2,0,0,5,2,1
"Jacquiniella","Orchidaceae","Asparagales",0,0,2,12,2,0
"Jadunia","Acanthaceae","Lamiales",0,0,0,1,0,NA
"Jaegeria","Asteraceae","Asterales",0,0,1,11,1,0
"Jaeschkea","Gentianaceae","Gentianales",0,0,0,2,0,NA
"Jagera","Sapindaceae","Sapindales",1,0,0,1,1,1
"Jaimehintonia","Asparagaceae","Asparagales",0,0,0,1,0,NA
"Jalcophila","Asteraceae","Asterales",0,0,0,4,0,NA
"Jaliscoa","Asteraceae","Asterales",0,0,0,3,0,NA
"Jaltomata","Solanaceae","Solanales",0,0,2,35,2,0
"Jamesbrittenia","Scrophulariaceae","Lamiales",0,0,4,83,4,0
"Jamesia","Hydrangeaceae","Cornales",1,0,0,2,1,1
"Jamesianthus","Asteraceae","Asterales",0,0,0,1,0,NA
"Jamesonia","Pteridaceae","Polypodiales",0,0,0,57,0,NA
"Jankaea","Gesneriaceae","Lamiales",0,0,0,1,0,NA
"Janotia","Rubiaceae","Gentianales",1,0,0,1,1,1
"Jansenella","Poaceae","Poales",0,0,1,1,1,0
"Jansonia","Fabaceae","Fabales",0,0,0,1,0,NA
"Janusia","Malpighiaceae","Malpighiales",1,2,0,14,1,1
"Japonolirion","Petrosaviaceae","Petrosaviales",0,0,1,1,1,0
"Jaramilloa","Asteraceae","Asterales",0,0,0,2,0,NA
"Jarilla","Caricaceae","Brassicales",1,0,0,4,1,1
"Jasarum","Araceae","Alismatales",0,0,0,1,0,NA
"Jasione","Campanulaceae","Asterales",0,0,3,15,3,0
"Jasminanthes","Apocynaceae","Gentianales",0,0,0,4,0,NA
"Jasminocereus","Cactaceae","Caryophyllales",0,0,0,2,0,NA
"Jasminum","Oleaceae","Lamiales",36,1,0,198,36,1
"Jasonia","Asteraceae","Asterales",0,0,0,3,0,NA
"Jateorhiza","Menispermaceae","Ranunculales",0,1,0,2,0,NA
"Jatropha","Euphorbiaceae","Malpighiales",16,0,4,190,20,0.8
"Jaumea","Asteraceae","Asterales",0,0,1,7,1,0
"Jaundea","Connaraceae","Oxalidales",0,0,0,4,0,NA
"Jedda","Thymelaeaceae","Malvales",0,0,0,1,0,NA
"Jefea","Asteraceae","Asterales",1,0,0,5,1,1
"Jeffersonia","Berberidaceae","Ranunculales",0,0,1,1,1,0
"Jeffreya","Asteraceae","Asterales",0,0,0,2,0,NA
"Jehlia","Onagraceae","Myrtales",0,0,0,1,0,NA
"Jejewoodia","Orchidaceae","Asparagales",0,0,0,6,0,NA
"Jejosephia","Orchidaceae","Asparagales",0,0,0,1,0,NA
"Jenmaniella","Podostemaceae","Malpighiales",0,0,0,7,0,NA
"Jensenobotrya","Aizoaceae","Caryophyllales",0,0,0,1,0,NA
"Jensia","Asteraceae","Asterales",0,0,0,2,0,NA
"Jepsonia","Saxifragaceae","Saxifragales",0,0,2,3,2,0
"Jessea","Asteraceae","Asterales",0,0,0,4,0,NA
"Joannesia","Euphorbiaceae","Malpighiales",2,0,0,2,2,1
"Jobaphes","Asteraceae","Asterales",0,0,0,1,0,NA
"Jobinia","Apocynaceae","Gentianales",0,0,0,10,0,NA
"Jodina","Santalaceae","Santalales",1,0,0,1,1,1
"Jodrellia","Xanthorrhoeaceae","Asparagales",0,0,1,2,1,0
"Johanneshowellia","Polygonaceae","Caryophyllales",0,0,1,2,1,0
"Johannesteijsmannia","Arecaceae","Arecales",1,0,0,4,1,1
"Johnsonia","Xanthorrhoeaceae","Asparagales",0,0,2,5,2,0
"Johnstonalia","Rhamnaceae","Rosales",0,0,0,1,0,NA
"Johrenia","Apiaceae","Apiales",0,0,0,4,0,NA
"Joinvillea","Joinvilleaceae","Poales",0,0,2,4,2,0
"Jollydora","Connaraceae","Oxalidales",1,0,0,3,1,1
"Jonopsidium","Brassicaceae","Brassicales",0,0,0,1,0,NA
"Joosia","Rubiaceae","Gentianales",2,0,0,12,2,1
"Jordaaniella","Aizoaceae","Caryophyllales",0,0,0,4,0,NA
"Joseanthus","Asteraceae","Asterales",0,0,0,5,0,NA
"Josephinia","Pedaliaceae","Lamiales",0,0,0,1,0,NA
"Jouvea","Poaceae","Poales",0,0,0,2,0,NA
"Jovellana","Calceolariaceae","Lamiales",1,0,0,2,1,1
"Jovetia","Rubiaceae","Gentianales",0,0,0,1,0,NA
"Jovibarba","Crassulaceae","Saxifragales",0,0,0,1,0,NA
"Juania","Arecaceae","Arecales",1,0,0,1,1,1
"Juanulloa","Solanaceae","Solanales",1,0,0,10,1,1
"Jubaea","Arecaceae","Arecales",1,0,0,1,1,1
"Jubaeopsis","Arecaceae","Arecales",1,0,0,1,1,1
"Jubelina","Malpighiaceae","Malpighiales",0,0,0,6,0,NA
"Juglans","Juglandaceae","Fagales",14,0,0,21,14,1
"Julbernardia","Fabaceae","Fabales",3,0,0,11,3,1
"Juliania","Anacardiaceae","Sapindales",0,0,0,1,0,NA
"Jumellea","Orchidaceae","Asparagales",0,0,3,64,3,0
"Juncoides","Juncaceae","Poales",0,0,0,2,0,NA
"Juncus","Juncaceae","Poales",0,0,141,348,141,0
"Junellia","Verbenaceae","Lamiales",6,0,0,37,6,1
"Jungia","Asteraceae","Asterales",0,0,0,29,0,NA
"Juniperus","Cupressaceae","Cupressales",21,0,0,75,21,1
"Juno","Iridaceae","Asparagales",0,0,0,5,0,NA
"Jurinea","Asteraceae","Asterales",0,0,5,207,5,0
"Jurinella","Asteraceae","Asterales",0,0,0,1,0,NA
"Jussiaea","Onagraceae","Myrtales",0,0,0,3,0,NA
"Justago","Cleomaceae","Brassicales",0,0,0,1,0,NA
"Justicia","Acanthaceae","Lamiales",2,1,3,652,5,0.4
"Juttadinteria","Aizoaceae","Caryophyllales",0,0,0,12,0,NA
"Kabuyea","Tecophilaeaceae","Asparagales",0,0,1,1,1,0
"Kadenia","Apiaceae","Apiales",0,0,0,1,0,NA
"Kadenicarpus","Cactaceae","Caryophyllales",0,0,0,1,0,NA
"Kadsura","Schisandraceae","Austrobaileyales",5,0,0,16,5,1
"Kadua","Rubiaceae","Gentianales",1,0,1,29,2,0.5
"Kaempferia","Zingiberaceae","Zingiberales",0,0,0,36,0,NA
"Kafirnigania","Apiaceae","Apiales",0,0,0,1,0,NA
"Kageneckia","Rosaceae","Rosales",1,0,0,1,1,1
"Kailarsenia","Rubiaceae","Gentianales",0,0,0,6,0,NA
"Kairothamnus","Picrodendraceae","Malpighiales",0,0,0,1,0,NA
"Kaisupeea","Gesneriaceae","Lamiales",0,0,0,1,0,NA
"Kajewskiella","Rubiaceae","Gentianales",0,0,0,2,0,NA
"Kalaharia","Lamiaceae","Lamiales",0,1,0,1,0,NA
"Kalakia","Apiaceae","Apiales",0,0,0,1,0,NA
"Kalanchoe","Crassulaceae","Saxifragales",0,0,0,133,0,NA
"Kalappia","Fabaceae","Fabales",1,0,0,1,1,1
"Kalbreyeriella","Acanthaceae","Lamiales",0,0,0,3,0,NA
"Kalidium","Amaranthaceae","Caryophyllales",4,0,0,6,4,1
"Kalimantanorchis","Orchidaceae","Asparagales",0,0,0,1,0,NA
"Kalimeris","Asteraceae","Asterales",0,0,0,15,0,NA
"Kaliphora","Cornaceae","Cornales",1,0,0,1,1,1
"Kallstroemia","Zygophyllaceae","Zygophyllales",0,0,1,31,1,0
"Kalmia","Ericaceae","Ericales",4,0,0,10,4,1
"Kalmiella","Ericaceae","Ericales",0,0,0,1,0,NA
"Kalmiopsis","Ericaceae","Ericales",1,0,0,1,1,1
"Kalopanax","Araliaceae","Apiales",1,0,0,2,1,1
"Kamelinia","Apiaceae","Apiales",0,0,0,1,0,NA
"Kamettia","Apocynaceae","Gentianales",0,0,0,2,0,NA
"Kampochloa","Poaceae","Poales",0,0,0,1,0,NA
"Kanahia","Apocynaceae","Gentianales",0,0,0,2,0,NA
"Kanakomyrtus","Myrtaceae","Myrtales",0,0,0,6,0,NA
"Kanaloa","Fabaceae","Fabales",1,0,0,1,1,1
"Kandelia","Rhizophoraceae","Malpighiales",2,0,0,2,2,1
"Kania","Myrtaceae","Myrtales",1,0,0,6,1,1
"Kaokochloa","Poaceae","Poales",0,0,0,1,0,NA
"Kardomia","Myrtaceae","Myrtales",6,0,0,6,6,1
"Karelinia","Asteraceae","Asterales",0,0,1,1,1,0
"Karinia","Cyperaceae","Poales",0,0,0,1,0,NA
"Karnataka","Apiaceae","Apiales",0,0,0,1,0,NA
"Karomia","Lamiaceae","Lamiales",2,0,0,9,2,1
"Karvandarina","Asteraceae","Asterales",0,0,0,1,0,NA
"Karwinskia","Rhamnaceae","Rosales",3,0,0,10,3,1
"Kaschgaria","Asteraceae","Asterales",0,0,0,2,0,NA
"Kashmiria","Plantaginaceae","Lamiales",0,0,0,1,0,NA
"Kaulinia","Polypodiaceae","Polypodiales",0,0,0,1,0,NA
"Kaunia","Asteraceae","Asterales",1,0,0,12,1,1
"Kavalama","Malvaceae","Malvales",1,0,0,1,1,1
"Kayea","Calophyllaceae","Malpighiales",0,0,0,2,0,NA
"Kearnemalvastrum","Malvaceae","Malvales",0,0,0,2,0,NA
"Keayodendron","Phyllanthaceae","Malpighiales",1,0,0,1,1,1
"Kebirita","Fabaceae","Fabales",0,0,0,1,0,NA
"Keckiella","Plantaginaceae","Lamiales",5,0,0,7,5,1
"Kedhalia","Zingiberaceae","Zingiberales",0,0,0,1,0,NA
"Kedrostis","Cucurbitaceae","Cucurbitales",0,2,0,18,0,NA
"Keenania","Rubiaceae","Gentianales",0,0,0,5,0,NA
"Keetia","Rubiaceae","Gentianales",6,0,0,32,6,1
"Kefersteinia","Orchidaceae","Asparagales",0,0,6,70,6,0
"Kegelia","Orchidaceae","Asparagales",0,0,0,1,0,NA
"Kegeliella","Orchidaceae","Asparagales",0,0,2,4,2,0
"Kelissa","Iridaceae","Asparagales",0,0,1,1,1,0
"Kelleria","Thymelaeaceae","Malvales",0,0,0,11,0,NA
"Kelloggia","Rubiaceae","Gentianales",0,0,2,2,2,0
"Kelseya","Rosaceae","Rosales",0,0,1,1,1,0
"Kemulariella","Asteraceae","Asterales",0,0,0,6,0,NA
"Kennedia","Fabaceae","Fabales",0,0,1,15,1,0
"Kensitia","Aizoaceae","Caryophyllales",0,0,0,1,0,NA
"Kentiopsis","Arecaceae","Arecales",1,0,0,4,1,1
"Kentranthus","Caprifoliaceae","Dipsacales",0,0,0,1,0,NA
"Kentrophyllum","Asteraceae","Asterales",0,0,0,1,0,NA
"Kentrothamnus","Rhamnaceae","Rosales",0,0,0,1,0,NA
"Keramocarpus","Apiaceae","Apiales",0,0,0,1,0,NA
"Keraudrenia","Malvaceae","Malvales",0,0,0,1,0,NA
"Kerbera","Apocynaceae","Gentianales",0,0,0,1,0,NA
"Kerianthera","Rubiaceae","Gentianales",1,0,0,2,1,1
"Kermadecia","Proteaceae","Proteales",1,0,0,1,1,1
"Kernera","Brassicaceae","Brassicales",0,0,1,1,1,0
"Kerria","Rosaceae","Rosales",1,0,0,1,1,1
"Kerriochloa","Poaceae","Poales",0,0,0,1,0,NA
"Kerriodoxa","Arecaceae","Arecales",1,0,0,1,1,1
"Kerstingiella","Fabaceae","Fabales",0,0,0,1,0,NA
"Keteleeria","Pinaceae","Pinales",3,0,0,3,3,1
"Keyserlingia","Fabaceae","Fabales",0,0,0,1,0,NA
"Keysseria","Asteraceae","Asterales",0,0,0,5,0,NA
"Khadia","Aizoaceae","Caryophyllales",0,0,0,6,0,NA
"Khaosokia","Cyperaceae","Poales",0,0,1,1,1,0
"Khasiaclunea","Rubiaceae","Gentianales",0,0,0,1,0,NA
"Khasianthus","Asteraceae","Asterales",0,0,0,1,0,NA
"Khaya","Meliaceae","Sapindales",6,0,0,6,6,1
"Kibara","Monimiaceae","Laurales",2,0,0,2,2,1
"Kibaropsis","Monimiaceae","Laurales",1,0,0,1,1,1
"Kibatalia","Apocynaceae","Gentianales",4,0,0,15,4,1
"Kickxia","Plantaginaceae","Lamiales",0,0,2,10,2,0
"Kielmeyera","Calophyllaceae","Malpighiales",5,0,0,39,5,1
"Kigelia","Bignoniaceae","Lamiales",1,0,0,1,1,1
"Kiggelaria","Achariaceae","Malpighiales",1,0,0,1,1,1
"Kihansia","Triuridaceae","Pandanales",0,0,0,1,0,NA
"Killickia","Lamiaceae","Lamiales",0,0,0,4,0,NA
"Killipia","Melastomataceae","Myrtales",0,0,0,1,0,NA
"Kinabaluchloa","Poaceae","Poales",0,0,0,2,0,NA
"Kingdonia","Circaeasteraceae","Ranunculales",0,0,1,1,1,0
"Kingella","Loranthaceae","Santalales",0,0,0,1,0,NA
"Kinghamia","Asteraceae","Asterales",0,0,0,5,0,NA
"Kingia","Dasypogonaceae","UnknownOrder-Dasypogonaceae",1,0,0,1,1,1
"Kingianthus","Asteraceae","Asterales",0,0,0,2,0,NA
"Kingidium","Orchidaceae","Asparagales",0,0,0,2,0,NA
"Kingiodendron","Fabaceae","Fabales",1,0,0,5,1,1
"Kionophyton","Orchidaceae","Asparagales",0,0,0,4,0,NA
"Kippistia","Asteraceae","Asterales",0,0,0,1,0,NA
"Kirkia","Kirkiaceae","Sapindales",4,0,0,5,4,1
"Kissenia","Loasaceae","Cornales",0,0,0,1,0,NA
"Kitaibelia","Malvaceae","Malvales",0,0,0,1,0,NA
"Kjellbergiodendron","Myrtaceae","Myrtales",1,0,0,1,1,1
"Klackenbergia","Gentianaceae","Gentianales",0,0,0,2,0,NA
"Klaineanthus","Euphorbiaceae","Malpighiales",1,0,0,2,1,1
"Klainedoxa","Irvingiaceae","Malpighiales",1,0,0,3,1,1
"Klaprothia","Loasaceae","Cornales",0,0,2,2,2,0
"Klarobelia","Annonaceae","Magnoliales",6,0,0,12,6,1
"Klasea","Asteraceae","Asterales",0,0,2,29,2,0
"Klattia","Iridaceae","Asparagales",2,0,0,3,2,1
"Kleinhovia","Malvaceae","Malvales",1,0,0,1,1,1
"Kleinia","Asteraceae","Asterales",0,0,0,59,0,NA
"Klossia","Rubiaceae","Gentianales",0,0,0,1,0,NA
"Klotzschia","Apiaceae","Apiales",0,0,1,3,1,0
"Klugiodendron","Fabaceae","Fabales",0,0,0,1,0,NA
"Knautia","Caprifoliaceae","Dipsacales",0,0,2,48,2,0
"Kneiffia","Onagraceae","Myrtales",0,0,0,15,0,NA
"Knema","Myristicaceae","Magnoliales",3,0,0,10,3,1
"Knightia","Proteaceae","Proteales",1,0,0,1,1,1
"Kniphofia","Xanthorrhoeaceae","Asparagales",0,0,16,73,16,0
"Knorringia","Polygonaceae","Caryophyllales",0,0,1,1,1,0
"Knowltonia","Ranunculaceae","Ranunculales",0,0,0,2,0,NA
"Knoxia","Rubiaceae","Gentianales",0,1,0,13,0,NA
"Koanophyllon","Asteraceae","Asterales",2,0,0,137,2,1
"Kobresia","Cyperaceae","Poales",0,0,15,57,15,0
"Kochia","Amaranthaceae","Caryophyllales",0,0,0,9,0,NA
"Kochummenia","Rubiaceae","Gentianales",0,0,0,2,0,NA
"Kodalyodendron","Rutaceae","Sapindales",0,0,0,1,0,NA
"Koeberlinia","Koeberliniaceae","Brassicales",1,0,0,2,1,1
"Koehneola","Asteraceae","Asterales",0,0,0,1,0,NA
"Koehneria","Lythraceae","Myrtales",0,0,0,1,0,NA
"Koeleria","Poaceae","Poales",0,0,8,50,8,0
"Koellensteinia","Orchidaceae","Asparagales",0,0,3,17,3,0
"Koellia","Lamiaceae","Lamiales",0,0,0,3,0,NA
"Koellikeria","Gesneriaceae","Lamiales",0,0,1,2,1,0
"Koelpinia","Asteraceae","Asterales",0,0,2,7,2,0
"Koelreuteria","Sapindaceae","Sapindales",3,0,0,3,3,1
"Koenigia","Polygonaceae","Caryophyllales",0,0,1,1,1,0
"Koernickanthe","Marantaceae","Zingiberales",0,0,0,1,0,NA
"Kogelbergia","Stilbaceae","Lamiales",0,0,0,2,0,NA
"Kohautia","Rubiaceae","Gentianales",0,1,5,27,5,0
"Kohleria","Gesneriaceae","Lamiales",0,0,3,40,3,0
"Koilodepas","Euphorbiaceae","Malpighiales",2,0,0,12,2,1
"Kokia","Malvaceae","Malvales",1,0,0,4,1,1
"Kolkwitzia","Caprifoliaceae","Dipsacales",1,0,0,1,1,1
"Kolobopetalum","Menispermaceae","Ranunculales",0,1,0,4,0,NA
"Koompassia","Fabaceae","Fabales",2,0,0,3,2,1
"Kopsia","Apocynaceae","Gentianales",2,0,0,24,2,1
"Kopsiopsis","Orobanchaceae","Lamiales",0,0,0,1,0,NA
"Korovinia","Apiaceae","Apiales",0,0,0,1,0,NA
"Korshinskia","Apiaceae","Apiales",0,0,0,1,0,NA
"Korshinskya","Apiaceae","Apiales",0,0,0,1,0,NA
"Korthalsella","Santalaceae","Santalales",0,2,0,11,0,NA
"Korthalsia","Arecaceae","Arecales",1,0,0,27,1,1
"Korupodendron","Vochysiaceae","Myrtales",0,0,0,1,0,NA
"Kosmosiphon","Acanthaceae","Lamiales",0,0,0,1,0,NA
"Kosteletzkya","Malvaceae","Malvales",2,1,0,22,2,1
"Kostermanthus","Chrysobalanaceae","Malpighiales",0,0,0,3,0,NA
"Kotschya","Fabaceae","Fabales",0,0,0,30,0,NA
"Kovalevskiella","Asteraceae","Asterales",0,0,0,3,0,NA
"Koyamacalia","Asteraceae","Asterales",0,0,1,7,1,0
"Koyamaea","Cyperaceae","Poales",0,0,0,1,0,NA
"Koyamasia","Asteraceae","Asterales",0,0,0,1,0,NA
"Kraenzlinella","Orchidaceae","Asparagales",0,0,0,9,0,NA
"Krainzia","Cactaceae","Caryophyllales",0,0,0,1,0,NA
"Krameria","Krameriaceae","Zygophyllales",4,1,0,25,4,1
"Krapfia","Ranunculaceae","Ranunculales",0,0,0,4,0,NA
"Krapovickasia","Malvaceae","Malvales",0,0,0,4,0,NA
"Krascheninnikovia","Amaranthaceae","Caryophyllales",1,0,0,3,1,1
"Krasnovia","Apiaceae","Apiales",0,0,0,1,0,NA
"Kraunhia","Fabaceae","Fabales",0,0,0,4,0,NA
"Krauseola","Caryophyllaceae","Caryophyllales",0,0,0,2,0,NA
"Kraussia","Rubiaceae","Gentianales",2,0,0,4,2,1
"Krebsia","Apocynaceae","Gentianales",0,0,0,1,0,NA
"Kremeriella","Brassicaceae","Brassicales",0,0,0,1,0,NA
"Kreodanthus","Orchidaceae","Asparagales",0,0,0,14,0,NA
"Krigia","Asteraceae","Asterales",0,0,1,9,1,0
"Krubera","Apiaceae","Apiales",0,0,0,1,0,NA
"Krugiodendron","Rhamnaceae","Rosales",1,0,0,2,1,1
"Krukoviella","Ochnaceae","Malpighiales",0,0,0,1,0,NA
"Kryptostoma","Orchidaceae","Asparagales",0,0,0,1,0,NA
"Kubitzkia","Lauraceae","Laurales",1,0,0,2,1,1
"Kudoacanthus","Acanthaceae","Lamiales",0,0,0,1,0,NA
"Kudrjaschevia","Lamiaceae","Lamiales",0,0,0,5,0,NA
"Kuhitangia","Caryophyllaceae","Caryophyllales",0,0,0,2,0,NA
"Kuhlhasseltia","Orchidaceae","Asparagales",0,0,0,9,0,NA
"Kuhnia","Asteraceae","Asterales",0,0,0,1,0,NA
"Kuhnistera","Fabaceae","Fabales",0,0,0,1,0,NA
"Kulinia","Restionaceae","Poales",0,0,1,1,1,0
"Kummerowia","Fabaceae","Fabales",0,0,1,2,1,0
"Kundmannia","Apiaceae","Apiales",0,0,0,1,0,NA
"Kungia","Crassulaceae","Saxifragales",0,0,0,2,0,NA
"Kunhardtia","Rapateaceae","Poales",0,0,1,2,1,0
"Kuniwatsukia","Athyriaceae","Polypodiales",0,0,0,1,0,NA
"Kunstleria","Fabaceae","Fabales",0,0,0,8,0,NA
"Kuntheria","Colchicaceae","Liliales",0,0,0,1,0,NA
"Kunzea","Myrtaceae","Myrtales",21,0,0,43,21,1
"Kupea","Triuridaceae","Pandanales",0,0,1,2,1,0
"Kurramiana","Gentianaceae","Gentianales",0,0,0,1,0,NA
"Kurzamra","Lamiaceae","Lamiales",0,0,0,1,0,NA
"Kuschakewiczia","Boraginaceae","UnknownOrder-Boraginaceae",0,0,0,1,0,NA
"Kutchubaea","Rubiaceae","Gentianales",1,0,0,13,1,1
"Kydia","Malvaceae","Malvales",1,0,0,2,1,1
"Kyhosia","Asteraceae","Asterales",0,0,0,1,0,NA
"Kyllinga","Cyperaceae","Poales",0,0,15,78,15,0
"Kyphocarpa","Amaranthaceae","Caryophyllales",0,0,2,3,2,0
"Kyrsteniopsis","Asteraceae","Asterales",0,0,0,4,0,NA
"Labichea","Fabaceae","Fabales",0,0,0,14,0,NA
"Labisia","Primulaceae","Ericales",0,0,0,1,0,NA
"Lablab","Fabaceae","Fabales",0,0,0,2,0,NA
"Labordia","Loganiaceae","Gentianales",0,0,0,24,0,NA
"Labourdonnaisia","Sapotaceae","Ericales",1,0,0,7,1,1
"Labramia","Sapotaceae","Ericales",3,0,0,9,3,1
"Laburnocytisus","Fabaceae","Fabales",0,0,0,1,0,NA
"Laburnum","Fabaceae","Fabales",1,0,0,4,1,1
"Lacaena","Orchidaceae","Asparagales",0,0,1,2,1,0
"Lacandonia","Triuridaceae","Pandanales",0,0,0,1,0,NA
"Laccodiscus","Sapindaceae","Sapindales",1,0,0,4,1,1
"Laccopetalum","Ranunculaceae","Ranunculales",0,0,1,1,1,0
"Laccospadix","Arecaceae","Arecales",0,0,0,1,0,NA
"Laccosperma","Arecaceae","Arecales",1,0,0,6,1,1
"Lachenalia","Asparagaceae","Asparagales",0,0,49,115,49,0
"Lachnaea","Thymelaeaceae","Malvales",30,0,0,37,30,1
"Lachnanthes","Haemodoraceae","Commelinales",0,0,1,1,1,0
"Lachnocapsa","Brassicaceae","Brassicales",0,0,0,1,0,NA
"Lachnocaulon","Eriocaulaceae","Poales",0,0,2,7,2,0
"Lachnoloma","Brassicaceae","Brassicales",0,0,0,1,0,NA
"Lachnophyllum","Asteraceae","Asterales",0,0,0,2,0,NA
"Lachnorhiza","Asteraceae","Asterales",0,0,0,2,0,NA
"Lachnospermum","Asteraceae","Asterales",1,0,0,3,1,1
"Lachnostachys","Lamiaceae","Lamiales",1,0,0,6,1,1
"Lachnostylis","Phyllanthaceae","Malpighiales",1,0,0,2,1,1
"Lacinaria","Asteraceae","Asterales",0,0,0,2,0,NA
"Lacistema","Lacistemataceae","Malpighiales",7,0,0,10,7,1
"Lackeya","Fabaceae","Fabales",0,0,0,1,0,NA
"Lacmellea","Apocynaceae","Gentianales",7,0,0,26,7,1
"Lacostea","Hymenophyllaceae","Hymenophyllales",0,0,0,2,0,NA
"Lacosteopsis","Hymenophyllaceae","Hymenophyllales",0,0,0,2,0,NA
"Lactoris","Lactoridaceae","Piperales",1,0,0,1,1,1
"Lactuca","Asteraceae","Asterales",0,0,10,147,10,0
"Lacunaria","Ochnaceae","Malpighiales",3,0,0,8,3,1
"Ladeania","Fabaceae","Fabales",0,0,0,2,0,NA
"Ladenbergia","Rubiaceae","Gentianales",6,0,0,35,6,1
"Ladyginia","Apiaceae","Apiales",0,0,0,2,0,NA
"Laelia","Orchidaceae","Asparagales",0,0,9,24,9,0
"Laelichilis","Orchidaceae","Asparagales",0,0,0,1,0,NA
"Laeliocattleya","Orchidaceae","Asparagales",0,0,0,4,0,NA
"Laennecia","Asteraceae","Asterales",0,0,0,13,0,NA
"Laestadia","Asteraceae","Asterales",0,0,0,6,0,NA
"Laetia","Salicaceae","Malpighiales",9,0,0,9,9,1
"Lafoensia","Lythraceae","Myrtales",4,0,0,6,4,1
"Lafuentea","Plantaginaceae","Lamiales",0,0,0,1,0,NA
"Lagarinthus","Apocynaceae","Gentianales",0,0,0,2,0,NA
"Lagarosiphon","Hydrocharitaceae","Alismatales",0,0,3,9,3,0
"Lagarosolen","Gesneriaceae","Lamiales",0,0,0,1,0,NA
"Lagarostrobos","Podocarpaceae","Araucariales",1,0,0,1,1,1
"Lagascea","Asteraceae","Asterales",0,0,0,8,0,NA
"Lagenandra","Araceae","Alismatales",0,0,0,15,0,NA
"Lagenantha","Amaranthaceae","Caryophyllales",0,0,0,1,0,NA
"Lagenanthus","Gentianaceae","Gentianales",0,0,0,1,0,NA
"Lagenaria","Cucurbitaceae","Cucurbitales",0,0,2,6,2,0
"Lagenocarpus","Cyperaceae","Poales",0,0,0,30,0,NA
"Lagenocypsela","Asteraceae","Asterales",0,0,0,2,0,NA
"Lagenophora","Asteraceae","Asterales",0,0,3,18,3,0
"Lagerstroemia","Lythraceae","Myrtales",9,0,0,23,9,1
"Lagetta","Thymelaeaceae","Malvales",0,0,0,3,0,NA
"Laggera","Asteraceae","Asterales",0,0,2,9,2,0
"Lagochilus","Lamiaceae","Lamiales",0,0,1,45,1,0
"Lagoecia","Apiaceae","Apiales",0,0,1,1,1,0
"Lagophylla","Asteraceae","Asterales",0,0,1,4,1,0
"Lagopsis","Lamiaceae","Lamiales",0,0,0,5,0,NA
"Lagoseriopsis","Asteraceae","Asterales",0,0,0,1,0,NA
"Lagoseris","Asteraceae","Asterales",0,0,0,2,0,NA
"Lagotis","Plantaginaceae","Lamiales",0,0,0,20,0,NA
"Lagrezia","Amaranthaceae","Caryophyllales",0,0,0,9,0,NA
"Lagunaria","Malvaceae","Malvales",1,0,0,1,1,1
"Laguncularia","Combretaceae","Myrtales",1,0,0,1,1,1
"Lagurus","Poaceae","Poales",0,0,1,1,1,0
"Lallemantia","Lamiaceae","Lamiales",0,0,3,5,3,0
"Lamanonia","Cunoniaceae","Oxalidales",0,0,0,5,0,NA
"Lamarchea","Myrtaceae","Myrtales",1,0,0,2,1,1
"Lamarckia","Poaceae","Poales",0,0,1,1,1,0
"Lamiodendron","Bignoniaceae","Lamiales",0,0,0,1,0,NA
"Lamium","Lamiaceae","Lamiales",0,0,8,25,8,0
"Lamourouxia","Orobanchaceae","Lamiales",0,0,0,25,0,NA
"Lampadaria","Gesneriaceae","Lamiales",0,0,0,1,0,NA
"Lampas","Loranthaceae","Santalales",0,0,0,1,0,NA
"Lampayo","Verbenaceae","Lamiales",0,0,0,3,0,NA
"Lamprachaenium","Asteraceae","Asterales",0,0,0,1,0,NA
"Lampranthus","Aizoaceae","Caryophyllales",0,0,1,217,1,0
"Lamprocapnos","Papaveraceae","Ranunculales",0,0,1,1,1,0
"Lamprocephalus","Asteraceae","Asterales",0,0,0,1,0,NA
"Lamprolobium","Fabaceae","Fabales",0,0,0,2,0,NA
"Lampropappus","Asteraceae","Asterales",0,0,0,3,0,NA
"Lamprothamnus","Rubiaceae","Gentianales",0,0,0,1,0,NA
"Lamprothyrsus","Poaceae","Poales",0,0,1,2,1,0
"Lamyra","Asteraceae","Asterales",0,0,0,4,0,NA
"Lamyropappus","Asteraceae","Asterales",0,0,0,1,0,NA
"Lamyropsis","Asteraceae","Asterales",0,0,0,5,0,NA
"Lanaria","Lanariaceae","Asparagales",0,0,1,1,1,0
"Lancea","Phrymaceae","Lamiales",0,0,1,2,1,0
"Lancisia","Asteraceae","Asterales",0,0,0,1,0,NA
"Landiopsis","Rubiaceae","Gentianales",0,0,0,1,0,NA
"Landolphia","Apocynaceae","Gentianales",3,0,0,64,3,1
"Langebergia","Asteraceae","Asterales",0,0,0,1,0,NA
"Langloisia","Polemoniaceae","Ericales",0,0,0,5,0,NA
"Langsdorffia","Balanophoraceae","Santalales",0,0,0,2,0,NA
"Lankesterella","Orchidaceae","Asparagales",0,0,0,11,0,NA
"Lankesteria","Acanthaceae","Lamiales",0,0,0,7,0,NA
"Lannea","Anacardiaceae","Sapindales",10,0,0,27,10,1
"Lansium","Meliaceae","Sapindales",0,0,0,1,0,NA
"Lantana","Verbenaceae","Lamiales",8,0,1,129,9,0.888888888888889
"Lantanopsis","Asteraceae","Asterales",0,0,0,3,0,NA
"Laosanthus","Zingiberaceae","Zingiberales",0,0,0,1,0,NA
"Lapageria","Philesiaceae","Liliales",1,0,0,1,1,1
"Lapanthus","Bromeliaceae","Poales",0,0,0,2,0,NA
"Lapathum","Polygonaceae","Caryophyllales",0,0,0,1,0,NA
"Lapeirousia","Iridaceae","Asparagales",0,0,30,41,30,0
"Laphamia","Asteraceae","Asterales",0,0,0,1,0,NA
"Laphangium","Asteraceae","Asterales",0,0,0,3,0,NA
"Lapidaria","Aizoaceae","Caryophyllales",0,0,0,1,0,NA
"Lapiedra","Asparagaceae","Asparagales",0,0,1,1,1,0
"Lapithea","Gentianaceae","Gentianales",0,0,0,2,0,NA
"Laplacea","Theaceae","Ericales",1,0,0,2,1,1
"Laportea","Urticaceae","Rosales",0,0,4,25,4,0
"Lappa","Asteraceae","Asterales",0,0,0,6,0,NA
"Lappula","Boraginaceae","UnknownOrder-Boraginaceae",0,0,1,54,1,0
"Lapsana","Asteraceae","Asterales",0,0,1,6,1,0
"Lapsanastrum","Asteraceae","Asterales",0,0,0,4,0,NA
"Lardizabala","Lardizabalaceae","Ranunculales",0,0,0,1,0,NA
"Larentia","Iridaceae","Asparagales",0,0,1,3,1,0
"Laretia","Apiaceae","Apiales",0,0,1,1,1,0
"Larix","Pinaceae","Pinales",11,0,0,14,11,1
"Larnax","Solanaceae","Solanales",0,0,0,22,0,NA
"Larrea","Zygophyllaceae","Zygophyllales",4,0,0,6,4,1
"Larsenaikia","Rubiaceae","Gentianales",1,0,0,3,1,1
"Larsenianthus","Zingiberaceae","Zingiberales",0,0,0,4,0,NA
"Laser","Apiaceae","Apiales",0,0,0,1,0,NA
"Laserpitium","Apiaceae","Apiales",0,0,0,14,0,NA
"Lasia","Araceae","Alismatales",0,1,0,2,0,NA
"Lasiacis","Poaceae","Poales",4,0,0,15,4,1
"Lasiadenia","Thymelaeaceae","Malvales",0,0,0,2,0,NA
"Lasianthaea","Asteraceae","Asterales",1,0,1,14,2,0.5
"Lasianthera","Stemonuraceae","Aquifoliales",1,0,0,1,1,1
"Lasianthus","Rubiaceae","Gentianales",11,0,0,226,11,1
"Lasiarrhenum","Boraginaceae","UnknownOrder-Boraginaceae",0,0,0,3,0,NA
"Lasimorpha","Araceae","Alismatales",0,0,0,1,0,NA
"Lasiobema","Fabaceae","Fabales",0,0,0,4,0,NA
"Lasiocarpus","Malpighiaceae","Malpighiales",0,0,0,2,0,NA
"Lasiocaryum","Boraginaceae","UnknownOrder-Boraginaceae",0,0,0,4,0,NA
"Lasiocephalus","Asteraceae","Asterales",0,0,1,15,1,0
"Lasiocereus","Cactaceae","Caryophyllales",0,0,0,2,0,NA
"Lasiochlamys","Salicaceae","Malpighiales",1,0,0,1,1,1
"Lasiocladus","Acanthaceae","Lamiales",0,0,0,7,0,NA
"Lasiococca","Euphorbiaceae","Malpighiales",1,0,0,5,1,1
"Lasiocroton","Euphorbiaceae","Malpighiales",2,0,0,7,2,1
"Lasiodiscus","Rhamnaceae","Rosales",3,0,0,12,3,1
"Lasiolaena","Asteraceae","Asterales",0,0,0,7,0,NA
"Lasiopetalum","Malvaceae","Malvales",0,0,0,1,0,NA
"Lasiopogon","Asteraceae","Asterales",0,0,0,9,0,NA
"Lasiosiphon","Thymelaeaceae","Malvales",0,0,0,1,0,NA
"Lasiospermum","Asteraceae","Asterales",0,0,1,4,1,0
"Lasiospora","Asteraceae","Asterales",0,0,0,2,0,NA
"Lasiurus","Poaceae","Poales",0,0,0,1,0,NA
"Lastarriaea","Polygonaceae","Caryophyllales",0,0,0,2,0,NA
"Lasthenia","Asteraceae","Asterales",0,0,1,19,1,0
"Lastrea","Dryopteridaceae","Polypodiales",0,0,0,11,0,NA
"Lastreopsis","Dryopteridaceae","Polypodiales",0,0,2,31,2,0
"Latania","Arecaceae","Arecales",2,0,0,3,2,1
"Lateropora","Ericaceae","Ericales",0,0,0,3,0,NA
"Lathraea","Orobanchaceae","Lamiales",0,0,1,4,1,0
"Lathraeocarpa","Rubiaceae","Gentianales",0,0,0,2,0,NA
"Lathrocasis","Polemoniaceae","Ericales",0,0,0,1,0,NA
"Lathrophytum","Balanophoraceae","Santalales",0,0,0,1,0,NA
"Lathyrus","Fabaceae","Fabales",0,0,18,159,18,0
"Latouchea","Gentianaceae","Gentianales",0,0,0,1,0,NA
"Latrobea","Fabaceae","Fabales",0,0,0,5,0,NA
"Latua","Solanaceae","Solanales",0,0,0,1,0,NA
"Laubertia","Apocynaceae","Gentianales",0,1,0,3,0,NA
"Launaea","Asteraceae","Asterales",1,2,2,59,3,0.333333333333333
"Laurelia","Atherospermataceae","Laurales",1,0,0,1,1,1
"Laureliopsis","Atherospermataceae","Laurales",1,0,0,1,1,1
"Laurembergia","Haloragaceae","Saxifragales",0,0,0,4,0,NA
"Laurentia","Campanulaceae","Asterales",0,0,0,1,0,NA
"Lauridia","Celastraceae","Celastrales",2,0,0,2,2,1
"Laurophyllus","Anacardiaceae","Sapindales",1,0,0,1,1,1
"Laurus","Lauraceae","Laurales",2,0,0,4,2,1
"Lavandula","Lamiaceae","Lamiales",6,1,0,47,6,1
"Lavatera","Malvaceae","Malvales",0,0,0,10,0,NA
"Lavauxia","Onagraceae","Myrtales",0,0,0,4,0,NA
"Lavigeria","Icacinaceae","UnknownOrder-Icacinaceae",1,0,0,1,1,1
"Lavoisiera","Melastomataceae","Myrtales",1,0,0,31,1,1
"Lavradia","Ochnaceae","Malpighiales",0,0,0,1,0,NA
"Lavrania","Apocynaceae","Gentianales",0,0,0,5,0,NA
"Lawrencella","Asteraceae","Asterales",0,0,0,2,0,NA
"Lawsonia","Lythraceae","Myrtales",1,0,0,2,1,1
"Laxmannia","Asparagaceae","Asparagales",0,0,4,14,4,0
"Laxmannia","Asteraceae",NA,0,0,0,1,0,NA
"Laxoplumeria","Apocynaceae","Gentianales",0,0,0,3,0,NA
"Layia","Asteraceae","Asterales",0,0,1,19,1,0
"Leachiella","Apocynaceae","Gentianales",0,0,0,5,0,NA
"Leandra","Melastomataceae","Myrtales",4,0,0,219,4,1
"Leandriella","Acanthaceae","Lamiales",0,0,0,2,0,NA
"Leavenworthia","Brassicaceae","Brassicales",0,0,4,8,4,0
"Lebeckia","Fabaceae","Fabales",0,0,0,44,0,NA
"Lebetanthus","Ericaceae","Ericales",1,0,0,1,1,1
"Lebetina","Asteraceae","Asterales",0,0,0,2,0,NA
"Lebruniodendron","Fabaceae","Fabales",0,0,0,1,0,NA
"Lecananthus","Rubiaceae","Gentianales",0,0,0,3,0,NA
"Lecaniodiscus","Sapindaceae","Sapindales",2,0,0,2,2,1
"Lecanocarpus","Amaranthaceae","Caryophyllales",0,0,0,1,0,NA
"Lecanophora","Malvaceae","Malvales",0,0,0,5,0,NA
"Lecanopteris","Polypodiaceae","Polypodiales",0,0,0,1,0,NA
"Lecanorchis","Orchidaceae","Asparagales",0,0,1,20,1,0
"Lecanthus","Urticaceae","Rosales",0,0,0,3,0,NA
"Lecariocalyx","Rubiaceae","Gentianales",0,0,0,1,0,NA
"Lechea","Cistaceae","Malvales",0,0,0,23,0,NA
"Lechenaultia","Goodeniaceae","Asterales",1,0,2,26,3,0.333333333333333
"Lecocarpus","Asteraceae","Asterales",0,0,0,2,0,NA
"Lecointea","Fabaceae","Fabales",2,0,0,7,2,1
"Lecokia","Apiaceae","Apiales",0,0,0,1,0,NA
"Lecomtedoxa","Sapotaceae","Ericales",1,0,0,6,1,1
"Lecomtella","Poaceae","Poales",0,0,0,1,0,NA
"Lecosia","Amaranthaceae","Caryophyllales",0,0,0,2,0,NA
"Lecythis","Lecythidaceae","Ericales",21,0,0,27,21,1
"Ledebouria","Asparagaceae","Asparagales",0,0,5,53,5,0
"Ledenbergia","Phytolaccaceae","Caryophyllales",0,0,0,3,0,NA
"Ledermanniella","Podostemaceae","Malpighiales",0,0,0,11,0,NA
"Ledothamnus","Ericaceae","Ericales",1,0,0,7,1,1
"Ledum","Ericaceae","Ericales",3,0,0,6,3,1
"Leea","Vitaceae","Vitales",3,0,0,36,3,1
"Leersia","Poaceae","Poales",0,0,5,18,5,0
"Leeuwenbergia","Euphorbiaceae","Malpighiales",0,0,0,2,0,NA
"Lefebvrea","Apiaceae","Apiales",0,0,0,10,0,NA
"Legazpia","Linderniaceae","Lamiales",0,0,1,1,1,0
"Legenere","Campanulaceae","Asterales",0,0,0,1,0,NA
"Legousia","Campanulaceae","Asterales",0,0,3,7,3,0
"Legrandia","Myrtaceae","Myrtales",0,0,0,1,0,NA
"Lehmanniella","Gentianaceae","Gentianales",0,0,0,3,0,NA
"Leibnitzia","Asteraceae","Asterales",0,0,1,9,1,0
"Leiboldia","Asteraceae","Asterales",0,0,0,1,0,NA
"Leichardtia","Apocynaceae","Gentianales",0,0,0,4,0,NA
"Leidesia","Euphorbiaceae","Malpighiales",0,0,1,1,1,0
"Leighia","Asteraceae","Asterales",0,0,0,2,0,NA
"Leiocarpa","Asteraceae","Asterales",0,0,4,10,4,0
"Leionema","Rutaceae","Sapindales",2,0,0,21,2,1
"Leiophyllum","Ericaceae","Ericales",0,0,0,3,0,NA
"Leiospermum","Cunoniaceae","Oxalidales",0,0,0,1,0,NA
"Leiospora","Brassicaceae","Brassicales",0,0,3,6,3,0
"Leiostemon","Plantaginaceae","Lamiales",0,0,0,2,0,NA
"Leiothrix","Eriocaulaceae","Poales",0,0,0,64,0,NA
"Leiothylax","Podostemaceae","Malpighiales",0,0,0,2,0,NA
"Leiotulus","Apiaceae","Apiales",0,0,0,6,0,NA
"Leiphaimos","Gentianaceae","Gentianales",0,0,0,2,0,NA
"Leipoldtia","Aizoaceae","Caryophyllales",0,0,0,21,0,NA
"Leitneria","Simaroubaceae","Sapindales",1,0,0,1,1,1
"Lellingeria","Polypodiaceae","Polypodiales",0,0,0,39,0,NA
"Lelya","Rubiaceae","Gentianales",0,0,0,1,0,NA
"Lemaireocereus","Cactaceae","Caryophyllales",0,0,0,1,0,NA
"Lembocarpus","Gesneriaceae","Lamiales",0,0,1,1,1,0
"Lembotropis","Fabaceae","Fabales",0,0,0,2,0,NA
"Lemma","Marsileaceae","Salviniales",0,0,0,2,0,NA
"Lemmaphyllum","Polypodiaceae","Polypodiales",0,0,0,5,0,NA
"Lemna","Araceae","Alismatales",0,0,13,14,13,0
"Lemooria","Asteraceae","Asterales",0,0,1,1,1,0
"Lemurella","Orchidaceae","Asparagales",0,0,1,4,1,0
"Lemurodendron","Fabaceae","Fabales",0,0,0,1,0,NA
"Lemurophoenix","Arecaceae","Arecales",1,0,0,1,1,1
"Lemuropisum","Fabaceae","Fabales",1,0,0,1,1,1
"Lemurorchis","Orchidaceae","Asparagales",0,0,1,1,1,0
"Lemurosicyos","Cucurbitaceae","Cucurbitales",0,0,0,1,0,NA
"Lemyrea","Rubiaceae","Gentianales",0,0,0,4,0,NA
"Lenda","Tectariaceae","Polypodiales",0,0,0,1,0,NA
"Lendneria","Plantaginaceae","Lamiales",0,0,0,1,0,NA
"Lennea","Fabaceae","Fabales",1,0,0,3,1,1
"Lennoa","Boraginaceae","UnknownOrder-Boraginaceae",0,0,0,2,0,NA
"Lenophyllum","Crassulaceae","Saxifragales",0,0,0,7,0,NA
"Lens","Fabaceae","Fabales",0,0,2,7,2,0
"Lenwebbia","Myrtaceae","Myrtales",2,0,0,2,2,1
"Lenzia","Portulacaceae","Caryophyllales",0,0,0,1,0,NA
"Leocereus","Cactaceae","Caryophyllales",0,0,0,1,0,NA
"Leochilus","Orchidaceae","Asparagales",0,0,0,12,0,NA
"Leonardendron","Fabaceae","Fabales",0,0,0,1,0,NA
"Leonardoxa","Fabaceae","Fabales",1,0,0,3,1,1
"Leonia","Violaceae","Malpighiales",3,0,0,6,3,1
"Leonis","Asteraceae","Asterales",0,0,0,1,0,NA
"Leonotis","Lamiaceae","Lamiales",3,0,1,9,4,0.75
"Leontice","Berberidaceae","Ranunculales",0,0,1,4,1,0
"Leontodon","Asteraceae","Asterales",0,0,5,79,5,0
"Leontonyx","Asteraceae","Asterales",0,0,0,2,0,NA
"Leontopodium","Asteraceae","Asterales",0,0,1,61,1,0
"Leonurus","Lamiaceae","Lamiales",0,0,6,24,6,0
"Leopoldia","Asparagaceae","Asparagales",0,0,3,11,3,0
"Leopoldinia","Arecaceae","Arecales",2,0,0,2,2,1
"Lepanthes","Orchidaceae","Asparagales",0,0,2,1092,2,0
"Lepanthopsis","Orchidaceae","Asparagales",0,0,1,43,1,0
"Lepargyrea","Elaeagnaceae","Rosales",0,0,0,1,0,NA
"Lepechinia","Lamiaceae","Lamiales",8,0,0,42,8,1
"Lepechiniella","Boraginaceae","UnknownOrder-Boraginaceae",0,0,0,4,0,NA
"Lepicaune","Asteraceae","Asterales",0,0,0,2,0,NA
"Lepidagathis","Acanthaceae","Lamiales",1,0,0,71,1,1
"Lepidaploa","Asteraceae","Asterales",0,0,0,140,0,NA
"Lepidaria","Loranthaceae","Santalales",0,0,0,1,0,NA
"Lepidella","Loranthaceae","Santalales",0,0,0,1,0,NA
"Lepidesmia","Asteraceae","Asterales",0,0,0,1,0,NA
"Lepidium","Brassicaceae","Brassicales",0,0,16,234,16,0
"Lepidobolus","Restionaceae","Poales",0,0,1,6,1,0
"Lepidobotrys","Lepidobotryaceae","Celastrales",1,0,0,1,1,1
"Lepidocaryum","Arecaceae","Arecales",1,0,0,1,1,1
"Lepidoceras","Santalaceae","Santalales",0,0,0,2,0,NA
"Lepidocordia","Boraginaceae","UnknownOrder-Boraginaceae",2,0,0,2,2,1
"Lepidogrammitis","Polypodiaceae","Polypodiales",0,0,0,8,0,NA
"Lepidogyne","Orchidaceae","Asparagales",0,0,0,1,0,NA
"Lepidolopha","Asteraceae","Asterales",0,0,0,8,0,NA
"Lepidolopsis","Asteraceae","Asterales",0,0,0,1,0,NA
"Lepidomicrosorium","Polypodiaceae","Polypodiales",0,0,0,7,0,NA
"Lepidoneuron","Lomariopsidaceae","Polypodiales",0,0,0,2,0,NA
"Lepidonia","Asteraceae","Asterales",0,0,0,7,0,NA
"Lepidophorum","Asteraceae","Asterales",0,0,0,1,0,NA
"Lepidophyllum","Asteraceae","Asterales",1,0,0,1,1,1
"Lepidorrhachis","Arecaceae","Arecales",1,0,0,1,1,1
"Lepidospartum","Asteraceae","Asterales",2,0,0,3,2,1
"Lepidosperma","Cyperaceae","Poales",0,0,14,66,14,0
"Lepidostemon","Brassicaceae","Brassicales",0,0,0,5,0,NA
"Lepidostemon","Convolvulaceae",NA,0,0,0,1,0,NA
"Lepidostephium","Asteraceae","Asterales",0,0,0,2,0,NA
"Lepidostoma","Rubiaceae","Gentianales",0,0,0,1,0,NA
"Lepidothamnus","Podocarpaceae","Araucariales",2,0,0,3,2,1
"Lepidotrichilia","Meliaceae","Sapindales",2,0,0,4,2,1
"Lepidozamia","Zamiaceae","Cycadales",1,0,0,2,1,1
"Lepilaena","Potamogetonaceae","Alismatales",0,0,3,6,3,0
"Lepinia","Apocynaceae","Gentianales",1,0,0,4,1,1
"Lepiniopsis","Apocynaceae","Gentianales",2,0,0,2,2,1
"Lepionurus","Opiliaceae","Santalales",1,0,0,1,1,1
"Lepironia","Cyperaceae","Poales",0,0,1,1,1,0
"Lepisanthes","Sapindaceae","Sapindales",3,0,0,11,3,1
"Lepismium","Cactaceae","Caryophyllales",1,0,0,8,1,1
"Lepisorus","Polypodiaceae","Polypodiales",0,0,0,93,0,NA
"Lepistemon","Convolvulaceae","Solanales",0,0,0,4,0,NA
"Lepistemonopsis","Convolvulaceae","Solanales",0,0,0,1,0,NA
"Leplaea","Meliaceae","Sapindales",0,0,0,1,0,NA
"Leporella","Orchidaceae","Asparagales",0,0,1,1,1,0
"Leptactina","Rubiaceae","Gentianales",3,0,0,27,3,1
"Leptadenia","Apocynaceae","Gentianales",1,0,0,5,1,1
"Leptagrostis","Poaceae","Poales",0,0,0,1,0,NA
"Leptaleum","Brassicaceae","Brassicales",0,0,0,1,0,NA
"Leptamnium","Orobanchaceae","Lamiales",0,0,0,1,0,NA
"Leptandra","Plantaginaceae","Lamiales",0,0,0,3,0,NA
"Leptarrhena","Saxifragaceae","Saxifragales",0,0,1,1,1,0
"Leptasea","Saxifragaceae","Saxifragales",0,0,0,1,0,NA
"Leptaspis","Poaceae","Poales",0,0,1,5,1,0
"Leptaulus","Cardiopteridaceae","Aquifoliales",1,0,0,6,1,1
"Leptidium","Fabaceae","Fabales",0,0,0,1,0,NA
"Leptinella","Asteraceae","Asterales",0,0,4,33,4,0
"Leptoboea","Gesneriaceae","Lamiales",0,0,0,1,0,NA
"Leptocarpha","Asteraceae","Asterales",0,0,0,1,0,NA
"Leptocarpus","Restionaceae","Poales",0,0,1,2,1,0
"Leptocarydion","Poaceae","Poales",0,0,0,1,0,NA
"Leptoceras","Orchidaceae","Asparagales",0,0,0,1,0,NA
"Leptocereus","Cactaceae","Caryophyllales",0,0,0,6,0,NA
"Leptochilus","Polypodiaceae","Polypodiales",0,0,0,19,0,NA
"Leptochiton","Amaryllidaceae","Asparagales",0,0,1,2,1,0
"Leptochloa","Poaceae","Poales",0,0,3,36,3,0
"Leptocionium","Hymenophyllaceae","Hymenophyllales",0,0,0,1,0,NA
"Leptocladia","Cactaceae","Caryophyllales",0,0,0,1,0,NA
"Leptoclinium","Asteraceae","Asterales",0,0,0,1,0,NA
"Leptocoryphium","Poaceae","Poales",0,0,0,2,0,NA
"Leptodactylon","Polemoniaceae","Ericales",1,0,0,6,1,1
"Leptodermis","Rubiaceae","Gentianales",1,0,0,47,1,1
"Leptoderris","Fabaceae","Fabales",1,0,0,27,1,1
"Leptodesmia","Fabaceae","Fabales",0,0,0,3,0,NA
"Leptoglossis","Solanaceae","Solanales",0,0,0,6,0,NA
"Leptoglottis","Fabaceae","Fabales",0,0,0,1,0,NA
"Leptogramma","Thelypteridaceae","Polypodiales",0,0,0,10,0,NA
"Leptolaena","Sarcolaenaceae","Malvales",5,0,0,10,5,1
"Leptolepia","Dennstaedtiaceae","Polypodiales",0,0,0,1,0,NA
"Leptolepidium","Pteridaceae","Polypodiales",0,0,0,3,0,NA
"Leptolobium","Fabaceae","Fabales",0,0,0,3,0,NA
"Leptomeria","Santalaceae","Santalales",0,0,0,1,0,NA
"Leptomischus","Rubiaceae","Gentianales",0,0,0,7,0,NA
"Leptonema","Phyllanthaceae","Malpighiales",0,0,0,2,0,NA
"Leptonychia","Malvaceae","Malvales",2,0,0,26,2,1
"Leptopetalum","Rubiaceae","Gentianales",0,0,0,3,0,NA
"Leptopoda","Asteraceae","Asterales",0,0,0,1,0,NA
"Leptopteris","Osmundaceae","Osmundales",0,0,2,2,2,0
"Leptopus","Phyllanthaceae","Malpighiales",2,1,0,10,2,1
"Leptopyrum","Ranunculaceae","Ranunculales",0,0,1,1,1,0
"Leptorchis","Orchidaceae","Asparagales",0,0,0,3,0,NA
"Leptorhabdos","Orobanchaceae","Lamiales",0,0,0,1,0,NA
"Leptorhynchos","Asteraceae","Asterales",0,0,3,10,3,0
"Leptormus","Brassicaceae","Brassicales",0,0,0,1,0,NA
"Leptorumohra","Dryopteridaceae","Polypodiales",0,0,0,4,0,NA
"Leptoscela","Rubiaceae","Gentianales",0,0,0,1,0,NA
"Leptosema","Fabaceae","Fabales",0,0,0,6,0,NA
"Leptosiphon","Polemoniaceae","Ericales",0,0,0,26,0,NA
"Leptosolena","Zingiberaceae","Zingiberales",0,0,0,1,0,NA
"Leptospermum","Myrtaceae","Myrtales",71,0,0,87,71,1
"Leptospron","Fabaceae","Fabales",0,0,0,2,0,NA
"Leptostachya","Acanthaceae","Lamiales",0,0,0,1,0,NA
"Leptostelma","Asteraceae","Asterales",0,0,0,7,0,NA
"Leptostigma","Rubiaceae","Gentianales",0,0,0,7,0,NA
"Leptostylis","Sapotaceae","Ericales",1,0,0,8,1,1
"Leptosyne","Asteraceae","Asterales",0,0,0,3,0,NA
"Leptotaenia","Apiaceae","Apiales",0,0,0,3,0,NA
"Leptoterantha","Menispermaceae","Ranunculales",0,1,0,1,0,NA
"Leptotes","Orchidaceae","Asparagales",0,0,1,9,1,0
"Leptothrium","Poaceae","Poales",0,0,0,2,0,NA
"Leptothyrsa","Rutaceae","Sapindales",0,0,0,1,0,NA
"Lepturidium","Poaceae","Poales",0,0,0,1,0,NA
"Lepturopetium","Poaceae","Poales",0,0,0,2,0,NA
"Lepturus","Poaceae","Poales",0,0,1,11,1,0
"Lepuropetalon","Celastraceae","Celastrales",0,0,1,1,1,0
"Lepyrodia","Restionaceae","Poales",0,0,6,13,6,0
"Lepyrodiclis","Caryophyllaceae","Caryophyllales",0,0,0,3,0,NA
"Lerchea","Rubiaceae","Gentianales",1,0,0,10,1,1
"Lereschia","Apiaceae","Apiales",0,0,0,1,0,NA
"Leretia","Icacinaceae","UnknownOrder-Icacinaceae",0,0,0,1,0,NA
"Lescaillea","Asteraceae","Asterales",0,0,0,1,0,NA
"Lespedeza","Fabaceae","Fabales",3,0,3,58,6,0.5
"Lesquerella","Brassicaceae","Brassicales",0,0,0,15,0,NA
"Lessertia","Fabaceae","Fabales",1,0,1,61,2,0.5
"Lessingia","Asteraceae","Asterales",0,0,0,10,0,NA
"Lessingianthus","Asteraceae","Asterales",0,0,0,126,0,NA
"Letestua","Sapotaceae","Ericales",1,0,0,1,1,1
"Letestudoxa","Annonaceae","Magnoliales",2,0,0,3,2,1
"Letestuella","Podostemaceae","Malpighiales",0,0,0,1,0,NA
"Lethedon","Thymelaeaceae","Malvales",1,0,0,14,1,1
"Lethia","Iridaceae","Asparagales",0,0,0,1,0,NA
"Leto","Asteraceae","Asterales",0,0,0,1,0,NA
"Lettowianthus","Annonaceae","Magnoliales",1,0,0,1,1,1
"Lettsomia","Convolvulaceae","Solanales",0,0,0,1,0,NA
"Leucactinia","Asteraceae","Asterales",0,0,0,1,0,NA
"Leucadendron","Proteaceae","Proteales",56,0,0,83,56,1
"Leucaena","Fabaceae","Fabales",9,0,0,25,9,1
"Leucanthemella","Asteraceae","Asterales",0,0,0,2,0,NA
"Leucanthemopsis","Asteraceae","Asterales",0,0,1,7,1,0
"Leucanthemum","Asteraceae","Asterales",0,0,3,42,3,0
"Leucas","Lamiaceae","Lamiales",1,0,11,111,12,0.0833333333333333
"Leucaster","Nyctaginaceae","Caryophyllales",0,0,0,1,0,NA
"Leucerminium","Orchidaceae","Asparagales",0,0,0,1,0,NA
"Leucheria","Asteraceae","Asterales",0,0,0,40,0,NA
"Leuchtenbergia","Cactaceae","Caryophyllales",0,0,0,1,0,NA
"Leuciva","Asteraceae","Asterales",0,0,0,1,0,NA
"Leucocarpus","Phrymaceae","Lamiales",0,0,1,1,1,0
"Leucochloron","Fabaceae","Fabales",0,0,0,5,0,NA
"Leucochrysum","Asteraceae","Asterales",0,0,2,5,2,0
"Leucocodon","Rubiaceae","Gentianales",0,0,0,1,0,NA
"Leucocoma","Ranunculaceae","Ranunculales",0,0,0,2,0,NA
"Leucocoryne","Amaryllidaceae","Asparagales",0,0,10,49,10,0
"Leucocrinum","Asparagaceae","Asparagales",0,0,1,1,1,0
"Leucocroton","Euphorbiaceae","Malpighiales",4,0,0,26,4,1
"Leucogenes","Asteraceae","Asterales",1,0,0,4,1,1
"Leucojum","Amaryllidaceae","Asparagales",0,0,2,2,2,0
"Leucolophus","Rubiaceae","Gentianales",0,0,0,3,0,NA
"Leucomeris","Asteraceae","Asterales",0,0,0,2,0,NA
"Leucomphalos","Fabaceae","Fabales",0,0,0,4,0,NA
"Leuconotis","Apocynaceae","Gentianales",0,0,0,4,0,NA
"Leucophyllum","Scrophulariaceae","Lamiales",0,0,1,15,1,0
"Leucophysalis","Solanaceae","Solanales",0,0,0,5,0,NA
"Leucophyta","Asteraceae","Asterales",1,0,0,1,1,1
"Leucopoa","Poaceae","Poales",0,0,0,1,0,NA
"Leucopogon","Ericaceae","Ericales",1,0,0,7,1,1
"Leucoptera","Asteraceae","Asterales",0,0,0,3,0,NA
"Leucorchis","Orchidaceae","Asparagales",0,0,0,1,0,NA
"Leucosalpa","Orobanchaceae","Lamiales",0,0,0,3,0,NA
"Leucosceptrum","Lamiaceae","Lamiales",0,0,0,1,0,NA
"Leucoseris","Asteraceae","Asterales",0,0,0,1,0,NA
"Leucosidea","Rosaceae","Rosales",0,0,0,1,0,NA
"Leucospermum","Proteaceae","Proteales",20,0,0,47,20,1
"Leucosphaera","Amaranthaceae","Caryophyllales",0,0,0,1,0,NA
"Leucospora","Plantaginaceae","Lamiales",0,0,0,1,0,NA
"Leucostegane","Fabaceae","Fabales",0,0,0,2,0,NA
"Leucostegia","Hypodematiaceae","Polypodiales",0,0,0,3,0,NA
"Leucosyke","Urticaceae","Rosales",0,0,0,1,0,NA
"Leucothoe","Ericaceae","Ericales",5,0,0,9,5,1
"Leucothrinax","Arecaceae","Arecales",1,0,0,1,1,1
"Leucotrichum","Polypodiaceae","Polypodiales",0,0,0,5,0,NA
"Leunisia","Asteraceae","Asterales",0,0,0,1,0,NA
"Leutea","Apiaceae","Apiales",0,0,0,1,0,NA
"Leuzea","Asteraceae","Asterales",0,0,0,1,0,NA
"Levenhookia","Stylidiaceae","Asterales",0,0,0,1,0,NA
"Levisticum","Apiaceae","Apiales",0,0,0,1,0,NA
"Lewisia","Montiaceae","Caryophyllales",0,0,5,17,5,0
"Lexarzanthe","Brassicaceae","Brassicales",0,0,0,1,0,NA
"Leycesteria","Caprifoliaceae","Dipsacales",1,0,0,6,1,1
"Leydeum","Poaceae","Poales",0,0,0,2,0,NA
"Leymostachys","Poaceae","Poales",0,0,0,1,0,NA
"Leymotrigia","Poaceae","Poales",0,0,0,6,0,NA
"Leymus","Poaceae","Poales",0,0,9,55,9,0
"Leysera","Asteraceae","Asterales",0,0,0,4,0,NA
"Liabellum","Asteraceae","Asterales",0,0,0,1,0,NA
"Liabum","Asteraceae","Asterales",1,0,0,36,1,1
"Lianthus","Hypericaceae","Malpighiales",0,0,0,1,0,NA
"Liatris","Asteraceae","Asterales",0,0,3,50,3,0
"Libanothamnus","Asteraceae","Asterales",0,0,0,14,0,NA
"Libanotis","Apiaceae","Apiales",0,0,0,16,0,NA
"Liberatia","Acanthaceae","Lamiales",0,0,0,1,0,NA
"Libertia","Iridaceae","Asparagales",0,0,9,16,9,0
"Libidibia","Fabaceae","Fabales",0,0,0,2,0,NA
"Libocedrus","Cupressaceae","Cupressales",4,0,0,5,4,1
"Librevillea","Fabaceae","Fabales",1,0,0,1,1,1
"Libyella","Poaceae","Poales",0,0,0,1,0,NA
"Licania","Chrysobalanaceae","Malpighiales",83,0,0,219,83,1
"Licaria","Lauraceae","Laurales",17,0,0,62,17,1
"Lichtensteinia","Apiaceae","Apiales",0,0,1,6,1,0
"Licuala","Arecaceae","Arecales",4,0,0,153,4,1
"Lidbeckia","Asteraceae","Asterales",0,1,0,2,0,NA
"Liebigia","Gesneriaceae","Lamiales",0,0,0,12,0,NA
"Liesneria","Loganiaceae","Gentianales",0,0,0,1,0,NA
"Lifago","Asteraceae","Asterales",0,0,0,1,0,NA
"Ligaria","Loranthaceae","Santalales",1,0,0,2,1,1
"Ligeophila","Orchidaceae","Asparagales",0,0,0,12,0,NA
"Ligeria","Gesneriaceae","Lamiales",0,0,0,1,0,NA
"Lightfootia","Campanulaceae","Asterales",0,0,0,2,0,NA
"Lightiodendron","Euphroniaceae","Malpighiales",0,0,0,1,0,NA
"Ligularia","Asteraceae","Asterales",0,0,20,155,20,0
"Ligulariopsis","Asteraceae","Asterales",0,0,1,1,1,0
"Ligusticopsis","Apiaceae","Apiales",0,0,0,2,0,NA
"Ligusticum","Apiaceae","Apiales",0,0,5,58,5,0
"Ligustrum","Oleaceae","Lamiales",15,0,0,43,15,1
"Lijndenia","Melastomataceae","Myrtales",1,0,0,12,1,1
"Lilaeopsis","Apiaceae","Apiales",0,0,3,9,3,0
"Lilium","Liliaceae","Liliales",0,0,54,111,54,0
"Limacia","Menispermaceae","Ranunculales",1,0,0,1,1,1
"Limaciopsis","Menispermaceae","Ranunculales",0,0,0,2,0,NA
"Limbarda","Asteraceae","Asterales",0,0,0,2,0,NA
"Limeum","Limeaceae","Caryophyllales",1,0,0,20,1,1
"Limnanthemum","Menyanthaceae","Asterales",0,0,0,1,0,NA
"Limnanthes","Limnanthaceae","Brassicales",0,0,1,8,1,0
"Limnas","Poaceae","Poales",0,0,0,3,0,NA
"Limnia","Montiaceae","Caryophyllales",0,0,0,7,0,NA
"Limnobium","Hydrocharitaceae","Alismatales",0,0,2,2,2,0
"Limnobotrya","Saxifragaceae","Saxifragales",0,0,0,3,0,NA
"Limnocharis","Alismataceae","Alismatales",0,0,1,2,1,0
"Limnocitrus","Rutaceae","Sapindales",0,0,0,1,0,NA
"Limnodea","Poaceae","Poales",0,0,0,1,0,NA
"Limnophila","Plantaginaceae","Lamiales",0,0,2,18,2,0
"Limnophyton","Alismataceae","Alismatales",0,0,1,3,1,0
"Limnopoa","Poaceae","Poales",0,0,0,1,0,NA
"Limnosciadium","Apiaceae","Apiales",0,0,0,2,0,NA
"Limnosipanea","Rubiaceae","Gentianales",0,0,0,3,0,NA
"Limodorum","Orchidaceae","Asparagales",0,0,1,3,1,0
"Limonia","Rutaceae","Sapindales",1,0,0,1,1,1
"Limoniastrum","Plumbaginaceae","Caryophyllales",1,0,0,1,1,1
"Limoniopsis","Plumbaginaceae","Caryophyllales",0,0,0,1,0,NA
"Limonium","Plumbaginaceae","Caryophyllales",2,2,11,166,13,0.153846153846154
"Limosella","Scrophulariaceae","Lamiales",0,0,3,11,3,0
"Linanthastrum","Polemoniaceae","Ericales",0,0,0,1,0,NA
"Linanthus","Polemoniaceae","Ericales",0,0,0,45,0,NA
"Linaria","Plantaginaceae","Lamiales",0,0,4,98,4,0
"Linariopsis","Pedaliaceae","Lamiales",0,0,0,2,0,NA
"Linconia","Bruniaceae","Bruniales",3,0,0,4,3,1
"Lindackeria","Achariaceae","Malpighiales",2,0,0,9,2,1
"Lindbergella","Poaceae","Poales",0,0,0,1,0,NA
"Lindelofia","Boraginaceae","UnknownOrder-Boraginaceae",0,0,1,4,1,0
"Lindenbergia","Plantaginaceae","Lamiales",0,0,1,4,1,0
"Lindeniopiper","Piperaceae","Piperales",0,0,0,2,0,NA
"Lindera","Lauraceae","Laurales",19,0,0,53,19,1
"Lindernia","Linderniaceae","Lamiales",0,0,11,85,11,0
"Lindheimera","Asteraceae","Asterales",0,0,0,2,0,NA
"Lindleya","Rosaceae","Rosales",0,0,0,1,0,NA
"Lindmania","Bromeliaceae","Poales",0,0,1,38,1,0
"Lindsaea","Lindsaeaceae","Polypodiales",0,0,3,89,3,0
"Lindsaenium","Lindsaeaceae","Polypodiales",0,0,0,1,0,NA
"Lindsayomyrtus","Myrtaceae","Myrtales",1,0,0,1,1,1
"Lingelsheimia","Phyllanthaceae","Malpighiales",0,0,0,6,0,NA
"Lingoum","Fabaceae","Fabales",0,0,0,1,0,NA
"Linnaea","Caprifoliaceae","Dipsacales",1,0,0,2,1,1
"Linnaeosicyos","Cucurbitaceae","Cucurbitales",0,0,1,1,1,0
"Linodendron","Thymelaeaceae","Malvales",0,0,0,3,0,NA
"Linospadix","Arecaceae","Arecales",3,0,0,7,3,1
"Linostoma","Thymelaeaceae","Malvales",0,0,0,3,0,NA
"Linosyris","Asteraceae","Asterales",0,0,0,2,0,NA
"Lintonia","Poaceae","Poales",0,0,0,2,0,NA
"Linum","Linaceae","Malpighiales",2,0,5,141,7,0.285714285714286
"Linzia","Asteraceae","Asterales",0,0,0,10,0,NA
"Liparia","Fabaceae","Fabales",15,0,0,19,15,1
"Liparis","Orchidaceae","Asparagales",0,0,21,428,21,0
"Liparophyllum","Menyanthaceae","Asterales",0,0,2,7,2,0
"Lipocarpha","Cyperaceae","Poales",0,0,12,35,12,0
"Lipochaeta","Asteraceae","Asterales",0,0,0,12,0,NA
"Lippia","Verbenaceae","Lamiales",9,0,2,191,11,0.818181818181818
"Lipskya","Apiaceae","Apiales",0,0,0,1,0,NA
"Lipskyella","Asteraceae","Asterales",0,0,0,1,0,NA
"Liquidambar","Altingiaceae","Saxifragales",4,0,0,5,4,1
"Liriodendron","Magnoliaceae","Magnoliales",2,0,0,2,2,1
"Liriope","Asparagaceae","Asparagales",0,0,2,6,2,0
"Lisaea","Apiaceae","Apiales",0,0,0,2,0,NA
"Lisianthius","Gentianaceae","Gentianales",1,0,0,31,1,1
"Lissanthe","Ericaceae","Ericales",1,0,0,1,1,1
"Lissocarpa","Ebenaceae","Ericales",2,0,0,8,2,1
"Lissospermum","Acanthaceae","Lamiales",0,0,0,1,0,NA
"Listrobanthes","Acanthaceae","Lamiales",0,0,0,1,0,NA
"Listrostachys","Orchidaceae","Asparagales",0,0,1,1,1,0
"Litanthus","Asparagaceae","Asparagales",0,0,0,1,0,NA
"Litchi","Sapindaceae","Sapindales",1,0,0,3,1,1
"Lithachne","Poaceae","Poales",0,0,2,4,2,0
"Lithobium","Melastomataceae","Myrtales",0,0,0,1,0,NA
"Lithocardium","Boraginaceae","UnknownOrder-Boraginaceae",0,0,0,2,0,NA
"Lithocarpus","Fagaceae","Fagales",68,0,0,336,68,1
"Lithodora","Boraginaceae","UnknownOrder-Boraginaceae",0,0,0,3,0,NA
"Lithodraba","Brassicaceae","Brassicales",0,0,0,1,0,NA
"Lithomyrtus","Myrtaceae","Myrtales",1,0,0,11,1,1
"Lithoon","Fabaceae","Fabales",0,0,0,1,0,NA
"Lithophila","Amaranthaceae","Caryophyllales",0,0,0,1,0,NA
"Lithophragma","Saxifragaceae","Saxifragales",0,0,3,15,3,0
"Lithops","Aizoaceae","Caryophyllales",0,0,0,31,0,NA
"Lithosciadium","Apiaceae","Apiales",0,0,0,1,0,NA
"Lithospermum","Boraginaceae","UnknownOrder-Boraginaceae",0,0,4,77,4,0
"Lithostegia","Dryopteridaceae","Polypodiales",0,0,0,1,0,NA
"Lithraea","Anacardiaceae","Sapindales",2,0,0,2,2,1
"Lithrea","Anacardiaceae","Sapindales",0,0,0,1,0,NA
"Litobrochia","Pteridaceae","Polypodiales",0,0,11,12,11,0
"Litogyne","Asteraceae","Asterales",0,0,0,1,0,NA
"Litothamnus","Asteraceae","Asterales",0,0,0,2,0,NA
"Litrisa","Asteraceae","Asterales",0,0,0,1,0,NA
"Litsea","Lauraceae","Laurales",41,0,0,150,41,1
"Littledalea","Poaceae","Poales",0,0,0,4,0,NA
"Littonia","Colchicaceae","Liliales",0,0,0,1,0,NA
"Littorella","Plantaginaceae","Lamiales",0,0,1,3,1,0
"Litwinowia","Brassicaceae","Brassicales",0,0,0,1,0,NA
"Livistona","Arecaceae","Arecales",10,0,0,28,10,1
"Llagunoa","Sapindaceae","Sapindales",1,0,0,3,1,1
"Llavea","Pteridaceae","Polypodiales",0,0,0,1,0,NA
"Llerasia","Asteraceae","Asterales",0,0,0,11,0,NA
"Loasa","Loasaceae","Cornales",0,1,9,32,9,0
"Lobanilia","Euphorbiaceae","Malpighiales",1,0,0,7,1,1
"Lobaria","Saxifragaceae","Saxifragales",0,0,0,1,0,NA
"Lobelia","Campanulaceae","Asterales",8,1,43,414,51,0.156862745098039
"Lobivia","Cactaceae","Caryophyllales",0,0,0,38,0,NA
"Lobostemon","Boraginaceae","UnknownOrder-Boraginaceae",1,0,0,30,1,1
"Lobularia","Brassicaceae","Brassicales",0,0,2,5,2,0
"Locheria","Gesneriaceae","Lamiales",0,0,0,1,0,NA
"Lockhartia","Orchidaceae","Asparagales",0,0,2,28,2,0
"Lodoicea","Arecaceae","Arecales",1,0,0,1,1,1
"Loefgrenianthus","Orchidaceae","Asparagales",0,0,0,1,0,NA
"Loeflingia","Caryophyllaceae","Caryophyllales",0,0,0,4,0,NA
"Loeselia","Polemoniaceae","Ericales",0,0,0,15,0,NA
"Loeseliastrum","Polemoniaceae","Ericales",0,0,0,3,0,NA
"Loesenera","Fabaceae","Fabales",1,0,0,4,1,1
"Loeseneriella","Celastraceae","Celastrales",2,0,0,18,2,1
"Loewia","Passifloraceae","Malpighiales",0,0,0,2,0,NA
"Logania","Loganiaceae","Gentianales",0,0,0,5,0,NA
"Logfia","Asteraceae","Asterales",0,0,1,5,1,0
"Loheria","Primulaceae","Ericales",0,0,0,1,0,NA
"Loiseleuria","Ericaceae","Ericales",1,0,0,1,1,1
"Loliolum","Poaceae","Poales",0,0,1,1,1,0
"Lolium","Poaceae","Poales",0,0,6,11,6,0
"Lomagramma","Dryopteridaceae","Polypodiales",0,0,0,9,0,NA
"Lomandra","Asparagaceae","Asparagales",1,0,21,52,22,0.0454545454545455
"Lomanthus","Asteraceae","Asterales",0,0,0,1,0,NA
"Lomaphlebia","Polypodiaceae","Polypodiales",0,0,0,1,0,NA
"Lomaria","Blechnaceae","Polypodiales",0,0,0,12,0,NA
"Lomariopsis","Lomariopsidaceae","Polypodiales",0,0,4,34,4,0
"Lomatia","Proteaceae","Proteales",4,0,0,4,4,1
"Lomatium","Apiaceae","Apiales",0,0,4,87,4,0
"Lomatocarpa","Apiaceae","Apiales",0,0,1,4,1,0
"Lomatogoniopsis","Gentianaceae","Gentianales",0,0,0,3,0,NA
"Lomatogonium","Gentianaceae","Gentianales",0,0,0,21,0,NA
"Lomatopodium","Apiaceae","Apiales",0,0,0,1,0,NA
"Lomatozona","Asteraceae","Asterales",0,0,0,4,0,NA
"Lomelosia","Caprifoliaceae","Dipsacales",0,0,0,4,0,NA
"Lonas","Asteraceae","Asterales",0,0,0,1,0,NA
"Lonchitis-aspera","Blechnaceae","Polypodiales",0,0,0,1,0,NA
"Lonchocarpus","Fabaceae","Fabales",31,0,0,211,31,1
"Lonchostephus","Podostemaceae","Malpighiales",0,0,0,1,0,NA
"Lonchostoma","Bruniaceae","Bruniales",2,0,0,2,2,1
"Longetia","Picrodendraceae","Malpighiales",0,0,0,1,0,NA
"Lonicera","Caprifoliaceae","Dipsacales",30,0,0,103,30,1
"Lopezia","Onagraceae","Myrtales",3,0,0,21,3,1
"Lophacme","Poaceae","Poales",0,0,0,2,0,NA
"Lophanthera","Malpighiaceae","Malpighiales",3,0,0,4,3,1
"Lophanthus","Lamiaceae","Lamiales",0,0,0,23,0,NA
"Lophatherum","Poaceae","Poales",0,0,1,2,1,0
"Lophidium","Schizaeaceae","Schizaeales",0,0,0,1,0,NA
"Lophiocarpus","Lophiocarpaceae","Caryophyllales",0,0,3,3,3,0
"Lophiola","Nartheciaceae","Dioscoreales",0,0,1,1,1,0
"Lophion","Violaceae","Malpighiales",0,0,0,3,0,NA
"Lophira","Ochnaceae","Malpighiales",2,0,0,2,2,1
"Lophocarpinia","Fabaceae","Fabales",0,0,0,1,0,NA
"Lophocereus","Cactaceae","Caryophyllales",0,0,0,2,0,NA
"Lophodium","Dryopteridaceae","Polypodiales",0,0,0,1,0,NA
"Lopholaena","Asteraceae","Asterales",1,0,0,16,1,1
"Lopholepis","Poaceae","Poales",0,0,0,1,0,NA
"Lophomyrtus","Myrtaceae","Myrtales",2,0,0,3,2,1
"Lophopappus","Asteraceae","Asterales",0,0,0,4,0,NA
"Lophophora","Cactaceae","Caryophyllales",0,0,0,2,0,NA
"Lophophytum","Balanophoraceae","Santalales",0,0,0,4,0,NA
"Lophopogon","Poaceae","Poales",0,0,0,2,0,NA
"Lophopterys","Malpighiaceae","Malpighiales",1,0,0,7,1,1
"Lophosoria","Dicksoniaceae","Cyatheales",0,0,0,2,0,NA
"Lophospermum","Plantaginaceae","Lamiales",1,0,0,8,1,1
"Lophostachys","Acanthaceae","Lamiales",0,0,0,5,0,NA
"Lophostemon","Myrtaceae","Myrtales",4,0,0,4,4,1
"Lophostigma","Sapindaceae","Sapindales",0,0,0,2,0,NA
"Lophostoma","Thymelaeaceae","Malvales",0,0,0,4,0,NA
"Lorandersonia","Asteraceae","Asterales",0,0,0,7,0,NA
"Loranthus","Loranthaceae","Santalales",1,0,0,10,1,1
"Lordhowea","Asteraceae","Asterales",0,0,0,1,0,NA
"Lorencea","Rubiaceae","Gentianales",0,0,0,1,0,NA
"Lorentea","Asteraceae","Asterales",0,0,0,1,0,NA
"Lorentzianthus","Asteraceae","Asterales",0,0,0,1,0,NA
"Lorenzanea","Sabiaceae","UnknownOrder-Sabiaceae",0,0,0,1,0,NA
"Loreya","Melastomataceae","Myrtales",3,0,0,9,3,1
"Loricalepis","Melastomataceae","Myrtales",0,0,0,1,0,NA
"Loricaria","Asteraceae","Asterales",1,0,0,20,1,1
"Lorinseria","Blechnaceae","Polypodiales",0,0,0,1,0,NA
"Loroglossum","Orchidaceae","Asparagales",0,0,0,1,0,NA
"Loropetalum","Hamamelidaceae","Saxifragales",1,0,0,3,1,1
"Lorostemon","Clusiaceae","Malpighiales",0,0,0,3,0,NA
"Lotodes","Fabaceae","Fabales",0,0,0,43,0,NA
"Lotononis","Fabaceae","Fabales",2,0,0,199,2,1
"Lotoxalis","Oxalidaceae","Oxalidales",0,0,0,1,0,NA
"Lotus","Fabaceae","Fabales",1,0,2,141,3,0.333333333333333
"Loudetia","Poaceae","Poales",0,0,1,26,1,0
"Loudetiopsis","Poaceae","Poales",0,0,0,11,0,NA
"Louisiella","Poaceae","Poales",0,0,0,1,0,NA
"Lourteigia","Asteraceae","Asterales",0,0,0,12,0,NA
"Lourtella","Lythraceae","Myrtales",0,0,0,1,0,NA
"Louteridium","Acanthaceae","Lamiales",0,0,0,9,0,NA
"Lovoa","Meliaceae","Sapindales",2,0,0,3,2,1
"Loxanthocereus","Cactaceae","Caryophyllales",0,0,0,7,0,NA
"Loxocalyx","Lamiaceae","Lamiales",0,0,0,3,0,NA
"Loxocarya","Restionaceae","Poales",0,0,2,5,2,0
"Loxococcus","Arecaceae","Arecales",0,0,0,1,0,NA
"Loxodera","Poaceae","Poales",0,0,0,5,0,NA
"Loxogramme","Polypodiaceae","Polypodiales",0,0,0,22,0,NA
"Loxopterygium","Anacardiaceae","Sapindales",2,0,0,3,2,1
"Loxoscaphe","Aspleniaceae","Polypodiales",0,0,0,1,0,NA
"Loxospermum","Fabaceae","Fabales",0,0,0,1,0,NA
"Loxostigma","Gesneriaceae","Lamiales",0,0,0,7,0,NA
"Loxostylis","Anacardiaceae","Sapindales",1,0,0,1,1,1
"Loxothysanus","Asteraceae","Asterales",1,0,0,2,1,1
"Loxotrema","Cyperaceae","Poales",0,0,0,1,0,NA
"Loxsomopsis","Loxsomataceae","Cyatheales",0,0,0,1,0,NA
"Lozanella","Cannabaceae","Rosales",1,0,0,2,1,1
"Lozania","Lacistemataceae","Malpighiales",3,0,0,3,3,1
"Lubaria","Rutaceae","Sapindales",0,0,0,1,0,NA
"Lucilia","Asteraceae","Asterales",0,0,0,9,0,NA
"Luciliocline","Asteraceae","Asterales",0,0,0,12,0,NA
"Luckhoffia","Apocynaceae","Gentianales",0,0,0,1,0,NA
"Luculia","Rubiaceae","Gentianales",3,0,0,4,3,1
"Lucuma","Sapotaceae","Ericales",0,0,0,1,0,NA
"Lucya","Rubiaceae","Gentianales",0,0,0,1,0,NA
"Ludekia","Rubiaceae","Gentianales",2,0,0,2,2,1
"Ludia","Salicaceae","Malpighiales",4,0,0,23,4,1
"Ludisia","Orchidaceae","Asparagales",0,0,0,1,0,NA
"Ludovia","Cyclanthaceae","Pandanales",0,0,1,3,1,0
"Ludwigia","Onagraceae","Myrtales",0,0,14,91,14,0
"Ludwigiantha","Onagraceae","Myrtales",0,0,0,1,0,NA
"Lueckelia","Orchidaceae","Asparagales",0,0,0,1,0,NA
"Lueddemannia","Orchidaceae","Asparagales",0,0,1,3,1,0
"Luehea","Malvaceae","Malvales",7,0,0,15,7,1
"Lueheopsis","Malvaceae","Malvales",4,0,0,6,4,1
"Luetkea","Rosaceae","Rosales",1,0,0,1,1,1
"Luetzelburgia","Fabaceae","Fabales",1,0,0,8,1,1
"Luffa","Cucurbitaceae","Cucurbitales",0,0,2,5,2,0
"Luina","Asteraceae","Asterales",0,0,0,2,0,NA
"Luisia","Orchidaceae","Asparagales",0,0,0,40,0,NA
"Luisma","Polypodiaceae","Polypodiales",0,0,0,1,0,NA
"Lulia","Asteraceae","Asterales",0,0,0,1,0,NA
"Luma","Myrtaceae","Myrtales",2,0,0,2,2,1
"Lumnitzera","Combretaceae","Myrtales",2,0,0,2,2,1
"Lunania","Salicaceae","Malpighiales",2,0,0,3,2,1
"Lunaria","Brassicaceae","Brassicales",0,0,1,4,1,0
"Lunathyrium","Athyriaceae","Polypodiales",0,0,0,28,0,NA
"Lundellianthus","Asteraceae","Asterales",1,0,0,7,1,1
"Lundia","Bignoniaceae","Lamiales",5,0,0,13,5,1
"Lundinia","Asteraceae","Asterales",0,0,0,1,0,NA
"Lupinaster","Fabaceae","Fabales",0,0,0,3,0,NA
"Lupinus","Fabaceae","Fabales",13,1,45,626,58,0.224137931034483
"Luronium","Alismataceae","Alismatales",0,0,1,1,1,0
"Luvunga","Rutaceae","Sapindales",0,0,0,2,0,NA
"Luxemburgia","Ochnaceae","Malpighiales",1,0,0,20,1,1
"Luziola","Poaceae","Poales",0,0,0,11,0,NA
"Luzonia","Fabaceae","Fabales",0,0,0,1,0,NA
"Luzula","Juncaceae","Poales",0,0,52,141,52,0
"Luzuriaga","Alstroemeriaceae","Liliales",0,0,4,4,4,0
"Lyallia","Montiaceae","Caryophyllales",0,0,1,1,1,0
"Lycapsus","Asteraceae","Asterales",0,0,0,1,0,NA
"Lycaste","Orchidaceae","Asparagales",0,0,2,46,2,0
"Lychniothyrsus","Acanthaceae","Lamiales",0,0,0,1,0,NA
"Lychnis","Caryophyllaceae","Caryophyllales",0,0,1,14,1,0
"Lychnodiscus","Sapindaceae","Sapindales",0,0,0,7,0,NA
"Lychnophora","Asteraceae","Asterales",1,0,0,37,1,1
"Lychnophoriopsis","Asteraceae","Asterales",0,0,0,4,0,NA
"Lycianthes","Solanaceae","Solanales",7,0,1,138,8,0.875
"Lycium","Solanaceae","Solanales",36,0,0,88,36,1
"Lycocarpus","Brassicaceae","Brassicales",0,0,0,1,0,NA
"Lycochloa","Poaceae","Poales",0,0,0,1,0,NA
"Lycomormium","Orchidaceae","Asparagales",0,0,2,5,2,0
"Lycopersicon","Solanaceae","Solanales",0,0,1,5,1,0
"Lycopodiastrum","Lycopodiaceae","Lycopodiales",0,0,1,1,1,0
"Lycopodiella","Lycopodiaceae","Lycopodiales",0,0,23,30,23,0
"Lycopodiodes","Lycopodiaceae","Lycopodiales",0,0,1,1,1,0
"Lycopodioides","Selaginellaceae","Selaginellales",0,0,8,10,8,0
"Lycopodium","Lycopodiaceae","Lycopodiales",0,0,40,70,40,0
"Lycopus","Lamiaceae","Lamiales",0,0,8,21,8,0
"Lycoris","Amaryllidaceae","Asparagales",0,0,4,23,4,0
"Lycoseris","Asteraceae","Asterales",0,0,0,11,0,NA
"Lycurus","Poaceae","Poales",0,0,0,3,0,NA
"Lydenburgia","Celastraceae","Celastrales",1,0,0,1,1,1
"Lygeum","Poaceae","Poales",0,0,1,1,1,0
"Lyginia","Anarthriaceae","Poales",0,0,2,3,2,0
"Lygisma","Apocynaceae","Gentianales",0,0,0,3,0,NA
"Lygodesmia","Asteraceae","Asterales",0,0,0,6,0,NA
"Lygodium","Lygodiaceae","Schizaeales",0,0,4,20,4,0
"Lygos","Fabaceae","Fabales",0,0,0,2,0,NA
"Lymania","Bromeliaceae","Poales",0,0,6,9,6,0
"Lyonia","Ericaceae","Ericales",10,0,0,40,10,1
"Lyperanthus","Orchidaceae","Asparagales",0,0,1,2,1,0
"Lyperia","Scrophulariaceae","Lamiales",0,0,2,4,2,0
"Lyrocarpa","Brassicaceae","Brassicales",0,0,0,3,0,NA
"Lyroglossa","Orchidaceae","Asparagales",0,0,0,2,0,NA
"Lysiana","Loranthaceae","Santalales",0,0,0,1,0,NA
"Lysicarpus","Myrtaceae","Myrtales",1,0,0,1,1,1
"Lysichiton","Araceae","Alismatales",0,0,2,2,2,0
"Lysichitum","Araceae","Alismatales",0,0,0,1,0,NA
"Lysidice","Fabaceae","Fabales",1,0,0,2,1,1
"Lysiloma","Fabaceae","Fabales",6,0,0,11,6,1
"Lysimachia","Primulaceae","Ericales",0,2,44,193,44,0
"Lysimachiopsis","Primulaceae","Ericales",0,0,0,1,0,NA
"Lysinema","Ericaceae","Ericales",1,0,0,2,1,1
"Lysionotus","Gesneriaceae","Lamiales",1,0,0,23,1,1
"Lysiostyles","Convolvulaceae","Solanales",0,0,0,1,0,NA
"Lysiphyllum","Fabaceae","Fabales",2,0,0,6,2,1
"Lysipomia","Campanulaceae","Asterales",0,2,0,30,0,NA
"Lythrum","Lythraceae","Myrtales",0,0,3,30,3,0
"Lytocaryum","Arecaceae","Arecales",2,0,0,4,2,1
"Maackia","Fabaceae","Fabales",3,0,0,9,3,1
"Maasia","Annonaceae","Magnoliales",0,0,0,4,0,NA
"Mabea","Euphorbiaceae","Malpighiales",9,0,0,39,9,1
"Mabrya","Plantaginaceae","Lamiales",1,0,0,6,1,1
"Maburea","Olacaceae","Santalales",1,0,0,1,1,1
"Macadamia","Proteaceae","Proteales",5,0,0,5,5,1
"Macahanea","Celastraceae","Celastrales",0,0,0,1,0,NA
"Macairea","Melastomataceae","Myrtales",1,0,0,24,1,1
"Macaranga","Euphorbiaceae","Malpighiales",52,0,0,308,52,1
"Macarenia","Podostemaceae","Malpighiales",0,0,0,1,0,NA
"Macarisia","Rhizophoraceae","Malpighiales",1,0,0,4,1,1
"Macbridea","Lamiaceae","Lamiales",0,0,0,2,0,NA
"Macbrideina","Rubiaceae","Gentianales",1,0,0,1,1,1
"Machaeranthera","Asteraceae","Asterales",0,0,0,27,0,NA
"Machaerina","Cyperaceae","Poales",0,0,18,49,18,0
"Machaerium","Fabaceae","Fabales",24,0,0,157,24,1
"Machairophyllum","Aizoaceae","Caryophyllales",0,0,0,10,0,NA
"Machaonia","Rubiaceae","Gentianales",2,0,0,31,2,1
"Machilus","Lauraceae","Laurales",18,0,0,93,18,1
"Mackaya","Acanthaceae","Lamiales",0,0,0,2,0,NA
"Mackinlaya","Apiaceae","Apiales",2,0,0,5,2,1
"Maclaudia","Apocynaceae","Gentianales",0,0,0,1,0,NA
"Macleania","Ericaceae","Ericales",3,0,0,37,3,1
"Macleaya","Papaveraceae","Ranunculales",0,0,1,2,1,0
"Macledium","Asteraceae","Asterales",0,0,1,20,1,0
"Maclura","Moraceae","Rosales",8,0,0,12,8,1
"Maclurochloa","Poaceae","Poales",0,0,0,1,0,NA
"Maclurodendron","Rutaceae","Sapindales",2,0,0,2,2,1
"Maclurolyra","Poaceae","Poales",0,0,0,1,0,NA
"Macodes","Orchidaceae","Asparagales",0,0,0,11,0,NA
"Macoubea","Apocynaceae","Gentianales",1,0,0,3,1,1
"Macowania","Asteraceae","Asterales",0,0,0,12,0,NA
"Macphersonia","Sapindaceae","Sapindales",0,0,0,6,0,NA
"Macrachaenium","Asteraceae","Asterales",0,0,0,1,0,NA
"Macradenia","Orchidaceae","Asparagales",0,0,0,11,0,NA
"Macraea","Asteraceae","Asterales",0,0,0,1,0,NA
"Macranthera","Orobanchaceae","Lamiales",0,0,0,2,0,NA
"Macrocarpaea","Gentianaceae","Gentianales",1,0,0,75,1,1
"Macrocaulon","Aizoaceae","Caryophyllales",0,0,0,1,0,NA
"Macrocentrum","Melastomataceae","Myrtales",1,0,1,24,2,0.5
"Macroclinium","Orchidaceae","Asparagales",0,0,1,42,1,0
"Macrocnemum","Rubiaceae","Gentianales",2,0,0,8,2,1
"Macrodiervilla","Caprifoliaceae","Dipsacales",0,0,0,1,0,NA
"Macroditassa","Apocynaceae","Gentianales",0,0,0,10,0,NA
"Macrohasseltia","Salicaceae","Malpighiales",1,0,0,1,1,1
"Macrolobium","Fabaceae","Fabales",11,0,0,76,11,1
"Macromeria","Boraginaceae","UnknownOrder-Boraginaceae",0,0,0,10,0,NA
"Macropanax","Araliaceae","Apiales",2,0,0,17,2,1
"Macropeplus","Monimiaceae","Laurales",1,0,0,4,1,1
"Macropharynx","Apocynaceae","Gentianales",0,0,0,5,0,NA
"Macropidia","Haemodoraceae","Commelinales",0,0,1,1,1,0
"Macropiper","Piperaceae","Piperales",0,0,0,1,0,NA
"Macropodanthus","Orchidaceae","Asparagales",0,0,1,8,1,0
"Macropodiella","Podostemaceae","Malpighiales",0,0,0,1,0,NA
"Macropodina","Asteraceae","Asterales",0,0,0,3,0,NA
"Macropodium","Brassicaceae","Brassicales",0,0,0,2,0,NA
"Macropsychanthus","Fabaceae","Fabales",0,0,0,3,0,NA
"Macroptilium","Fabaceae","Fabales",0,0,3,21,3,0
"Macrosamanea","Fabaceae","Fabales",0,0,0,11,0,NA
"Macroscepis","Apocynaceae","Gentianales",0,0,0,8,0,NA
"Macrosolen","Loranthaceae","Santalales",1,0,0,7,1,1
"Macrosphyra","Rubiaceae","Gentianales",1,0,0,3,1,1
"Macrostelia","Malvaceae","Malvales",1,0,0,1,1,1
"Macrostylis","Rutaceae","Sapindales",1,0,0,10,1,1
"Macrosyringion","Orobanchaceae","Lamiales",0,0,0,1,0,NA
"Macrothelypteris","Thelypteridaceae","Polypodiales",0,0,1,12,1,0
"Macrothumia","Salicaceae","Malpighiales",0,0,0,1,0,NA
"Macrotomia","Boraginaceae","UnknownOrder-Boraginaceae",0,0,0,1,0,NA
"Macrotorus","Monimiaceae","Laurales",0,0,0,1,0,NA
"Macrotyloma","Fabaceae","Fabales",0,0,0,25,0,NA
"Macrozamia","Zamiaceae","Cycadales",38,0,0,39,38,1
"Macuillamia","Plantaginaceae","Lamiales",0,0,0,1,0,NA
"Macvaughiella","Asteraceae","Asterales",0,0,0,2,0,NA
"Madagasikaria","Malpighiaceae","Malpighiales",0,0,0,1,0,NA
"Madagaster","Asteraceae","Asterales",0,0,0,5,0,NA
"Madaria","Asteraceae","Asterales",0,0,0,1,0,NA
"Maddenia","Rosaceae","Rosales",1,0,0,4,1,1
"Madhuca","Sapotaceae","Ericales",34,0,0,114,34,1
"Madia","Asteraceae","Asterales",0,0,2,12,2,0
"Madlabium","Lamiaceae","Lamiales",0,0,0,1,0,NA
"Maerua","Capparaceae","Brassicales",6,0,0,53,6,1
"Maesa","Primulaceae","Ericales",5,0,0,39,5,1
"Maesobotrya","Phyllanthaceae","Malpighiales",1,0,0,18,1,1
"Maesopsis","Rhamnaceae","Rosales",1,0,0,2,1,1
"Maeviella","Scrophulariaceae","Lamiales",0,0,0,1,0,NA
"Maferria","Podostemaceae","Malpighiales",0,0,0,1,0,NA
"Magdalenaea","Scrophulariaceae","Lamiales",0,0,0,1,0,NA
"Magnistipula","Chrysobalanaceae","Malpighiales",2,0,0,13,2,1
"Magnolia","Magnoliaceae","Magnoliales",113,0,0,242,113,1
"Magodendron","Sapotaceae","Ericales",0,0,0,2,0,NA
"Magonia","Sapindaceae","Sapindales",1,0,0,1,1,1
"Maguireanthus","Melastomataceae","Myrtales",0,0,0,1,0,NA
"Maguireocharis","Rubiaceae","Gentianales",0,0,0,1,0,NA
"Maguireothamnus","Rubiaceae","Gentianales",0,0,0,2,0,NA
"Magydaris","Apiaceae","Apiales",0,0,0,2,0,NA
"Maharanga","Boraginaceae","UnknownOrder-Boraginaceae",0,0,0,5,0,NA
"Mahonia","Berberidaceae","Ranunculales",4,0,0,45,4,1
"Mahurea","Calophyllaceae","Malpighiales",2,0,0,2,2,1
"Maianthemum","Asparagaceae","Asparagales",0,0,10,39,10,0
"Maieta","Melastomataceae","Myrtales",1,0,0,8,1,1
"Maihuenia","Cactaceae","Caryophyllales",2,0,0,2,2,1
"Maihueniopsis","Cactaceae","Caryophyllales",0,0,0,13,0,NA
"Maireana","Amaranthaceae","Caryophyllales",13,0,3,57,16,0.8125
"Mairia","Asteraceae","Asterales",0,0,1,3,1,0
"Majidea","Sapindaceae","Sapindales",0,0,0,4,0,NA
"Malabaila","Apiaceae","Apiales",0,0,0,4,0,NA
"Malaccotristicha","Podostemaceae","Malpighiales",0,0,0,1,0,NA
"Malache","Malvaceae","Malvales",0,0,0,1,0,NA
"Malachodendron","Theaceae","Ericales",0,0,0,1,0,NA
"Malachra","Malvaceae","Malvales",0,0,1,8,1,0
"Malacocarpus","Cactaceae","Caryophyllales",0,0,0,3,0,NA
"Malacocarpus","Zygophyllaceae",NA,1,0,0,1,1,1
"Malacocera","Amaranthaceae","Caryophyllales",0,0,1,4,1,0
"Malacomeles","Rosaceae","Rosales",1,0,0,3,1,1
"Malacothamnus","Malvaceae","Malvales",10,0,0,16,10,1
"Malacothrix","Asteraceae","Asterales",0,0,0,21,0,NA
"Malagasia","Proteaceae","Proteales",1,0,0,1,1,1
"Malanea","Rubiaceae","Gentianales",0,0,0,39,0,NA
"Malania","Olacaceae","Santalales",1,0,0,1,1,1
"Malapoenna","Lauraceae","Laurales",0,0,0,2,0,NA
"Malaxis","Orchidaceae","Asparagales",0,0,8,183,8,0
"Malcolmia","Brassicaceae","Brassicales",0,0,2,35,2,0
"Malephora","Aizoaceae","Caryophyllales",0,0,0,13,0,NA
"Malesherbia","Passifloraceae","Malpighiales",0,0,1,21,1,0
"Malleastrum","Meliaceae","Sapindales",3,0,0,21,3,1
"Malleola","Orchidaceae","Asparagales",0,0,1,34,1,0
"Malleostemon","Myrtaceae","Myrtales",4,0,0,6,4,1
"Mallophyton","Melastomataceae","Myrtales",0,0,0,1,0,NA
"Mallotus","Euphorbiaceae","Malpighiales",25,0,0,122,25,1
"Malmea","Annonaceae","Magnoliales",4,0,0,10,4,1
"Malmeanthus","Asteraceae","Asterales",0,0,0,3,0,NA
"Malope","Malvaceae","Malvales",0,0,1,2,1,0
"Malosma","Anacardiaceae","Sapindales",1,0,0,1,1,1
"Malouetia","Apocynaceae","Gentianales",6,0,0,33,6,1
"Malperia","Asteraceae","Asterales",0,0,0,1,0,NA
"Malpighia","Malpighiaceae","Malpighiales",10,0,0,127,10,1
"Malpighiodes","Malpighiaceae","Malpighiales",0,0,0,4,0,NA
"Maltebrunia","Poaceae","Poales",0,0,0,3,0,NA
"Malus","Rosaceae","Rosales",16,0,0,62,16,1
"Malva","Malvaceae","Malvales",0,0,7,29,7,0
"Malvalthaea","Malvaceae","Malvales",0,0,0,1,0,NA
"Malvastrum","Malvaceae","Malvales",0,0,2,27,2,0
"Malvaviscus","Malvaceae","Malvales",1,0,0,11,1,1
"Malvella","Malvaceae","Malvales",0,0,0,4,0,NA
"Mammea","Calophyllaceae","Malpighiales",5,0,0,17,5,1
"Mammillaria","Cactaceae","Caryophyllales",1,0,0,185,1,1
"Mammilloydia","Cactaceae","Caryophyllales",0,0,0,1,0,NA
"Managa","Celastraceae","Celastrales",0,0,0,1,0,NA
"Mananthes","Acanthaceae","Lamiales",0,0,0,2,0,NA
"Manaosella","Bignoniaceae","Lamiales",1,0,0,1,1,1
"Mancoa","Brassicaceae","Brassicales",0,0,1,9,1,0
"Mandenovia","Apiaceae","Apiales",0,0,0,1,0,NA
"Mandevilla","Apocynaceae","Gentianales",6,43,0,191,6,1
"Mandirola","Gesneriaceae","Lamiales",0,0,0,3,0,NA
"Mandragora","Solanaceae","Solanales",0,0,1,3,1,0
"Manekia","Piperaceae","Piperales",2,0,0,5,2,1
"Manettia","Rubiaceae","Gentianales",0,0,0,123,0,NA
"Manfreda","Asparagaceae","Asparagales",0,0,3,33,3,0
"Mangenotia","Apocynaceae","Gentianales",0,0,0,1,0,NA
"Mangifera","Anacardiaceae","Sapindales",5,0,0,10,5,1
"Mangonia","Araceae","Alismatales",0,0,1,2,1,0
"Manicaria","Arecaceae","Arecales",1,0,0,2,1,1
"Manihot","Euphorbiaceae","Malpighiales",7,0,0,108,7,1
"Manilkara","Sapotaceae","Ericales",47,0,0,81,47,1
"Maniltoa","Fabaceae","Fabales",5,0,0,21,5,1
"Manisuris","Poaceae","Poales",0,0,0,1,0,NA
"Mannagettaea","Orobanchaceae","Lamiales",0,0,0,2,0,NA
"Manniella","Orchidaceae","Asparagales",0,0,0,2,0,NA
"Manniophyton","Euphorbiaceae","Malpighiales",0,1,0,1,0,NA
"Manoao","Podocarpaceae","Araucariales",1,0,0,1,1,1
"Manochlamys","Amaranthaceae","Caryophyllales",1,0,0,1,1,1
"Manostachya","Rubiaceae","Gentianales",0,0,0,3,0,NA
"Manotes","Connaraceae","Oxalidales",3,0,0,7,3,1
"Manothrix","Apocynaceae","Gentianales",0,0,0,2,0,NA
"Mansoa","Bignoniaceae","Lamiales",7,0,0,12,7,1
"Mansonia","Malvaceae","Malvales",1,0,0,2,1,1
"Mantagnaea","Asteraceae","Asterales",0,0,0,1,0,NA
"Mantalania","Rubiaceae","Gentianales",0,0,0,3,0,NA
"Mantisalca","Asteraceae","Asterales",0,0,0,4,0,NA
"Manulea","Scrophulariaceae","Lamiales",0,0,8,49,8,0
"Manuleopsis","Scrophulariaceae","Lamiales",0,0,0,1,0,NA
"Manyonia","Asteraceae","Asterales",0,0,0,1,0,NA
"Maoutia","Urticaceae","Rosales",1,0,0,3,1,1
"Mapania","Cyperaceae","Poales",0,0,2,86,2,0
"Mapinguari","Orchidaceae","Asparagales",0,0,3,5,3,0
"Mapouria","Rubiaceae","Gentianales",0,0,0,1,0,NA
"Mappia","Icacinaceae","UnknownOrder-Icacinaceae",2,0,0,5,2,1
"Mappianthus","Icacinaceae","UnknownOrder-Icacinaceae",1,0,0,3,1,1
"Maprounea","Euphorbiaceae","Malpighiales",2,0,0,6,2,1
"Maquira","Moraceae","Rosales",4,0,0,4,4,1
"Marah","Cucurbitaceae","Cucurbitales",0,0,0,8,0,NA
"Marahuacaea","Rapateaceae","Poales",0,0,0,1,0,NA
"Maraniona","Fabaceae","Fabales",0,0,0,1,0,NA
"Maranta","Marantaceae","Zingiberales",0,0,4,42,4,0
"Maranthes","Chrysobalanaceae","Malpighiales",10,0,0,12,10,1
"Marantochloa","Marantaceae","Zingiberales",0,0,4,16,4,0
"Marantodes","Primulaceae","Ericales",0,0,0,1,0,NA
"Marasmodes","Asteraceae","Asterales",0,0,0,5,0,NA
"Marathrum","Podostemaceae","Malpighiales",0,0,2,22,2,0
"Marattia","Marattiaceae","Marattiales",0,0,6,9,6,0
"Marcelliopsis","Amaranthaceae","Caryophyllales",0,0,1,3,1,0
"Marcetia","Melastomataceae","Myrtales",0,0,0,28,0,NA
"Marcgravia","Marcgraviaceae","Ericales",14,0,0,62,14,1
"Marcgraviastrum","Marcgraviaceae","Ericales",2,0,0,11,2,1
"Maresia","Brassicaceae","Brassicales",0,0,0,3,0,NA
"Mareya","Euphorbiaceae","Malpighiales",1,0,0,4,1,1
"Mareyopsis","Euphorbiaceae","Malpighiales",1,0,0,2,1,1
"Margaranthus","Solanaceae","Solanales",0,0,0,2,0,NA
"Margaretta","Apocynaceae","Gentianales",0,0,0,1,0,NA
"Margaritaria","Phyllanthaceae","Malpighiales",8,0,0,13,8,1
"Margaritolobium","Fabaceae","Fabales",0,0,0,1,0,NA
"Margaritopsis","Rubiaceae","Gentianales",0,0,0,27,0,NA
"Margbensonia","Podocarpaceae","Araucariales",0,0,0,1,0,NA
"Margelliantha","Orchidaceae","Asparagales",0,0,0,6,0,NA
"Marginaria","Polypodiaceae","Polypodiales",0,0,0,17,0,NA
"Marginatocereus","Cactaceae","Caryophyllales",0,0,0,1,0,NA
"Margotia","Apiaceae","Apiales",0,0,0,1,0,NA
"Margyricarpus","Rosaceae","Rosales",1,0,0,1,1,1
"Marianthus","Pittosporaceae","Apiales",3,1,0,6,3,1
"Marila","Calophyllaceae","Malpighiales",4,0,0,13,4,1
"Marina","Fabaceae","Fabales",0,0,0,40,0,NA
"Mariosousa","Fabaceae","Fabales",3,0,0,13,3,1
"Maripa","Convolvulaceae","Solanales",5,0,0,20,5,1
"Mariscus","Cyperaceae","Poales",0,0,0,6,0,NA
"Markea","Solanaceae","Solanales",1,0,0,15,1,1
"Markhamia","Bignoniaceae","Lamiales",5,0,0,5,5,1
"Marlierea","Myrtaceae","Myrtales",6,0,0,92,6,1
"Marlothiella","Apiaceae","Apiales",0,0,0,1,0,NA
"Marmaroxylon","Fabaceae","Fabales",4,0,0,9,4,1
"Marmoritis","Lamiaceae","Lamiales",0,0,1,5,1,0
"Marojejya","Arecaceae","Arecales",1,0,0,2,1,1
"Marquesia","Dipterocarpaceae","Malvales",2,0,0,3,2,1
"Marrubium","Lamiaceae","Lamiales",0,0,7,49,7,0
"Marsdenia","Apocynaceae","Gentianales",3,0,1,151,4,0.75
"Marshallia","Asteraceae","Asterales",0,0,1,10,1,0
"Marshalljohnstonia","Asteraceae","Asterales",0,0,0,1,0,NA
"Marsilea","Marsileaceae","Salviniales",0,0,11,27,11,0
"Marsippospermum","Juncaceae","Poales",0,0,1,4,1,0
"Marsypianthes","Lamiaceae","Lamiales",0,0,1,6,1,0
"Marsypopetalum","Annonaceae","Magnoliales",1,0,0,1,1,1
"Martellidendron","Pandanaceae","Pandanales",0,0,0,6,0,NA
"Martensianthus","Rubiaceae","Gentianales",0,0,0,6,0,NA
"Marthella","Burmanniaceae","Dioscoreales",0,0,0,1,0,NA
"Marticorenia","Asteraceae","Asterales",0,0,0,1,0,NA
"Martinella","Bignoniaceae","Lamiales",2,0,0,2,2,1
"Martiodendron","Fabaceae","Fabales",2,0,0,5,2,1
"Martretia","Phyllanthaceae","Malpighiales",1,0,0,1,1,1
"Martynia","Martyniaceae","Lamiales",0,0,1,4,1,0
"Mascagnia","Malpighiaceae","Malpighiales",8,0,0,43,8,1
"Mascarenhasia","Apocynaceae","Gentianales",3,0,0,8,3,1
"Maschalocephalus","Rapateaceae","Poales",0,0,1,1,1,0
"Maschalodesme","Rubiaceae","Gentianales",0,0,0,2,0,NA
"Masdevallia","Orchidaceae","Asparagales",0,0,5,598,5,0
"Masoala","Arecaceae","Arecales",2,0,0,2,2,1
"Massonia","Asparagaceae","Asparagales",0,0,4,12,4,0
"Massularia","Rubiaceae","Gentianales",1,0,0,1,1,1
"Mastersia","Fabaceae","Fabales",0,0,0,2,0,NA
"Mastersiella","Restionaceae","Poales",0,0,1,3,1,0
"Mastigostyla","Iridaceae","Asparagales",0,0,2,27,2,0
"Mastixia","Cornaceae","Cornales",10,0,0,20,10,1
"Mastixiodendron","Rubiaceae","Gentianales",4,0,0,7,4,1
"Matayba","Sapindaceae","Sapindales",11,0,0,45,11,1
"Matelea","Apocynaceae","Gentianales",1,0,2,259,3,0.333333333333333
"Mathewsia","Brassicaceae","Brassicales",0,0,0,9,0,NA
"Mathieua","Amaryllidaceae","Asparagales",0,0,0,1,0,NA
"Matisia","Malvaceae","Malvales",4,0,0,26,4,1
"Matricaria","Asteraceae","Asterales",0,0,3,25,3,0
"Matsumurella","Lamiaceae","Lamiales",0,0,0,5,0,NA
"Matteuccia","Onocleaceae","Polypodiales",0,0,1,2,1,0
"Mattfeldanthus","Asteraceae","Asterales",0,0,0,2,0,NA
"Mattfeldia","Asteraceae","Asterales",0,0,0,1,0,NA
"Matthiola","Brassicaceae","Brassicales",0,0,4,50,4,0
"Mattiastrum","Boraginaceae","UnknownOrder-Boraginaceae",0,0,0,14,0,NA
"Matucana","Cactaceae","Caryophyllales",0,0,0,24,0,NA
"Matudaea","Hamamelidaceae","Saxifragales",1,0,0,2,1,1
"Matudanthus","Commelinaceae","Commelinales",0,0,0,1,0,NA
"Matudina","Asteraceae","Asterales",0,0,0,1,0,NA
"Maughania","Fabaceae","Fabales",0,0,0,13,0,NA
"Maughaniella","Aizoaceae","Caryophyllales",0,0,0,1,0,NA
"Mauloutchia","Myristicaceae","Magnoliales",1,0,0,5,1,1
"Maundia","Juncaginaceae","Alismatales",0,0,1,1,1,0
"Maurandya","Plantaginaceae","Lamiales",0,0,0,8,0,NA
"Mauranthemum","Asteraceae","Asterales",0,0,0,5,0,NA
"Mauria","Anacardiaceae","Sapindales",1,0,0,13,1,1
"Mauritia","Arecaceae","Arecales",2,0,0,2,2,1
"Mauritiella","Arecaceae","Arecales",3,0,0,4,3,1
"Maurocenia","Celastraceae","Celastrales",0,0,0,1,0,NA
"Mausolea","Asteraceae","Asterales",0,0,0,1,0,NA
"Maxburretia","Arecaceae","Arecales",0,0,0,3,0,NA
"Maxillaria","Orchidaceae","Asparagales",0,0,79,320,79,0
"Maxillariella","Orchidaceae","Asparagales",0,0,25,46,25,0
"Maxonia","Dryopteridaceae","Polypodiales",0,0,0,1,0,NA
"Mayaca","Mayacaceae","Poales",0,0,1,6,1,0
"Mayanaea","Violaceae","Malpighiales",0,0,0,1,0,NA
"Mayna","Achariaceae","Malpighiales",2,0,0,6,2,1
"Mayodendron","Bignoniaceae","Lamiales",1,0,0,1,1,1
"Maytenus","Celastraceae","Celastrales",26,0,0,160,26,1
"Mazaea","Rubiaceae","Gentianales",0,0,0,2,0,NA
"Mazus","Phrymaceae","Lamiales",0,0,2,27,2,0
"Mcvaughia","Malpighiaceae","Malpighiales",1,0,0,1,1,1
"Mecardonia","Plantaginaceae","Lamiales",0,0,2,10,2,0
"Mechowia","Amaranthaceae","Caryophyllales",0,0,0,1,0,NA
"Mecodium","Hymenophyllaceae","Hymenophyllales",0,0,0,10,0,NA
"Mecomischus","Asteraceae","Asterales",0,0,0,2,0,NA
"Meconella","Papaveraceae","Ranunculales",0,0,0,3,0,NA
"Meconopsis","Papaveraceae","Ranunculales",0,0,1,45,1,0
"Mecopus","Fabaceae","Fabales",0,0,0,1,0,NA
"Mecranium","Melastomataceae","Myrtales",3,0,0,23,3,1
"Medemia","Arecaceae","Arecales",1,0,0,1,1,1
"Medeola","Liliaceae","Liliales",0,0,1,1,1,0
"Mediasia","Apiaceae","Apiales",0,0,0,1,0,NA
"Medicago","Fabaceae","Fabales",1,0,22,103,23,0.0434782608695652
"Medicosma","Rutaceae","Sapindales",0,0,0,2,0,NA
"Medinilla","Melastomataceae","Myrtales",1,0,0,85,1,1
"Mediocalcar","Orchidaceae","Asparagales",0,0,0,17,0,NA
"Mediusella","Sarcolaenaceae","Malvales",0,0,0,1,0,NA
"Medranoa","Asteraceae","Asterales",0,0,0,1,0,NA
"Medusandra","Peridiscaceae","Saxifragales",1,0,0,2,1,1
"Medusanthera","Stemonuraceae","Aquifoliales",3,0,0,8,3,1
"Meeboldia","Apiaceae","Apiales",0,0,0,2,0,NA
"Meeboldina","Restionaceae","Poales",0,0,3,5,3,0
"Meehania","Lamiaceae","Lamiales",0,0,0,7,0,NA
"Megacarpaea","Brassicaceae","Brassicales",0,0,1,9,1,0
"Megacorax","Onagraceae","Myrtales",0,0,0,1,0,NA
"Megadenia","Brassicaceae","Brassicales",0,0,0,1,0,NA
"Megalachne","Poaceae","Poales",0,0,0,2,0,NA
"Megalastrum","Dryopteridaceae","Polypodiales",0,0,0,55,0,NA
"Megalochlamys","Acanthaceae","Lamiales",0,0,0,10,0,NA
"Megaloprotachne","Poaceae","Poales",0,0,0,1,0,NA
"Megalorchis","Orchidaceae","Asparagales",0,0,0,1,0,NA
"Megalostoma","Acanthaceae","Lamiales",0,0,0,1,0,NA
"Megalotus","Orchidaceae","Asparagales",0,0,0,1,0,NA
"Megaphrynium","Marantaceae","Zingiberales",0,0,2,5,2,0
"Megapterium","Onagraceae","Myrtales",0,0,0,3,0,NA
"Megarrhiza","Cucurbitaceae","Cucurbitales",0,0,1,1,1,0
"Megaskepasma","Acanthaceae","Lamiales",0,0,0,1,0,NA
"Megastachya","Poaceae","Poales",0,0,1,2,1,0
"Megastigma","Rutaceae","Sapindales",0,0,0,1,0,NA
"Megastylis","Orchidaceae","Asparagales",0,0,3,7,3,0
"Megatritheca","Malvaceae","Malvales",0,0,0,2,0,NA
"Megistostegium","Malvaceae","Malvales",2,0,0,3,2,1
"Megistostigma","Euphorbiaceae","Malpighiales",0,0,0,5,0,NA
"Meibomia","Fabaceae","Fabales",0,0,0,101,0,NA
"Meineckia","Phyllanthaceae","Malpighiales",2,1,0,30,2,1
"Meiocarpidium","Annonaceae","Magnoliales",1,0,0,1,1,1
"Meiogyne","Annonaceae","Magnoliales",2,0,0,12,2,1
"Meiostemon","Combretaceae","Myrtales",1,0,0,2,1,1
"Meiracyllium","Orchidaceae","Asparagales",0,0,2,2,2,0
"Meisneria","Melastomataceae","Myrtales",0,0,0,1,0,NA
"Meizotropis","Fabaceae","Fabales",0,0,0,2,0,NA
"Melaleuca","Myrtaceae","Myrtales",189,0,0,265,189,1
"Melampodium","Asteraceae","Asterales",0,1,0,45,0,NA
"Melampyrum","Orobanchaceae","Lamiales",0,0,4,13,4,0
"Melananthus","Solanaceae","Solanales",0,0,0,4,0,NA
"Melancium","Cucurbitaceae","Cucurbitales",0,0,0,1,0,NA
"Melandrium","Caryophyllaceae","Caryophyllales",0,0,0,6,0,NA
"Melanocenchris","Poaceae","Poales",0,0,1,3,1,0
"Melanolepis","Euphorbiaceae","Malpighiales",1,0,0,2,1,1
"Melanophylla","Torricelliaceae","Apiales",3,0,0,7,3,1
"Melanopsidium","Rubiaceae","Gentianales",0,0,0,1,0,NA
"Melanosciadium","Apiaceae","Apiales",0,0,0,3,0,NA
"Melanoselinum","Apiaceae","Apiales",0,0,0,1,0,NA
"Melanoseris","Asteraceae","Asterales",0,0,0,23,0,NA
"Melanospermum","Scrophulariaceae","Lamiales",0,0,0,1,0,NA
"Melanostachya","Restionaceae","Poales",0,0,1,1,1,0
"Melanoxylon","Fabaceae","Fabales",1,0,0,2,1,1
"Melanthera","Asteraceae","Asterales",0,0,2,38,2,0
"Melanthium","Melanthiaceae","Liliales",0,0,3,4,3,0
"Melasma","Orobanchaceae","Lamiales",0,0,1,8,1,0
"Melasphaerula","Iridaceae","Asparagales",0,0,1,1,1,0
"Melastoma","Melastomataceae","Myrtales",2,0,0,9,2,1
"Melastomastrum","Melastomataceae","Myrtales",0,0,0,4,0,NA
"Melhania","Malvaceae","Malvales",0,0,0,44,0,NA
"Melia","Meliaceae","Sapindales",2,0,0,2,2,1
"Melianthus","Melianthaceae","Geraniales",1,0,0,6,1,1
"Melica","Poaceae","Poales",0,0,13,92,13,0
"Melichrus","Ericaceae","Ericales",1,0,0,1,1,1
"Melicoccus","Sapindaceae","Sapindales",3,0,0,10,3,1
"Melicope","Rutaceae","Sapindales",14,0,0,98,14,1
"Melicytus","Violaceae","Malpighiales",2,0,0,6,2,1
"Melientha","Opiliaceae","Santalales",0,0,0,1,0,NA
"Melilotoides","Fabaceae","Fabales",0,0,0,2,0,NA
"Melilotus","Fabaceae","Fabales",0,0,5,22,5,0
"Melinia","Apocynaceae","Gentianales",0,0,0,3,0,NA
"Melinis","Poaceae","Poales",0,0,2,22,2,0
"Meliosma","Sabiaceae","UnknownOrder-Sabiaceae",24,0,0,90,24,1
"Melissa","Lamiaceae","Lamiales",0,0,2,4,2,0
"Melissitus","Fabaceae","Fabales",0,0,0,2,0,NA
"Melittacanthus","Acanthaceae","Lamiales",0,0,0,1,0,NA
"Melittis","Lamiaceae","Lamiales",0,0,1,1,1,0
"Mellera","Acanthaceae","Lamiales",0,0,0,5,0,NA
"Mellichampia","Apocynaceae","Gentianales",0,0,0,1,0,NA
"Melliniella","Fabaceae","Fabales",0,0,0,1,0,NA
"Melliodendron","Styracaceae","Ericales",1,0,0,1,1,1
"Melocactus","Cactaceae","Caryophyllales",0,0,0,35,0,NA
"Melocalamus","Poaceae","Poales",0,0,0,6,0,NA
"Melocanna","Poaceae","Poales",1,0,0,2,1,1
"Melochia","Malvaceae","Malvales",6,3,0,57,6,1
"Melodinus","Apocynaceae","Gentianales",2,0,0,21,2,1
"Melodorum","Annonaceae","Magnoliales",1,0,0,2,1,1
"Melolobium","Fabaceae","Fabales",2,0,0,27,2,1
"Melosperma","Plantaginaceae","Lamiales",1,0,0,1,1,1
"Melothria","Cucurbitaceae","Cucurbitales",0,0,1,14,1,0
"Melpomene","Polypodiaceae","Polypodiales",0,0,0,28,0,NA
"Memecylon","Melastomataceae","Myrtales",4,0,0,106,4,1
"Mendoncia","Acanthaceae","Lamiales",3,0,0,63,3,1
"Mendoravia","Fabaceae","Fabales",0,0,0,1,0,NA
"Meniscium","Thelypteridaceae","Polypodiales",0,0,0,1,0,NA
"Menispermum","Menispermaceae","Ranunculales",0,1,0,2,0,NA
"Menkea","Brassicaceae","Brassicales",0,0,0,6,0,NA
"Menodora","Oleaceae","Lamiales",2,0,2,24,4,0.5
"Menonvillea","Brassicaceae","Brassicales",0,0,1,23,1,0
"Mentha","Lamiaceae","Lamiales",0,0,10,42,10,0
"Mentzelia","Loasaceae","Cornales",2,1,22,88,24,0.0833333333333333
"Menyanthes","Menyanthaceae","Asterales",0,0,1,1,1,0
"Menziesia","Ericaceae","Ericales",2,0,0,2,2,1
"Merciera","Campanulaceae","Asterales",2,0,0,6,2,1
"Mercurialis","Euphorbiaceae","Malpighiales",0,0,3,14,3,0
"Merendera","Colchicaceae","Liliales",0,0,0,1,0,NA
"Meriandra","Lamiaceae","Lamiales",0,0,0,2,0,NA
"Meriania","Melastomataceae","Myrtales",5,0,0,78,5,1
"Merianthera","Melastomataceae","Myrtales",0,0,0,3,0,NA
"Mericarpaea","Rubiaceae","Gentianales",0,0,1,1,1,0
"Meringium","Hymenophyllaceae","Hymenophyllales",0,0,0,1,0,NA
"Merinthopodium","Solanaceae","Solanales",0,0,0,3,0,NA
"Meristotropis","Fabaceae","Fabales",0,0,0,3,0,NA
"Merope","Rutaceae","Sapindales",0,0,0,1,0,NA
"Merostachys","Poaceae","Poales",0,0,0,45,0,NA
"Merremia","Convolvulaceae","Solanales",1,1,5,62,6,0.166666666666667
"Merrillanthus","Apocynaceae","Gentianales",0,0,0,1,0,NA
"Merrillia","Rutaceae","Sapindales",1,0,0,1,1,1
"Merrilliodendron","Icacinaceae","UnknownOrder-Icacinaceae",0,0,0,1,0,NA
"Merrilliopanax","Araliaceae","Apiales",1,0,0,3,1,1
"Merrittia","Asteraceae","Asterales",0,0,0,1,0,NA
"Mertensia","Boraginaceae","UnknownOrder-Boraginaceae",0,0,1,40,1,0
"Merumea","Rubiaceae","Gentianales",0,0,0,2,0,NA
"Merwilla","Asparagaceae","Asparagales",0,0,1,3,1,0
"Merxmuellera","Poaceae","Poales",0,0,3,6,3,0
"Meryta","Araliaceae","Apiales",1,0,0,28,1,1
"Mesadenella","Orchidaceae","Asparagales",0,0,0,7,0,NA
"Mesadenus","Orchidaceae","Asparagales",0,0,0,7,0,NA
"Mesanthemum","Eriocaulaceae","Poales",0,0,1,15,1,0
"Mesanthophora","Asteraceae","Asterales",0,0,0,2,0,NA
"Mesaulosperma","Salicaceae","Malpighiales",0,0,0,1,0,NA
"Mesechites","Apocynaceae","Gentianales",4,0,0,8,4,1
"Mesembryanthemum","Aizoaceae","Caryophyllales",0,0,2,76,2,0
"Mesogramma","Asteraceae","Asterales",0,0,0,1,0,NA
"Mesogyne","Moraceae","Rosales",1,0,0,1,1,1
"Mesomelaena","Cyperaceae","Poales",0,0,2,5,2,0
"Mesoneuris","Asteraceae","Asterales",0,0,0,1,0,NA
"Mesoneuron","Thelypteridaceae","Polypodiales",0,0,0,1,0,NA
"Mesophlebion","Thelypteridaceae","Polypodiales",0,0,0,13,0,NA
"Mesopteris","Thelypteridaceae","Polypodiales",0,0,0,1,0,NA
"Mesosetum","Poaceae","Poales",0,0,1,26,1,0
"Mesostemma","Caryophyllaceae","Caryophyllales",0,0,0,5,0,NA
"Mesothema","Blechnaceae","Polypodiales",0,0,0,3,0,NA
"Mespilodaphne","Lauraceae","Laurales",0,0,0,1,0,NA
"Mespilus","Rosaceae","Rosales",1,0,0,3,1,1
"Mestoklema","Aizoaceae","Caryophyllales",0,0,0,2,0,NA
"Mesua","Calophyllaceae","Malpighiales",2,0,0,7,2,1
"Mesyniopsis","Linaceae","Malpighiales",0,0,0,1,0,NA
"Mesynium","Linaceae","Malpighiales",0,0,0,8,0,NA
"Metabolos","Rubiaceae","Gentianales",0,0,0,4,0,NA
"Metadina","Rubiaceae","Gentianales",1,0,0,1,1,1
"Metaeritrichium","Boraginaceae","UnknownOrder-Boraginaceae",0,0,0,1,0,NA
"Metagonia","Ericaceae","Ericales",0,0,0,4,0,NA
"Metalasia","Asteraceae","Asterales",1,0,0,52,1,1
"Metalepis","Apocynaceae","Gentianales",0,0,0,6,0,NA
"Metalonicera","Caprifoliaceae","Dipsacales",0,0,0,1,0,NA
"Metanarthecium","Nartheciaceae","Dioscoreales",0,0,0,1,0,NA
"Metanemone","Ranunculaceae","Ranunculales",0,0,0,1,0,NA
"Metapanax","Araliaceae","Apiales",2,0,0,2,2,1
"Metapetrocosmea","Gesneriaceae","Lamiales",0,0,0,1,0,NA
"Metaplexis","Apocynaceae","Gentianales",1,0,0,2,1,1
"Metapolypodium","Polypodiaceae","Polypodiales",0,0,0,1,0,NA
"Metaporana","Convolvulaceae","Solanales",0,1,0,5,0,NA
"Metarungia","Acanthaceae","Lamiales",0,0,0,3,0,NA
"Metasequoia","Cupressaceae","Cupressales",1,0,0,2,1,1
"Metastachydium","Lamiaceae","Lamiales",0,0,0,1,0,NA
"Metastelma","Apocynaceae","Gentianales",0,0,0,71,0,NA
"Metastevia","Asteraceae","Asterales",0,0,0,1,0,NA
"Metathelypteris","Thelypteridaceae","Polypodiales",0,0,0,14,0,NA
"Metaxya","Metaxyaceae","Cyatheales",0,0,0,1,0,NA
"Metcalfia","Poaceae","Poales",0,0,0,2,0,NA
"Meteoromyrtus","Myrtaceae","Myrtales",0,0,0,1,0,NA
"Meterostachys","Crassulaceae","Saxifragales",0,0,0,1,0,NA
"Metharme","Zygophyllaceae","Zygophyllales",0,0,0,1,0,NA
"Metopium","Anacardiaceae","Sapindales",2,0,0,3,2,1
"Metrodorea","Rutaceae","Sapindales",2,0,0,5,2,1
"Metrosideros","Myrtaceae","Myrtales",30,0,1,55,31,0.967741935483871
"Metroxylon","Arecaceae","Arecales",2,0,0,7,2,1
"Metteniusa","Metteniusaceae","UnknownOrder-Metteniusaceae",3,0,0,3,3,1
"Metternichia","Solanaceae","Solanales",0,0,0,1,0,NA
"Meum","Apiaceae","Apiales",0,0,1,1,1,0
"Mexacanthus","Acanthaceae","Lamiales",0,0,0,1,0,NA
"Mexerion","Asteraceae","Asterales",0,0,0,2,0,NA
"Mexianthus","Asteraceae","Asterales",0,0,0,1,0,NA
"Meximalva","Malvaceae","Malvales",0,0,0,2,0,NA
"Mexipedium","Orchidaceae","Asparagales",0,0,1,1,1,0
"Mexotis","Rubiaceae","Gentianales",0,0,0,4,0,NA
"Meyenia","Solanaceae","Solanales",0,0,0,1,0,NA
"Meyerophytum","Aizoaceae","Caryophyllales",0,0,0,1,0,NA
"Meyna","Rubiaceae","Gentianales",3,0,0,9,3,1
"Mezia","Malpighiaceae","Malpighiales",2,0,0,9,2,1
"Meziella","Haloragaceae","Saxifragales",0,0,0,1,0,NA
"Mezilaurus","Lauraceae","Laurales",8,0,0,21,8,1
"Mezobromelia","Bromeliaceae","Poales",0,0,1,8,1,0
"Mezoneurum","Fabaceae","Fabales",0,0,0,1,0,NA
"Mezonevron","Fabaceae","Fabales",0,0,0,2,0,NA
"Mezzettia","Annonaceae","Magnoliales",2,0,0,4,2,1
"Mezzettiopsis","Annonaceae","Magnoliales",0,0,0,1,0,NA
"Mibora","Poaceae","Poales",0,0,1,2,1,0
"Michauxia","Campanulaceae","Asterales",0,0,1,7,1,0
"Michelia","Magnoliaceae","Magnoliales",1,0,0,1,1,1
"Michelsonia","Fabaceae","Fabales",1,0,0,1,1,1
"Micholitzia","Apocynaceae","Gentianales",1,0,0,1,1,1
"Mickelia","Dryopteridaceae","Polypodiales",0,0,0,7,0,NA
"Miconia","Melastomataceae","Myrtales",81,0,0,881,81,1
"Micractis","Asteraceae","Asterales",0,0,0,3,0,NA
"Micraira","Poaceae","Poales",0,0,2,15,2,0
"Micrampelis","Cucurbitaceae","Cucurbitales",0,0,0,1,0,NA
"Micrandra","Euphorbiaceae","Malpighiales",7,0,0,12,7,1
"Micrandropsis","Euphorbiaceae","Malpighiales",1,0,0,1,1,1
"Micranthemum","Plantaginaceae","Lamiales",0,0,0,6,0,NA
"Micranthes","Saxifragaceae","Saxifragales",0,0,0,45,0,NA
"Micrantheum","Picrodendraceae","Malpighiales",3,0,0,4,3,1
"Micranthocereus","Cactaceae","Caryophyllales",0,0,0,10,0,NA
"Micranthus","Iridaceae","Asparagales",0,0,2,3,2,0
"Micrargeria","Orobanchaceae","Lamiales",0,0,0,2,0,NA
"Micrargeriella","Orobanchaceae","Lamiales",0,0,0,1,0,NA
"Micrasepalum","Rubiaceae","Gentianales",0,0,0,2,0,NA
"Micrechites","Apocynaceae","Gentianales",0,0,0,12,0,NA
"Microbahia","Asteraceae","Asterales",0,0,0,1,0,NA
"Microberlinia","Fabaceae","Fabales",2,0,0,2,2,1
"Microbiota","Cupressaceae","Cupressales",1,0,0,1,1,1
"Microbriza","Poaceae","Poales",0,0,0,1,0,NA
"Microbrochis","Tectariaceae","Polypodiales",0,0,0,1,0,NA
"Microcachrys","Podocarpaceae","Araucariales",0,0,0,1,0,NA
"Microcalamus","Poaceae","Poales",0,0,0,1,0,NA
"Microcarpaea","Plantaginaceae","Lamiales",0,0,0,1,0,NA
"Microcaryum","Boraginaceae","UnknownOrder-Boraginaceae",0,0,0,1,0,NA
"Microcephala","Asteraceae","Asterales",0,0,0,5,0,NA
"Microchaeta","Asteraceae","Asterales",0,0,0,1,0,NA
"Microcharis","Fabaceae","Fabales",1,0,0,35,1,1
"Microchilus","Orchidaceae","Asparagales",0,0,0,137,0,NA
"Microchirita","Gesneriaceae","Lamiales",0,0,0,18,0,NA
"Microchloa","Poaceae","Poales",0,0,0,6,0,NA
"Microcnemum","Amaranthaceae","Caryophyllales",0,0,1,1,1,0
"Micrococca","Euphorbiaceae","Malpighiales",1,0,0,12,1,1
"Microcodon","Campanulaceae","Asterales",0,0,1,5,1,0
"Microcoelia","Orchidaceae","Asparagales",0,0,12,30,12,0
"Microcorys","Lamiaceae","Lamiales",0,0,0,21,0,NA
"Microcos","Malvaceae","Malvales",6,0,0,13,6,1
"Microcycas","Zamiaceae","Cycadales",1,0,0,1,1,1
"Microdactylon","Apocynaceae","Gentianales",0,0,0,1,0,NA
"Microdesmis","Pandaceae","Malpighiales",5,0,0,11,5,1
"Microdon","Scrophulariaceae","Lamiales",0,0,2,6,2,0
"Microdracoides","Cyperaceae","Poales",0,0,0,1,0,NA
"Microepidendrum","Orchidaceae","Asparagales",0,0,1,1,1,0
"Microgilia","Polemoniaceae","Ericales",0,0,0,1,0,NA
"Microglossa","Asteraceae","Asterales",1,0,0,8,1,1
"Microgonium","Hymenophyllaceae","Hymenophyllales",0,0,0,3,0,NA
"Microgramma","Polypodiaceae","Polypodiales",0,0,5,30,5,0
"Microgyne","Asteraceae","Asterales",0,0,0,2,0,NA
"Microgynoecium","Amaranthaceae","Caryophyllales",0,0,1,1,1,0
"Microlagenaria","Cucurbitaceae","Cucurbitales",0,0,0,1,0,NA
"Microlecane","Asteraceae","Asterales",0,0,0,1,0,NA
"Microlepia","Dennstaedtiaceae","Polypodiales",0,0,3,82,3,0
"Microlepidium","Brassicaceae","Brassicales",0,0,0,2,0,NA
"Microlepis","Melastomataceae","Myrtales",0,0,0,2,0,NA
"Microliabum","Asteraceae","Asterales",0,0,0,5,0,NA
"Microlicia","Melastomataceae","Myrtales",1,0,0,106,1,1
"Microlobius","Fabaceae","Fabales",1,0,0,1,1,1
"Microloma","Apocynaceae","Gentianales",0,0,1,13,1,0
"Micromelum","Rutaceae","Sapindales",0,0,0,2,0,NA
"Micromeria","Lamiaceae","Lamiales",9,0,0,77,9,1
"Micromonolepis","Amaranthaceae","Caryophyllales",0,0,0,1,0,NA
"Micromyrtus","Myrtaceae","Myrtales",6,0,0,50,6,1
"Micronychia","Anacardiaceae","Sapindales",0,0,0,6,0,NA
"Microparacaryum","Boraginaceae","UnknownOrder-Boraginaceae",0,0,0,1,0,NA
"Micropera","Orchidaceae","Asparagales",0,0,1,21,1,0
"Micropetalon","Caryophyllaceae","Caryophyllales",0,0,0,1,0,NA
"Micropholis","Sapotaceae","Ericales",35,0,0,38,35,1
"Microphyes","Caryophyllaceae","Caryophyllales",0,0,0,3,0,NA
"Microphysa","Rubiaceae","Gentianales",0,0,0,1,0,NA
"Micropleura","Apiaceae","Apiales",0,0,1,2,1,0
"Microplumeria","Apocynaceae","Gentianales",1,0,0,1,1,1
"Micropodium","Aspleniaceae","Polypodiales",0,0,0,1,0,NA
"Micropolypodium","Polypodiaceae","Polypodiales",0,0,0,25,0,NA
"Micropsis","Asteraceae","Asterales",0,0,0,5,0,NA
"Micropterum","Aizoaceae","Caryophyllales",0,0,0,1,0,NA
"Micropus","Asteraceae","Asterales",0,0,0,4,0,NA
"Micropyropsis","Poaceae","Poales",0,0,0,1,0,NA
"Micropyrum","Poaceae","Poales",0,0,1,2,1,0
"Microsaccus","Orchidaceae","Asparagales",0,0,1,12,1,0
"Microsechium","Cucurbitaceae","Cucurbitales",0,0,0,2,0,NA
"Microseris","Asteraceae","Asterales",0,0,4,42,4,0
"Microsorum","Polypodiaceae","Polypodiales",0,0,0,36,0,NA
"Microspermum","Asteraceae","Asterales",0,0,0,10,0,NA
"Microstachys","Euphorbiaceae","Malpighiales",0,1,0,18,0,NA
"Microstaphyla","Dryopteridaceae","Polypodiales",0,0,0,1,0,NA
"Microstegium","Poaceae","Poales",0,0,3,24,3,0
"Microsteira","Malpighiaceae","Malpighiales",0,0,0,10,0,NA
"Microsteris","Polemoniaceae","Ericales",0,0,0,2,0,NA
"Microstigma","Brassicaceae","Brassicales",0,0,0,3,0,NA
"Microstrobilus","Acanthaceae","Lamiales",0,0,0,1,0,NA
"Microtatorchis","Orchidaceae","Asparagales",0,0,0,51,0,NA
"Microtea","Phytolaccaceae","Caryophyllales",0,0,0,9,0,NA
"Microterangis","Orchidaceae","Asparagales",0,0,2,7,2,0
"Microterus","Polypodiaceae","Polypodiales",0,0,0,1,0,NA
"Microthelys","Orchidaceae","Asparagales",0,0,0,7,0,NA
"Microthlaspi","Brassicaceae","Brassicales",0,0,0,3,0,NA
"Microtis","Orchidaceae","Asparagales",0,0,1,19,1,0
"Microtoena","Lamiaceae","Lamiales",0,0,2,25,2,0
"Microtropis","Celastraceae","Celastrales",0,0,0,34,0,NA
"Microula","Boraginaceae","UnknownOrder-Boraginaceae",0,0,1,29,1,0
"Miersia","Amaryllidaceae","Asparagales",0,0,0,5,0,NA
"Miersiella","Burmanniaceae","Dioscoreales",0,0,0,1,0,NA
"Mikania","Asteraceae","Asterales",7,0,1,433,8,0.875
"Mikaniopsis","Asteraceae","Asterales",0,0,0,15,0,NA
"Mila","Cactaceae","Caryophyllales",0,0,0,3,0,NA
"Mildbraediodendron","Fabaceae","Fabales",1,0,0,1,1,1
"Mildella","Pteridaceae","Polypodiales",0,0,0,3,0,NA
"Milicia","Moraceae","Rosales",2,0,0,2,2,1
"Milium","Poaceae","Poales",0,0,2,5,2,0
"Miliusa","Annonaceae","Magnoliales",3,0,0,14,3,1
"Milla","Asparagaceae","Asparagales",0,0,0,10,0,NA
"Milleria","Asteraceae","Asterales",0,0,1,2,1,0
"Millettia","Fabaceae","Fabales",16,0,0,202,16,1
"Milligania","Asteliaceae","Asparagales",0,0,3,5,3,0
"Millina","Asteraceae","Asterales",0,0,0,1,0,NA
"Millingtonia","Bignoniaceae","Lamiales",1,0,0,1,1,1
"Millotia","Asteraceae","Asterales",0,0,2,16,2,0
"Millspaughia","Polygonaceae","Caryophyllales",0,0,0,1,0,NA
"Miltitzia","Boraginaceae","UnknownOrder-Boraginaceae",0,0,0,7,0,NA
"Miltonia","Orchidaceae","Asparagales",0,0,3,19,3,0
"Miltonidium","Orchidaceae","Asparagales",0,0,0,1,0,NA
"Miltoniopsis","Orchidaceae","Asparagales",0,0,2,5,2,0
"Mimetanthe","Scrophulariaceae","Lamiales",0,0,0,1,0,NA
"Mimetes","Proteaceae","Proteales",4,0,0,13,4,1
"Mimophytum","Boraginaceae","UnknownOrder-Boraginaceae",0,0,0,1,0,NA
"Mimosa","Fabaceae","Fabales",17,0,1,708,18,0.944444444444444
"Mimosopsis","Fabaceae","Fabales",0,0,0,8,0,NA
"Mimozyganthus","Fabaceae","Fabales",1,0,0,1,1,1
"Mimulicalyx","Scrophulariaceae","Lamiales",0,0,0,2,0,NA
"Mimulopsis","Acanthaceae","Lamiales",0,0,0,14,0,NA
"Mimulus","Phrymaceae","Lamiales",1,0,2,155,3,0.333333333333333
"Mimusops","Sapotaceae","Ericales",16,0,0,45,16,1
"Minaria","Apocynaceae","Gentianales",0,0,0,19,0,NA
"Minasia","Asteraceae","Asterales",0,0,1,6,1,0
"Minquartia","Olacaceae","Santalales",1,0,0,1,1,1
"Minthostachys","Lamiaceae","Lamiales",0,0,0,17,0,NA
"Minuartia","Caryophyllaceae","Caryophyllales",0,0,2,108,2,0
"Minuria","Asteraceae","Asterales",0,0,1,11,1,0
"Mionandra","Malpighiaceae","Malpighiales",1,0,0,1,1,1
"Miquelia","Icacinaceae","UnknownOrder-Icacinaceae",0,0,3,7,3,0
"Miqueliopuntia","Cactaceae","Caryophyllales",0,0,0,1,0,NA
"Mirabilis","Nyctaginaceae","Caryophyllales",0,0,4,63,4,0
"Miraglossum","Apocynaceae","Gentianales",0,0,0,7,0,NA
"Mirandea","Acanthaceae","Lamiales",0,0,0,6,0,NA
"Mirbelia","Fabaceae","Fabales",2,0,0,26,2,1
"Miricacalia","Asteraceae","Asterales",0,0,0,1,0,NA
"Misanteca","Lauraceae","Laurales",3,0,0,34,3,1
"Misbrookea","Asteraceae","Asterales",0,0,0,1,0,NA
"Miscanthus","Poaceae","Poales",0,0,5,16,5,0
"Mischarytera","Sapindaceae","Sapindales",2,0,0,3,2,1
"Mischocarpus","Sapindaceae","Sapindales",3,0,0,4,3,1
"Mischodon","Picrodendraceae","Malpighiales",0,0,0,1,0,NA
"Mischogyne","Annonaceae","Magnoliales",0,0,0,2,0,NA
"Misodendrum","Misodendraceae","Santalales",0,0,0,8,0,NA
"Misopates","Plantaginaceae","Lamiales",0,0,1,3,1,0
"Mitchella","Rubiaceae","Gentianales",0,0,2,2,2,0
"Mitella","Saxifragaceae","Saxifragales",0,0,6,11,6,0
"Mitostemma","Passifloraceae","Malpighiales",0,0,0,3,0,NA
"Mitostigma","Apocynaceae","Gentianales",0,0,0,1,0,NA
"Mitracarpus","Rubiaceae","Gentianales",0,0,1,64,1,0
"Mitragyna","Rubiaceae","Gentianales",5,0,0,7,5,1
"Mitranthes","Myrtaceae","Myrtales",0,0,0,8,0,NA
"Mitrantia","Myrtaceae","Myrtales",0,0,0,1,0,NA
"Mitraria","Gesneriaceae","Lamiales",1,0,0,3,1,1
"Mitrasacme","Loganiaceae","Gentianales",0,0,0,3,0,NA
"Mitrasacmopsis","Rubiaceae","Gentianales",0,0,0,1,0,NA
"Mitrastemon","Mitrastemonaceae","Ericales",0,0,1,2,1,0
"Mitrella","Annonaceae","Magnoliales",1,0,0,4,1,1
"Mitreola","Loganiaceae","Gentianales",0,0,2,7,2,0
"Mitrephora","Annonaceae","Magnoliales",1,0,0,19,1,1
"Mitriostigma","Rubiaceae","Gentianales",1,0,0,5,1,1
"Mitrophyllum","Aizoaceae","Caryophyllales",0,0,0,8,0,NA
"Miyakea","Ranunculaceae","Ranunculales",0,0,0,1,0,NA
"Miyamayomena","Asteraceae","Asterales",0,0,0,6,0,NA
"Mkilua","Annonaceae","Magnoliales",1,0,0,1,1,1
"Mnesithea","Poaceae","Poales",0,0,0,2,0,NA
"Mniarum","Caryophyllaceae","Caryophyllales",0,0,0,1,0,NA
"Mniochloa","Poaceae","Poales",0,0,0,1,0,NA
"Mniodes","Asteraceae","Asterales",0,0,0,4,0,NA
"Mobilabium","Orchidaceae","Asparagales",0,0,0,1,0,NA
"Mocinnodaphne","Lauraceae","Laurales",0,0,0,1,0,NA
"Mocquerysia","Achariaceae","Malpighiales",0,0,0,1,0,NA
"Modiola","Malvaceae","Malvales",0,0,1,1,1,0
"Modiolastrum","Malvaceae","Malvales",0,0,0,5,0,NA
"Moehringia","Caryophyllaceae","Caryophyllales",0,0,3,30,3,0
"Moenchia","Caryophyllaceae","Caryophyllales",0,0,1,3,1,0
"Mohavea","Plantaginaceae","Lamiales",0,0,1,2,1,0
"Mohria","Anemiaceae","Schizaeales",0,0,0,3,0,NA
"Moldenhawera","Fabaceae","Fabales",1,0,0,13,1,1
"Molinadendron","Hamamelidaceae","Saxifragales",3,0,0,3,3,1
"Molinaea","Sapindaceae","Sapindales",0,0,0,6,0,NA
"Molineria","Hypoxidaceae","Asparagales",0,0,2,7,2,0
"Molinia","Poaceae","Poales",0,0,2,2,2,0
"Mollia","Malvaceae","Malvales",3,0,0,17,3,1
"Mollinedia","Monimiaceae","Laurales",9,0,0,55,9,1
"Mollugo","Molluginaceae","Caryophyllales",0,0,3,18,3,0
"Molongum","Apocynaceae","Gentianales",1,0,0,3,1,1
"Molopanthera","Rubiaceae","Gentianales",0,0,0,1,0,NA
"Molopospermum","Apiaceae","Apiales",0,0,0,1,0,NA
"Moltkia","Boraginaceae","UnknownOrder-Boraginaceae",0,0,0,2,0,NA
"Moltkiopsis","Boraginaceae","UnknownOrder-Boraginaceae",0,0,0,1,0,NA
"Moluccella","Lamiaceae","Lamiales",0,0,1,8,1,0
"Momordica","Cucurbitaceae","Cucurbitales",0,0,3,36,3,0
"Mona","Portulacaceae","Caryophyllales",0,0,0,1,0,NA
"Monachather","Poaceae","Poales",0,0,1,1,1,0
"Monachosorum","Dennstaedtiaceae","Polypodiales",0,0,0,5,0,NA
"Monactis","Asteraceae","Asterales",1,0,0,6,1,1
"Monanthes","Crassulaceae","Saxifragales",0,0,0,12,0,NA
"Monanthochloe","Poaceae","Poales",0,0,1,2,1,0
"Monanthocitrus","Rutaceae","Sapindales",0,0,0,1,0,NA
"Monanthotaxis","Annonaceae","Magnoliales",10,0,0,53,10,1
"Monarda","Lamiaceae","Lamiales",0,0,6,22,6,0
"Monardella","Lamiaceae","Lamiales",0,0,6,35,6,0
"Monarrhenus","Asteraceae","Asterales",0,0,0,1,0,NA
"Mondia","Apocynaceae","Gentianales",0,1,0,2,0,NA
"Monechma","Acanthaceae","Lamiales",1,0,0,33,1,1
"Monelasmum","Ochnaceae","Malpighiales",0,0,0,1,0,NA
"Monelytrum","Poaceae","Poales",0,0,0,1,0,NA
"Monencyanthes","Asteraceae","Asterales",0,0,0,1,0,NA
"Moneses","Ericaceae","Ericales",1,0,0,1,1,1
"Monilaria","Aizoaceae","Caryophyllales",0,0,0,6,0,NA
"Monimopetalum","Celastraceae","Celastrales",0,0,0,1,0,NA
"Monizia","Apiaceae","Apiales",0,0,0,1,0,NA
"Monnina","Polygalaceae","Fabales",1,0,0,148,1,1
"Monocarpia","Annonaceae","Magnoliales",1,0,0,3,1,1
"Monochaetum","Melastomataceae","Myrtales",6,0,0,46,6,1
"Monochasma","Orobanchaceae","Lamiales",0,0,1,2,1,0
"Monochilus","Lamiaceae","Lamiales",0,0,0,2,0,NA
"Monochlaena","Dryopteridaceae","Polypodiales",0,0,0,1,0,NA
"Monochoria","Pontederiaceae","Commelinales",0,0,5,7,5,0
"Monocostus","Costaceae","Zingiberales",0,0,1,1,1,0
"Monoculus","Asteraceae","Asterales",0,0,1,2,1,0
"Monocyclanthus","Annonaceae","Magnoliales",0,0,0,1,0,NA
"Monocymbium","Poaceae","Poales",0,0,0,3,0,NA
"Monodia","Poaceae","Poales",0,0,1,1,1,0
"Monodora","Annonaceae","Magnoliales",5,0,0,12,5,1
"Monogereion","Asteraceae","Asterales",0,0,0,1,0,NA
"Monogonia","Thelypteridaceae","Polypodiales",0,0,0,1,0,NA
"Monogramma","Pteridaceae","Polypodiales",0,0,0,7,0,NA
"Monogynella","Convolvulaceae","Solanales",0,0,0,5,0,NA
"Monolena","Melastomataceae","Myrtales",0,1,0,8,0,NA
"Monolepis","Amaranthaceae","Caryophyllales",0,0,1,2,1,0
"Monolluma","Apocynaceae","Gentianales",0,0,0,1,0,NA
"Monolopia","Asteraceae","Asterales",0,0,2,5,2,0
"Monomelangium","Athyriaceae","Polypodiales",0,0,0,2,0,NA
"Monomeria","Orchidaceae","Asparagales",0,0,0,3,0,NA
"Monopera","Plantaginaceae","Lamiales",0,0,0,2,0,NA
"Monopetalanthus","Fabaceae","Fabales",2,0,0,2,2,1
"Monopholis","Asteraceae","Asterales",0,0,0,1,0,NA
"Monophyllaea","Gesneriaceae","Lamiales",0,0,0,1,0,NA
"Monophyllanthe","Marantaceae","Zingiberales",0,0,0,2,0,NA
"Monophyllorchis","Orchidaceae","Asparagales",0,0,0,1,0,NA
"Monoporus","Primulaceae","Ericales",0,0,0,6,0,NA
"Monopsis","Campanulaceae","Asterales",0,0,2,16,2,0
"Monopteryx","Fabaceae","Fabales",1,0,0,3,1,1
"Monoptilon","Asteraceae","Asterales",0,0,0,2,0,NA
"Monopyle","Gesneriaceae","Lamiales",0,0,2,17,2,0
"Monosalpinx","Rubiaceae","Gentianales",0,0,0,1,0,NA
"Monosis","Asteraceae","Asterales",0,0,0,7,0,NA
"Monostylis","Podostemaceae","Malpighiales",0,0,0,1,0,NA
"Monotagma","Marantaceae","Zingiberales",0,0,5,39,5,0
"Monotaxis","Euphorbiaceae","Malpighiales",2,0,0,8,2,1
"Monotes","Dipterocarpaceae","Malvales",3,0,0,26,3,1
"Monothecium","Acanthaceae","Lamiales",0,0,0,3,0,NA
"Monotrema","Rapateaceae","Poales",0,0,0,5,0,NA
"Monotropa","Ericaceae","Ericales",0,0,1,2,1,0
"Monotropastrum","Ericaceae","Ericales",0,0,0,2,0,NA
"Monotropsis","Ericaceae","Ericales",0,0,0,3,0,NA
"Monsonia","Geraniaceae","Geraniales",0,0,2,24,2,0
"Monstera","Araceae","Alismatales",0,0,1,45,1,0
"Montanoa","Asteraceae","Asterales",1,0,0,50,1,1
"Monteiroa","Malvaceae","Malvales",0,0,0,10,0,NA
"Montia","Montiaceae","Caryophyllales",0,0,3,13,3,0
"Montiastrum","Montiaceae","Caryophyllales",0,0,0,1,0,NA
"Monticalia","Asteraceae","Asterales",0,0,0,11,0,NA
"Montinia","Montiniaceae","Solanales",1,0,0,1,1,1
"Montiopsis","Montiaceae","Caryophyllales",0,0,5,18,5,0
"Montrichardia","Araceae","Alismatales",0,0,1,2,1,0
"Monttea","Plantaginaceae","Lamiales",0,0,0,2,0,NA
"Monvillea","Cactaceae","Caryophyllales",0,0,0,9,0,NA
"Moonia","Asteraceae","Asterales",0,0,0,6,0,NA
"Moquinia","Asteraceae","Asterales",0,0,0,2,0,NA
"Moquiniella","Loranthaceae","Santalales",1,0,0,1,1,1
"Mora","Fabaceae","Fabales",4,0,0,7,4,1
"Moraea","Iridaceae","Asparagales",0,0,148,204,148,0
"Moranopteris","Polypodiaceae","Polypodiales",0,0,0,27,0,NA
"Morelia","Rubiaceae","Gentianales",1,0,0,1,1,1
"Morella","Myricaceae","Fagales",9,0,0,30,9,1
"Morelosia","Boraginaceae","UnknownOrder-Boraginaceae",0,0,0,5,0,NA
"Morelotia","Cyperaceae","Poales",0,0,0,2,0,NA
"Morettia","Brassicaceae","Brassicales",0,0,0,3,0,NA
"Moricandia","Brassicaceae","Brassicales",0,0,1,8,1,0
"Moriera","Brassicaceae","Brassicales",0,0,1,1,1,0
"Morierina","Rubiaceae","Gentianales",0,0,0,2,0,NA
"Morina","Caprifoliaceae","Dipsacales",0,0,2,12,2,0
"Morinda","Rubiaceae","Gentianales",6,0,0,112,6,1
"Morindopsis","Rubiaceae","Gentianales",0,0,0,1,0,NA
"Moringa","Moringaceae","Brassicales",8,0,0,13,8,1
"Morisia","Brassicaceae","Brassicales",0,0,0,1,0,NA
"Morisonia","Capparaceae","Brassicales",2,0,0,2,2,1
"Morithamnus","Asteraceae","Asterales",0,0,0,2,0,NA
"Moritzia","Boraginaceae","UnknownOrder-Boraginaceae",0,0,0,4,0,NA
"Morkillia","Zygophyllaceae","Zygophyllales",0,0,0,2,0,NA
"Mormodes","Orchidaceae","Asparagales",0,0,1,83,1,0
"Mormolyca","Orchidaceae","Asparagales",0,0,13,26,13,0
"Moronobea","Clusiaceae","Malpighiales",1,0,0,7,1,1
"Morrenia","Apocynaceae","Gentianales",0,0,0,9,0,NA
"Mortonia","Celastraceae","Celastrales",1,0,0,8,1,1
"Mortoniella","Apocynaceae","Gentianales",0,0,0,1,0,NA
"Mortoniodendron","Malvaceae","Malvales",1,0,0,15,1,1
"Mortoniopteris","Hymenophyllaceae","Hymenophyllales",0,0,0,1,0,NA
"Morus","Moraceae","Rosales",9,0,0,17,9,1
"Mosannona","Annonaceae","Magnoliales",5,0,0,13,5,1
"Moscharia","Asteraceae","Asterales",0,0,0,2,0,NA
"Moschopsis","Calyceraceae","Asterales",0,0,1,5,1,0
"Mosdenia","Poaceae","Poales",0,0,0,1,0,NA
"Mosiera","Myrtaceae","Myrtales",1,0,0,33,1,1
"Mosla","Lamiaceae","Lamiales",0,0,4,15,4,0
"Mosquitoxylum","Anacardiaceae","Sapindales",1,0,0,1,1,1
"Mossia","Aizoaceae","Caryophyllales",0,0,0,1,0,NA
"Mostacillastrum","Brassicaceae","Brassicales",0,0,1,19,1,0
"Mostuea","Gelsemiaceae","Gentianales",1,0,0,9,1,1
"Motandra","Apocynaceae","Gentianales",1,0,0,3,1,1
"Motherwellia","Araliaceae","Apiales",0,0,0,1,0,NA
"Motleyia","Rubiaceae","Gentianales",0,0,0,1,0,NA
"Moulinsia","Poaceae","Poales",0,0,0,1,0,NA
"Moullava","Fabaceae","Fabales",0,0,0,1,0,NA
"Moultonianthus","Euphorbiaceae","Malpighiales",1,0,0,1,1,1
"Mourera","Podostemaceae","Malpighiales",0,0,1,7,1,0
"Mouretia","Rubiaceae","Gentianales",0,0,0,4,0,NA
"Mouriri","Melastomataceae","Myrtales",25,0,0,82,25,1
"Moussonia","Gesneriaceae","Lamiales",3,0,0,14,3,1
"Moutabea","Polygalaceae","Fabales",1,0,0,7,1,1
"Moutouchi","Fabaceae","Fabales",0,0,0,1,0,NA
"Msuata","Asteraceae","Asterales",0,0,0,1,0,NA
"Mtonia","Asteraceae","Asterales",0,0,0,1,0,NA
"Mucoa","Apocynaceae","Gentianales",0,0,0,2,0,NA
"Mucronea","Polygonaceae","Caryophyllales",0,0,0,2,0,NA
"Mucuna","Fabaceae","Fabales",7,1,0,82,7,1
"Muehlbergella","Campanulaceae","Asterales",0,0,0,1,0,NA
"Muehlenbeckia","Polygonaceae","Caryophyllales",0,0,2,12,2,0
"Muellera","Fabaceae","Fabales",0,0,0,3,0,NA
"Muelleranthus","Fabaceae","Fabales",0,0,0,3,0,NA
"Muellerargia","Cucurbitaceae","Cucurbitales",0,0,0,1,0,NA
"Muellerina","Loranthaceae","Santalales",0,0,0,1,0,NA
"Muellerolimon","Plumbaginaceae","Caryophyllales",0,0,0,1,0,NA
"Muhlenbergia","Poaceae","Poales",0,0,21,162,21,0
"Muilla","Asparagaceae","Asparagales",0,0,1,3,1,0
"Muiria","Aizoaceae","Caryophyllales",0,0,0,1,0,NA
"Muiriantha","Rutaceae","Sapindales",0,0,0,1,0,NA
"Mukdenia","Saxifragaceae","Saxifragales",0,0,0,1,0,NA
"Mukia","Cucurbitaceae","Cucurbitales",0,0,1,1,1,0
"Mulgedium","Asteraceae","Asterales",0,0,0,7,0,NA
"Mulguraea","Verbenaceae","Lamiales",0,0,0,11,0,NA
"Mulinum","Apiaceae","Apiales",0,0,1,13,1,0
"Multidentia","Rubiaceae","Gentianales",1,0,0,9,1,1
"Mundulea","Fabaceae","Fabales",1,0,0,13,1,1
"Munnozia","Asteraceae","Asterales",0,0,1,42,1,0
"Munroa","Poaceae","Poales",0,0,0,5,0,NA
"Munronia","Meliaceae","Sapindales",1,0,0,3,1,1
"Muntingia","Muntingiaceae","Malvales",1,0,0,1,1,1
"Munzothamnus","Asteraceae","Asterales",1,0,0,1,1,1
"Muraltia","Polygalaceae","Fabales",0,0,0,114,0,NA
"Murbeckiella","Brassicaceae","Brassicales",0,0,0,5,0,NA
"Murchisonia","Asparagaceae","Asparagales",0,0,1,2,1,0
"Murdannia","Commelinaceae","Commelinales",0,0,6,53,6,0
"Muricaria","Brassicaceae","Brassicales",0,0,0,1,0,NA
"Muricococcum","Euphorbiaceae","Malpighiales",0,0,0,1,0,NA
"Murraya","Rutaceae","Sapindales",2,0,0,8,2,1
"Musa","Musaceae","Zingiberales",4,0,4,70,8,0.5
"Musanga","Urticaceae","Rosales",1,0,0,2,1,1
"Muscadinia","Vitaceae","Vitales",0,0,0,2,0,NA
"Muscari","Asparagaceae","Asparagales",0,0,6,43,6,0
"Muschleria","Asteraceae","Asterales",0,0,0,1,0,NA
"Museniopsis","Apiaceae","Apiales",0,0,0,1,0,NA
"Musilia","Asteraceae","Asterales",0,0,0,1,0,NA
"Musineon","Apiaceae","Apiales",0,0,0,4,0,NA
"Mussaenda","Rubiaceae","Gentianales",9,0,0,185,9,1
"Mussaendopsis","Rubiaceae","Gentianales",1,0,0,3,1,1
"Musschia","Campanulaceae","Asterales",0,0,1,3,1,0
"Musteron","Asteraceae","Asterales",0,0,0,1,0,NA
"Mutellina","Apiaceae","Apiales",0,0,0,1,0,NA
"Mutisia","Asteraceae","Asterales",2,1,0,57,2,1
"Mutisiopersea","Lauraceae","Laurales",0,0,0,17,0,NA
"Myagrum","Brassicaceae","Brassicales",0,0,1,1,1,0
"Myanmaria","Asteraceae","Asterales",0,0,0,1,0,NA
"Mycaranthes","Orchidaceae","Asparagales",0,0,0,36,0,NA
"Mycerinus","Ericaceae","Ericales",0,0,0,3,0,NA
"Mycetia","Rubiaceae","Gentianales",3,0,0,45,3,1
"Myginda","Celastraceae","Celastrales",0,0,0,6,0,NA
"Myobroma","Fabaceae","Fabales",0,0,0,2,0,NA
"Myodocarpus","Myodocarpaceae","Apiales",8,0,0,8,8,1
"Myopordon","Asteraceae","Asterales",0,0,0,5,0,NA
"Myoporum","Scrophulariaceae","Lamiales",2,0,0,4,2,1
"Myoschilos","Santalaceae","Santalales",1,0,0,1,1,1
"Myosotidium","Boraginaceae","UnknownOrder-Boraginaceae",0,0,0,1,0,NA
"Myosotis","Boraginaceae","UnknownOrder-Boraginaceae",0,0,14,61,14,0
"Myosurus","Ranunculaceae","Ranunculales",0,0,1,8,1,0
"Myoxanthus","Orchidaceae","Asparagales",0,0,1,48,1,0
"Myracrodruon","Anacardiaceae","Sapindales",0,0,0,1,0,NA
"Myrceugenia","Myrtaceae","Myrtales",10,0,0,47,10,1
"Myrcia","Myrtaceae","Myrtales",26,0,0,405,26,1
"Myrcianthes","Myrtaceae","Myrtales",5,0,0,37,5,1
"Myrciaria","Myrtaceae","Myrtales",3,0,0,26,3,1
"Myriactis","Asteraceae","Asterales",0,0,0,16,0,NA
"Myrialepis","Arecaceae","Arecales",0,0,0,1,0,NA
"Myriandra","Clusiaceae","Malpighiales",0,0,0,5,0,NA
"Myrianthus","Urticaceae","Rosales",2,0,0,7,2,1
"Myriaspora","Melastomataceae","Myrtales",0,0,0,1,0,NA
"Myrica","Myricaceae","Fagales",8,0,0,20,8,1
"Myricanthe","Euphorbiaceae","Malpighiales",0,0,0,1,0,NA
"Myricaria","Tamaricaceae","Caryophyllales",3,0,0,12,3,1
"Myrinia","Onagraceae","Myrtales",0,0,0,4,0,NA
"Myriocarpa","Urticaceae","Rosales",2,0,0,14,2,1
"Myriocephalus","Asteraceae","Asterales",0,0,3,15,3,0
"Myriocladus","Poaceae","Poales",0,0,0,13,0,NA
"Myrioneuron","Rubiaceae","Gentianales",0,0,0,8,0,NA
"Myriophyllum","Haloragaceae","Saxifragales",0,0,8,28,8,0
"Myriopteris","Pteridaceae","Polypodiales",0,0,0,3,0,NA
"Myriopteron","Apocynaceae","Gentianales",0,0,0,1,0,NA
"Myriopus","Boraginaceae","UnknownOrder-Boraginaceae",0,0,0,2,0,NA
"Myriostachya","Poaceae","Poales",0,0,0,1,0,NA
"Myripnois","Asteraceae","Asterales",1,0,0,1,1,1
"Myristica","Myristicaceae","Magnoliales",4,0,0,10,4,1
"Myrmechis","Orchidaceae","Asparagales",0,0,0,17,0,NA
"Myrmecodia","Rubiaceae","Gentianales",1,0,0,27,1,1
"Myrmecolaelia","Orchidaceae","Asparagales",0,0,0,2,0,NA
"Myrmeconauclea","Rubiaceae","Gentianales",1,0,0,4,1,1
"Myrmecophila","Orchidaceae","Asparagales",0,0,1,11,1,0
"Myrmecophila","Polypodiaceae",NA,0,0,0,1,0,NA
"Myrmecopteris","Polypodiaceae","Polypodiales",0,0,0,5,0,NA
"Myrmephytum","Rubiaceae","Gentianales",0,0,0,5,0,NA
"Myrobalanus","Combretaceae","Myrtales",0,0,0,1,0,NA
"Myrocarpus","Fabaceae","Fabales",2,0,0,5,2,1
"Myrosma","Marantaceae","Zingiberales",0,0,0,6,0,NA
"Myrosmodes","Orchidaceae","Asparagales",0,0,0,12,0,NA
"Myrospermum","Fabaceae","Fabales",2,0,0,2,2,1
"Myrothamnus","Myrothamnaceae","Gunnerales",1,0,0,2,1,1
"Myroxylon","Fabaceae","Fabales",2,0,0,4,2,1
"Myrrhidendron","Apiaceae","Apiales",1,0,0,5,1,1
"Myrrhinium","Myrtaceae","Myrtales",1,0,0,1,1,1
"Myrrhis","Apiaceae","Apiales",0,0,1,2,1,0
"Myrrhoides","Apiaceae","Apiales",0,0,0,1,0,NA
"Myrsine","Primulaceae","Ericales",14,0,0,131,14,1
"Myrtastrum","Myrtaceae","Myrtales",0,0,0,1,0,NA
"Myrtella","Myrtaceae","Myrtales",0,0,0,2,0,NA
"Myrteola","Myrtaceae","Myrtales",1,0,0,3,1,1
"Myrtillocactus","Cactaceae","Caryophyllales",0,0,0,5,0,NA
"Myrtus","Myrtaceae","Myrtales",2,0,0,3,2,1
"Mysanthus","Fabaceae","Fabales",0,0,0,1,0,NA
"Mystacidium","Orchidaceae","Asparagales",0,0,4,10,4,0
"Mystropetalon","Balanophoraceae","Santalales",0,0,1,1,1,0
"Mytilaria","Hamamelidaceae","Saxifragales",1,0,0,1,1,1
"Myxochlamys","Zingiberaceae","Zingiberales",0,0,0,2,0,NA
"Myxopappus","Asteraceae","Asterales",0,0,0,2,0,NA
"Myxopyrum","Oleaceae","Lamiales",2,0,0,4,2,1
"Myzorrhiza","Orobanchaceae","Lamiales",0,0,0,1,0,NA
"Nabaluia","Orchidaceae","Asparagales",0,0,1,3,1,0
"Nabalus","Asteraceae","Asterales",0,0,0,26,0,NA
"Nablonium","Asteraceae","Asterales",0,0,0,1,0,NA
"Nageia","Podocarpaceae","Araucariales",4,0,0,6,4,1
"Nageliella","Orchidaceae","Asparagales",0,0,0,1,0,NA
"Naiocrene","Montiaceae","Caryophyllales",0,0,0,2,0,NA
"Najas","Hydrocharitaceae","Alismatales",0,0,5,38,5,0
"Nama","Boraginaceae","UnknownOrder-Boraginaceae",0,0,6,54,6,0
"Namacodon","Campanulaceae","Asterales",0,0,0,1,0,NA
"Namaquanthus","Aizoaceae","Caryophyllales",0,0,0,1,0,NA
"Namaquanula","Amaryllidaceae","Asparagales",0,0,0,2,0,NA
"Namation","Scrophulariaceae","Lamiales",0,0,0,1,0,NA
"Namibia","Aizoaceae","Caryophyllales",0,0,0,2,0,NA
"Namophila","Asparagaceae","Asparagales",0,0,0,1,0,NA
"Nananthea","Asteraceae","Asterales",0,0,0,1,0,NA
"Nananthus","Aizoaceae","Caryophyllales",0,0,0,8,0,NA
"Nandina","Berberidaceae","Ranunculales",1,0,0,1,1,1
"Nannoglottis","Asteraceae","Asterales",0,0,0,4,0,NA
"Nannorrhops","Arecaceae","Arecales",0,0,0,1,0,NA
"Nannothelypteris","Thelypteridaceae","Polypodiales",0,0,0,1,0,NA
"Nanobubon","Apiaceae","Apiales",0,0,0,2,0,NA
"Nanochilus","Zingiberaceae","Zingiberales",0,0,0,1,0,NA
"Nanocnide","Urticaceae","Rosales",0,0,1,2,1,0
"Nanodea","Santalaceae","Santalales",0,0,0,1,0,NA
"Nanophyton","Amaranthaceae","Caryophyllales",0,0,0,1,0,NA
"Nanorrhinum","Plantaginaceae","Lamiales",0,0,0,3,0,NA
"Nanostelma","Apocynaceae","Gentianales",0,0,0,1,0,NA
"Nanothamnus","Asteraceae","Asterales",0,0,0,1,0,NA
"Nanuza","Velloziaceae","Pandanales",0,0,0,3,0,NA
"Napaea","Malvaceae","Malvales",0,0,0,1,0,NA
"Napeanthus","Gesneriaceae","Lamiales",0,0,1,16,1,0
"Napoleonaea","Lecythidaceae","Ericales",4,0,0,10,4,1
"Naravelia","Ranunculaceae","Ranunculales",0,0,0,2,0,NA
"Narcissus","Amaryllidaceae","Asparagales",0,0,13,116,13,0
"Nardophyllum","Asteraceae","Asterales",0,0,0,7,0,NA
"Nardostachys","Caprifoliaceae","Dipsacales",0,0,0,1,0,NA
"Narduroides","Poaceae","Poales",0,0,0,1,0,NA
"Nardus","Poaceae","Poales",0,0,1,1,1,0
"Nargedia","Rubiaceae","Gentianales",0,0,0,1,0,NA
"Narthecium","Nartheciaceae","Dioscoreales",0,0,3,7,3,0
"Narvalina","Asteraceae","Asterales",0,0,0,1,0,NA
"Nasa","Loasaceae","Cornales",0,0,3,95,3,0
"Nashia","Verbenaceae","Lamiales",0,0,0,7,0,NA
"Nassauvia","Asteraceae","Asterales",6,0,1,39,7,0.857142857142857
"Nassella","Poaceae","Poales",0,0,4,114,4,0
"Nastanthus","Calyceraceae","Asterales",0,0,2,6,2,0
"Nasturtiopsis","Brassicaceae","Brassicales",0,0,0,2,0,NA
"Nasturtium","Brassicaceae","Brassicales",0,0,1,15,1,0
"Nastus","Poaceae","Poales",2,0,0,25,2,1
"Nathaliella","Scrophulariaceae","Lamiales",0,0,0,1,0,NA
"Natsiatopsis","Icacinaceae","UnknownOrder-Icacinaceae",0,0,0,1,0,NA
"Natsiatum","Icacinaceae","UnknownOrder-Icacinaceae",1,0,0,1,1,1
"Nauclea","Rubiaceae","Gentianales",7,0,0,11,7,1
"Naucleopsis","Moraceae","Rosales",12,0,0,23,12,1
"Naudinia","Rutaceae","Sapindales",0,0,0,1,0,NA
"Naufraga","Apiaceae","Apiales",0,0,0,1,0,NA
"Nauplius","Asteraceae","Asterales",0,0,0,1,0,NA
"Nautilocalyx","Gesneriaceae","Lamiales",1,0,0,47,1,1
"Nautonia","Apocynaceae","Gentianales",0,0,0,1,0,NA
"Navarretia","Polemoniaceae","Ericales",0,0,3,41,3,0
"Navia","Bromeliaceae","Poales",0,0,2,91,2,0
"Nayariophyton","Malvaceae","Malvales",0,0,0,1,0,NA
"Nealchornea","Euphorbiaceae","Malpighiales",1,0,0,2,1,1
"Neamyza","Loranthaceae","Santalales",0,0,0,1,0,NA
"Neanotis","Rubiaceae","Gentianales",0,0,0,30,0,NA
"Neatostema","Boraginaceae","UnknownOrder-Boraginaceae",0,0,1,1,1,0
"Nebelia","Bruniaceae","Bruniales",0,0,0,1,0,NA
"Neblinaea","Asteraceae","Asterales",0,0,0,1,0,NA
"Neblinantha","Gentianaceae","Gentianales",0,0,0,2,0,NA
"Neblinanthera","Melastomataceae","Myrtales",0,0,0,1,0,NA
"Neblinathamnus","Rubiaceae","Gentianales",0,0,0,2,0,NA
"Necepsia","Euphorbiaceae","Malpighiales",1,0,0,3,1,1
"Nechamandra","Hydrocharitaceae","Alismatales",0,0,1,1,1,0
"Necramium","Melastomataceae","Myrtales",0,0,0,1,0,NA
"Nectandra","Lauraceae","Laurales",100,0,0,117,100,1
"Nectaropetalum","Erythroxylaceae","Malpighiales",2,0,0,5,2,1
"Nectouxia","Solanaceae","Solanales",0,0,0,1,0,NA
"Neea","Nyctaginaceae","Caryophyllales",17,0,0,72,17,1
"Needhamiella","Ericaceae","Ericales",1,0,0,1,1,1
"Neeopsis","Nyctaginaceae","Caryophyllales",0,0,0,1,0,NA
"Neesenbeckia","Cyperaceae","Poales",0,0,1,1,1,0
"Neesia","Malvaceae","Malvales",1,0,0,1,1,1
"Neesiochloa","Poaceae","Poales",0,0,0,1,0,NA
"Negretia","Fabaceae","Fabales",0,0,0,1,0,NA
"Negundo","Sapindaceae","Sapindales",0,0,0,1,0,NA
"Neillia","Rosaceae","Rosales",2,0,0,15,2,1
"Neja","Asteraceae","Asterales",0,0,0,1,0,NA
"Nelia","Aizoaceae","Caryophyllales",0,0,0,3,0,NA
"Nelmesia","Cyperaceae","Poales",0,0,0,1,0,NA
"Nelsia","Amaranthaceae","Caryophyllales",0,0,0,3,0,NA
"Nelsonia","Acanthaceae","Lamiales",0,0,0,3,0,NA
"Nelumbo","Nelumbonaceae","Proteales",0,0,2,2,2,0
"Nemacaulis","Polygonaceae","Caryophyllales",0,0,0,1,0,NA
"Nemacladus","Campanulaceae","Asterales",0,0,2,18,2,0
"Nemastylis","Iridaceae","Asparagales",0,0,2,6,2,0
"Nematanthus","Gesneriaceae","Lamiales",0,3,0,35,0,NA
"Nematolepis","Rutaceae","Sapindales",1,0,0,6,1,1
"Nematopoa","Poaceae","Poales",0,0,0,1,0,NA
"Nematopteris","Polypodiaceae","Polypodiales",0,0,0,1,0,NA
"Nematostylis","Rubiaceae","Gentianales",0,0,0,1,0,NA
"Nemcia","Fabaceae","Fabales",0,0,0,28,0,NA
"Nemesia","Scrophulariaceae","Lamiales",0,0,1,58,1,0
"Nemopanthus","Aquifoliaceae","Aquifoliales",2,0,0,4,2,1
"Nemophila","Boraginaceae","UnknownOrder-Boraginaceae",0,0,1,13,1,0
"Nemosenecio","Asteraceae","Asterales",0,0,0,6,0,NA
"Nemuaron","Atherospermataceae","Laurales",1,0,0,1,1,1
"Nemum","Cyperaceae","Poales",0,0,2,8,2,0
"Nenax","Rubiaceae","Gentianales",1,0,0,9,1,1
"Nenga","Arecaceae","Arecales",1,0,0,5,1,1
"Neo-uvaria","Annonaceae","Magnoliales",0,0,0,2,0,NA
"Neoachmandra","Cucurbitaceae","Cucurbitales",0,0,0,1,0,NA
"Neoalsomitra","Cucurbitaceae","Cucurbitales",0,0,2,2,2,0
"Neoapaloxylon","Fabaceae","Fabales",0,0,0,3,0,NA
"Neoastelia","Asteliaceae","Asparagales",0,0,1,1,1,0
"Neobaclea","Malvaceae","Malvales",0,0,0,1,0,NA
"Neobakeria","Asparagaceae","Asparagales",0,0,0,1,0,NA
"Neobalanocarpus","Dipterocarpaceae","Malvales",1,0,0,1,1,1
"Neobassia","Amaranthaceae","Caryophyllales",1,0,0,2,1,1
"Neobathiea","Orchidaceae","Asparagales",0,0,1,5,1,0
"Neobeckia","Brassicaceae","Brassicales",0,0,1,1,1,0
"Neobeguea","Meliaceae","Sapindales",2,0,0,3,2,1
"Neobenthamia","Orchidaceae","Asparagales",0,0,1,1,1,0
"Neobertiera","Rubiaceae","Gentianales",0,0,0,1,0,NA
"Neobesseya","Cactaceae","Caryophyllales",0,0,0,3,0,NA
"Neoblakea","Rubiaceae","Gentianales",0,0,0,2,0,NA
"Neobolusia","Orchidaceae","Asparagales",0,0,0,3,0,NA
"Neobouteloua","Poaceae","Poales",0,0,1,2,1,0
"Neoboutonia","Euphorbiaceae","Malpighiales",2,0,0,3,2,1
"Neoboykinia","Saxifragaceae","Saxifragales",0,0,0,1,0,NA
"Neobracea","Apocynaceae","Gentianales",2,0,0,8,2,1
"Neobrittonia","Malvaceae","Malvales",0,0,0,1,0,NA
"Neobuxbaumia","Cactaceae","Caryophyllales",0,0,0,9,0,NA
"Neocabreria","Asteraceae","Asterales",0,0,0,4,0,NA
"Neocallitropsis","Cupressaceae","Cupressales",1,0,0,1,1,1
"Neocalyptrocalyx","Capparaceae","Brassicales",0,0,0,1,0,NA
"Neocarya","Chrysobalanaceae","Malpighiales",1,0,0,1,1,1
"Neocentema","Amaranthaceae","Caryophyllales",0,0,0,1,0,NA
"Neocheiropteris","Polypodiaceae","Polypodiales",0,0,0,8,0,NA
"Neochevalierodendron","Fabaceae","Fabales",0,0,0,1,0,NA
"Neochilenia","Cactaceae","Caryophyllales",0,0,0,1,0,NA
"Neocinnamomum","Lauraceae","Laurales",1,0,0,4,1,1
"Neocogniauxia","Orchidaceae","Asparagales",0,0,1,2,1,0
"Neocollettia","Fabaceae","Fabales",0,0,0,1,0,NA
"Neocouma","Apocynaceae","Gentianales",0,0,0,2,0,NA
"Neocuatrecasia","Asteraceae","Asterales",0,0,0,12,0,NA
"Neocupropsis","Cupressaceae","Cupressales",0,0,0,3,0,NA
"Neodeutzia","Hydrangeaceae","Cornales",0,0,0,1,0,NA
"Neodillenia","Dilleniaceae","Dilleniales",0,0,0,3,0,NA
"Neodistemon","Urticaceae","Rosales",0,0,0,1,0,NA
"Neoeplingia","Lamiaceae","Lamiales",0,0,0,1,0,NA
"Neofabricia","Myrtaceae","Myrtales",3,0,0,3,3,1
"Neofinetia","Orchidaceae","Asparagales",0,0,1,3,1,0
"Neogaerrhinum","Plantaginaceae","Lamiales",0,0,0,2,0,NA
"Neogaillonia","Rubiaceae","Gentianales",0,0,0,1,0,NA
"Neogardneria","Orchidaceae","Asparagales",0,0,1,1,1,0
"Neoglaziovia","Bromeliaceae","Poales",0,0,1,3,1,0
"Neogoezia","Apiaceae","Apiales",0,0,1,5,1,0
"Neogontscharovia","Plumbaginaceae","Caryophyllales",0,0,0,2,0,NA
"Neoguillauminia","Euphorbiaceae","Malpighiales",1,0,0,1,1,1
"Neogyna","Orchidaceae","Asparagales",0,0,1,1,1,0
"Neoharmsia","Fabaceae","Fabales",0,0,0,2,0,NA
"Neohemsleya","Sapotaceae","Ericales",0,0,0,1,0,NA
"Neohenricia","Aizoaceae","Caryophyllales",0,0,0,2,0,NA
"Neohintonia","Asteraceae","Asterales",0,0,0,1,0,NA
"Neoholmgrenia","Onagraceae","Myrtales",0,0,0,1,0,NA
"Neohouzeaua","Poaceae","Poales",0,0,0,8,0,NA
"Neohymenopogon","Rubiaceae","Gentianales",1,0,0,3,1,1
"Neojeffreya","Asteraceae","Asterales",0,0,0,1,0,NA
"Neojobertia","Bignoniaceae","Lamiales",2,0,0,2,2,1
"Neokochia","Amaranthaceae","Caryophyllales",0,0,0,2,0,NA
"Neolacis","Podostemaceae","Malpighiales",0,0,0,3,0,NA
"Neolamarckia","Rubiaceae","Gentianales",1,0,0,2,1,1
"Neolemonniera","Sapotaceae","Ericales",1,0,0,3,1,1
"Neolepisorus","Polypodiaceae","Polypodiales",0,0,0,13,0,NA
"Neolindleya","Orchidaceae","Asparagales",0,0,0,1,0,NA
"Neolitsea","Lauraceae","Laurales",14,0,0,61,14,1
"Neolloydia","Cactaceae","Caryophyllales",0,0,0,2,0,NA
"Neolobivia","Cactaceae","Caryophyllales",0,0,0,5,0,NA
"Neololeba","Poaceae","Poales",0,0,0,3,0,NA
"Neoluederitzia","Zygophyllaceae","Zygophyllales",1,0,0,1,1,1
"Neomammillaria","Cactaceae","Caryophyllales",0,0,0,81,0,NA
"Neomarica","Iridaceae","Asparagales",0,0,6,28,6,0
"Neomartinella","Brassicaceae","Brassicales",0,0,0,1,0,NA
"Neomezia","Primulaceae","Ericales",0,0,0,1,0,NA
"Neomicrocalamus","Poaceae","Poales",0,0,0,4,0,NA
"Neomillspaughia","Polygonaceae","Caryophyllales",1,0,0,2,1,1
"Neomirandea","Asteraceae","Asterales",0,0,0,30,0,NA
"Neomitranthes","Myrtaceae","Myrtales",0,0,0,15,0,NA
"Neomoorea","Orchidaceae","Asparagales",0,0,1,1,1,0
"Neomortonia","Gesneriaceae","Lamiales",0,0,2,3,2,0
"Neomussaenda","Rubiaceae","Gentianales",0,0,0,2,0,NA
"Neomyrtus","Myrtaceae","Myrtales",1,0,0,1,1,1
"Neonauclea","Rubiaceae","Gentianales",19,0,0,68,19,1
"Neonelsonia","Apiaceae","Apiales",0,0,0,1,0,NA
"Neonesomia","Asteraceae","Asterales",0,0,0,1,0,NA
"Neonicholsonia","Arecaceae","Arecales",1,0,0,1,1,1
"Neonotonia","Fabaceae","Fabales",0,0,1,2,1,0
"Neopallasia","Asteraceae","Asterales",0,0,0,1,0,NA
"Neopanax","Araliaceae","Apiales",4,0,0,5,4,1
"Neoparrya","Apiaceae","Apiales",0,0,0,2,0,NA
"Neopaulia","Apiaceae","Apiales",0,0,0,1,0,NA
"Neopaxia","Portulacaceae","Caryophyllales",0,0,1,1,1,0
"Neopicrorhiza","Plantaginaceae","Lamiales",0,0,1,1,1,0
"Neopieris","Ericaceae","Ericales",0,0,0,1,0,NA
"Neoporteria","Cactaceae","Caryophyllales",0,0,0,28,0,NA
"Neopringlea","Salicaceae","Malpighiales",1,0,0,3,1,1
"Neoptychocarpus","Salicaceae","Malpighiales",2,0,0,2,2,1
"Neoraimondia","Cactaceae","Caryophyllales",2,0,0,2,2,1
"Neoraputia","Rutaceae","Sapindales",1,0,0,5,1,1
"Neorautanenia","Fabaceae","Fabales",0,0,1,3,1,0
"Neoregelia","Bromeliaceae","Poales",0,0,4,124,4,0
"Neorhine","Aizoaceae","Caryophyllales",0,0,0,1,0,NA
"Neoroepera","Picrodendraceae","Malpighiales",0,0,0,2,0,NA
"Neorudolphia","Fabaceae","Fabales",1,0,0,1,1,1
"Neoschroetera","Zygophyllaceae","Zygophyllales",0,0,0,1,0,NA
"Neoschumannia","Apocynaceae","Gentianales",0,0,0,2,0,NA
"Neoscirpus","Cyperaceae","Poales",0,0,0,1,0,NA
"Neoscortechinia","Euphorbiaceae","Malpighiales",3,0,0,6,3,1
"Neosepicaea","Bignoniaceae","Lamiales",1,0,0,4,1,1
"Neoshirakia","Euphorbiaceae","Malpighiales",1,0,0,1,1,1
"Neosparton","Verbenaceae","Lamiales",0,0,0,4,0,NA
"Neosprucea","Salicaceae","Malpighiales",1,0,0,7,1,1
"Neostapfia","Poaceae","Poales",0,0,1,1,1,0
"Neostapfiella","Poaceae","Poales",0,0,0,3,0,NA
"Neostenanthera","Annonaceae","Magnoliales",2,0,0,5,2,1
"Neotatea","Calophyllaceae","Malpighiales",1,0,0,4,1,1
"Neotessmannia","Muntingiaceae","Malvales",0,0,0,1,0,NA
"Neotina","Sapindaceae","Sapindales",0,0,0,1,0,NA
"Neotinea","Orchidaceae","Asparagales",0,0,0,5,0,NA
"Neotorularia","Brassicaceae","Brassicales",0,0,1,13,1,0
"Neottia","Orchidaceae","Asparagales",0,0,3,64,3,0
"Neottianthe","Orchidaceae","Asparagales",0,0,1,8,1,0
"Neottopteris","Aspleniaceae","Polypodiales",0,0,0,8,0,NA
"Neotysonia","Asteraceae","Asterales",0,0,0,1,0,NA
"Neoveitchia","Arecaceae","Arecales",1,0,0,2,1,1
"Neowerdermannia","Cactaceae","Caryophyllales",1,0,0,3,1,1
"Nepenthes","Nepenthaceae","Caryophyllales",0,2,0,7,0,NA
"Nepeta","Lamiaceae","Lamiales",0,0,17,251,17,0
"Nephelaphyllum","Orchidaceae","Asparagales",0,0,1,11,1,0
"Nephelea","Cyatheaceae","Cyatheales",0,0,0,7,0,NA
"Nephelium","Sapindaceae","Sapindales",3,0,0,5,3,1
"Nephelochloa","Poaceae","Poales",0,0,0,1,0,NA
"Nephopteris","Pteridaceae","Polypodiales",0,0,0,1,0,NA
"Nephradenia","Apocynaceae","Gentianales",0,0,0,4,0,NA
"Nephrangis","Orchidaceae","Asparagales",0,0,0,2,0,NA
"Nephrodesmus","Fabaceae","Fabales",0,0,0,1,0,NA
"Nephrodium","Dryopteridaceae","Polypodiales",0,0,0,38,0,NA
"Nephrolepis","Nephrolepidaceae","Polypodiales",0,0,2,22,2,0
"Nephromeria","Fabaceae","Fabales",0,0,0,3,0,NA
"Nephrophyllidium","Menyanthaceae","Asterales",0,0,0,1,0,NA
"Nephrosperma","Arecaceae","Arecales",0,0,0,1,0,NA
"Nephrotheca","Asteraceae","Asterales",0,0,1,1,1,0
"Nephthytis","Araceae","Alismatales",0,0,0,6,0,NA
"Nepsera","Melastomataceae","Myrtales",0,0,0,1,0,NA
"Neptunia","Fabaceae","Fabales",0,1,2,12,2,0
"Neraudia","Urticaceae","Rosales",0,0,0,7,0,NA
"Neriacanthus","Acanthaceae","Lamiales",0,0,0,3,0,NA
"Nerine","Amaryllidaceae","Asparagales",0,0,1,26,1,0
"Nerisyrenia","Brassicaceae","Brassicales",0,0,1,9,1,0
"Nerium","Apocynaceae","Gentianales",1,0,0,1,1,1
"Nernstia","Rubiaceae","Gentianales",0,0,0,1,0,NA
"Nertera","Rubiaceae","Gentianales",0,0,2,10,2,0
"Nervilia","Orchidaceae","Asparagales",0,0,2,67,2,0
"Nesaea","Lythraceae","Myrtales",0,0,2,58,2,0
"Nesampelos","Asteraceae","Asterales",0,0,0,3,0,NA
"Nesiota","Rhamnaceae","Rosales",1,0,0,1,1,1
"Neslia","Brassicaceae","Brassicales",0,0,1,1,1,0
"Nesocaryum","Boraginaceae","UnknownOrder-Boraginaceae",0,0,0,1,0,NA
"Nesocodon","Campanulaceae","Asterales",0,0,0,1,0,NA
"Nesogenes","Orobanchaceae","Lamiales",0,0,0,8,0,NA
"Nesogordonia","Malvaceae","Malvales",3,0,0,22,3,1
"Nesohedyotis","Rubiaceae","Gentianales",0,0,0,1,0,NA
"Nesomia","Asteraceae","Asterales",0,0,0,1,0,NA
"Nesopteris","Hymenophyllaceae","Hymenophyllales",0,0,0,1,0,NA
"Nesphostylis","Fabaceae","Fabales",0,0,0,4,0,NA
"Nestegis","Oleaceae","Lamiales",5,0,0,5,5,1
"Nestlera","Asteraceae","Asterales",0,0,0,1,0,NA
"Nestotus","Asteraceae","Asterales",0,0,0,2,0,NA
"Nestronia","Santalaceae","Santalales",1,0,0,1,1,1
"Neuburgia","Loganiaceae","Gentianales",1,0,0,3,1,1
"Neuontobotrys","Brassicaceae","Brassicales",0,1,2,12,2,0
"Neuracanthus","Acanthaceae","Lamiales",0,0,0,13,0,NA
"Neurachne","Poaceae","Poales",0,0,3,7,3,0
"Neurada","Neuradaceae","Malvales",0,0,1,1,1,0
"Neuradopsis","Neuradaceae","Malvales",0,0,0,2,0,NA
"Neurocallis","Pteridaceae","Polypodiales",0,0,3,3,3,0
"Neurocalyx","Rubiaceae","Gentianales",0,0,1,5,1,0
"Neurodium","Polypodiaceae","Polypodiales",0,0,0,1,0,NA
"Neurolaena","Asteraceae","Asterales",1,1,0,13,1,1
"Neurolakis","Asteraceae","Asterales",0,0,0,1,0,NA
"Neuropeltis","Convolvulaceae","Solanales",1,0,0,18,1,1
"Neuropoa","Poaceae","Poales",0,0,1,1,1,0
"Neurosoria","Pteridaceae","Polypodiales",0,0,0,1,0,NA
"Neurotheca","Gentianaceae","Gentianales",0,0,0,4,0,NA
"Neurotropis","Brassicaceae","Brassicales",0,0,0,1,0,NA
"Neuwiedia","Orchidaceae","Asparagales",0,0,3,8,3,0
"Nevada","Brassicaceae","Brassicales",0,0,1,1,1,0
"Nevillea","Restionaceae","Poales",0,0,0,3,0,NA
"Newberrya","Ericaceae","Ericales",0,0,0,1,0,NA
"Newbouldia","Bignoniaceae","Lamiales",1,0,0,1,1,1
"Newcastelia","Lamiaceae","Lamiales",0,0,0,10,0,NA
"Newmania","Zingiberaceae","Zingiberales",0,0,0,2,0,NA
"Newtonia","Fabaceae","Fabales",5,0,0,16,5,1
"Neyraudia","Poaceae","Poales",0,0,2,4,2,0
"Nicandra","Solanaceae","Solanales",0,0,1,2,1,0
"Nichallea","Rubiaceae","Gentianales",0,0,0,1,0,NA
"Nicolasia","Asteraceae","Asterales",0,0,0,7,0,NA
"Nicolletia","Asteraceae","Asterales",0,0,0,3,0,NA
"Nicolsonia","Fabaceae","Fabales",0,0,0,1,0,NA
"Nicotiana","Solanaceae","Solanales",9,0,20,55,29,0.310344827586207
"Nidema","Orchidaceae","Asparagales",0,0,1,2,1,0
"Nidorella","Asteraceae","Asterales",0,0,0,16,0,NA
"Nidularium","Bromeliaceae","Poales",0,0,1,55,1,0
"Niduregelia","Bromeliaceae","Poales",0,0,0,3,0,NA
"Niedenzuella","Malpighiaceae","Malpighiales",2,0,0,16,2,1
"Niedzwedzkia","Bignoniaceae","Lamiales",0,0,0,1,0,NA
"Niemeyera","Sapotaceae","Ericales",4,0,0,4,4,1
"Nierembergia","Solanaceae","Solanales",0,0,1,23,1,0
"Nietneria","Nartheciaceae","Dioscoreales",0,0,0,2,0,NA
"Nigella","Ranunculaceae","Ranunculales",0,0,2,18,2,0
"Nikitinia","Asteraceae","Asterales",0,0,0,1,0,NA
"Nilgirianthus","Acanthaceae","Lamiales",0,0,0,1,0,NA
"Nimiria","Fabaceae","Fabales",0,0,0,1,0,NA
"Niphaea","Gesneriaceae","Lamiales",0,0,1,3,1,0
"Niphidium","Polypodiaceae","Polypodiales",0,0,0,12,0,NA
"Niphogeton","Apiaceae","Apiales",0,0,1,18,1,0
"Nipponanthemum","Asteraceae","Asterales",0,0,0,1,0,NA
"Nissolia","Fabaceae","Fabales",2,0,1,18,3,0.666666666666667
"Nitidobulbon","Orchidaceae","Asparagales",0,0,0,3,0,NA
"Nitraria","Nitrariaceae","Sapindales",6,0,0,7,6,1
"Nitrophila","Amaranthaceae","Caryophyllales",0,0,1,3,1,0
"Nivellea","Asteraceae","Asterales",0,0,0,1,0,NA
"Nivenia","Iridaceae","Asparagales",6,0,0,11,6,1
"Noaea","Amaranthaceae","Caryophyllales",0,0,0,2,0,NA
"Nocca","Asteraceae","Asterales",0,0,0,4,0,NA
"Noccaea","Brassicaceae","Brassicales",0,0,0,45,0,NA
"Noccidium","Brassicaceae","Brassicales",0,0,0,2,0,NA
"Nodocarpaea","Rubiaceae","Gentianales",0,0,0,1,0,NA
"Nogalia","Boraginaceae","UnknownOrder-Boraginaceae",0,0,0,1,0,NA
"Nogra","Fabaceae","Fabales",0,0,0,4,0,NA
"Nohawilliamsia","Orchidaceae","Asparagales",0,0,0,1,0,NA
"Noisettia","Violaceae","Malpighiales",0,0,0,1,0,NA
"Nolana","Solanaceae","Solanales",0,0,4,84,4,0
"Nolina","Asparagaceae","Asparagales",9,0,0,29,9,1
"Nolletia","Asteraceae","Asterales",0,0,0,9,0,NA
"Noltea","Rhamnaceae","Rosales",1,0,0,1,1,1
"Nomismia","Fabaceae","Fabales",0,0,0,1,0,NA
"Nomocharis","Liliaceae","Liliales",0,0,4,9,4,0
"Nomopyle","Gesneriaceae","Lamiales",0,0,0,2,0,NA
"Nomosa","Boraginaceae","UnknownOrder-Boraginaceae",0,0,0,1,0,NA
"Nonea","Boraginaceae","UnknownOrder-Boraginaceae",0,0,1,20,1,0
"Nopalea","Cactaceae","Caryophyllales",0,0,0,7,0,NA
"Nopalxochia","Cactaceae","Caryophyllales",0,0,0,1,0,NA
"Norantea","Marcgraviaceae","Ericales",2,0,0,7,2,1
"Nordenstamia","Asteraceae","Asterales",0,0,0,15,0,NA
"Norlindhia","Asteraceae","Asterales",0,0,0,3,0,NA
"Normanbya","Arecaceae","Arecales",1,0,0,1,1,1
"Normandia","Rubiaceae","Gentianales",0,0,0,1,0,NA
"Normandiodendron","Fabaceae","Fabales",0,0,0,2,0,NA
"Normania","Solanaceae","Solanales",0,0,0,1,0,NA
"Noronhia","Oleaceae","Lamiales",1,0,0,45,1,1
"Northia","Sapotaceae","Ericales",1,0,0,1,1,1
"Nosema","Lamiaceae","Lamiales",0,0,0,1,0,NA
"Nostolachma","Rubiaceae","Gentianales",0,0,0,6,0,NA
"Notanthera","Loranthaceae","Santalales",0,0,0,1,0,NA
"Notaphoebe","Lauraceae","Laurales",0,0,0,1,0,NA
"Notechidnopsis","Apocynaceae","Gentianales",0,0,0,1,0,NA
"Notelaea","Oleaceae","Lamiales",7,0,0,12,7,1
"Nothaphoebe","Lauraceae","Laurales",1,0,0,12,1,1
"Nothapodytes","Icacinaceae","UnknownOrder-Icacinaceae",0,0,0,7,0,NA
"Notheria","Orchidaceae","Asparagales",0,0,0,1,0,NA
"Nothobaccaurea","Phyllanthaceae","Malpighiales",1,0,0,2,1,1
"Nothobaccharis","Asteraceae","Asterales",0,0,0,1,0,NA
"Nothobartsia","Orobanchaceae","Lamiales",0,0,0,2,0,NA
"Nothocalais","Asteraceae","Asterales",0,0,0,4,0,NA
"Nothocestrum","Solanaceae","Solanales",1,0,0,5,1,1
"Nothochelone","Plantaginaceae","Lamiales",0,0,0,1,0,NA
"Nothochilus","Orobanchaceae","Lamiales",0,0,0,1,0,NA
"Nothocnide","Urticaceae","Rosales",0,0,0,2,0,NA
"Nothodoritis","Orchidaceae","Asparagales",0,0,1,1,1,0
"Nothofagus","Nothofagaceae","Fagales",27,0,0,38,27,1
"Notholaena","Pteridaceae","Polypodiales",0,0,0,38,0,NA
"Notholirion","Liliaceae","Liliales",0,0,2,4,2,0
"Notholithocarpus","Fagaceae","Fagales",0,0,0,1,0,NA
"Nothopegia","Anacardiaceae","Sapindales",0,0,0,1,0,NA
"Nothoperanema","Dryopteridaceae","Polypodiales",0,0,0,6,0,NA
"Nothoruellia","Acanthaceae","Lamiales",0,0,0,1,0,NA
"Nothosaerva","Amaranthaceae","Caryophyllales",0,0,1,1,1,0
"Nothoscordum","Amaryllidaceae","Asparagales",0,0,3,89,3,0
"Nothosmyrnium","Apiaceae","Apiales",0,0,0,2,0,NA
"Nothospondias","Simaroubaceae","Sapindales",1,0,0,1,1,1
"Nothostele","Orchidaceae","Asparagales",0,0,0,2,0,NA
"Nothotalisia","Picramniaceae","Picramniales",0,0,0,3,0,NA
"Nothotsuga","Pinaceae","Pinales",1,0,0,1,1,1
"Noticastrum","Asteraceae","Asterales",0,0,1,18,1,0
"Notiosciadium","Apiaceae","Apiales",0,0,0,1,0,NA
"Notobasis","Asteraceae","Asterales",0,0,1,1,1,0
"Notobubon","Apiaceae","Apiales",0,0,0,12,0,NA
"Notocactus","Cactaceae","Caryophyllales",0,0,0,1,0,NA
"Notoceras","Brassicaceae","Brassicales",0,0,0,1,0,NA
"Notochloe","Poaceae","Poales",0,0,1,1,1,0
"Notodon","Fabaceae","Fabales",0,0,0,3,0,NA
"Notoleptopus","Phyllanthaceae","Malpighiales",0,0,0,1,0,NA
"Notonia","Asteraceae","Asterales",0,0,0,1,0,NA
"Notopleura","Rubiaceae","Gentianales",1,0,0,102,1,1
"Notopora","Ericaceae","Ericales",0,0,0,5,0,NA
"Notopterygium","Apiaceae","Apiales",0,0,0,6,0,NA
"Notoseris","Asteraceae","Asterales",0,0,0,13,0,NA
"Notospartium","Fabaceae","Fabales",0,0,0,3,0,NA
"Notothlaspi","Brassicaceae","Brassicales",0,0,0,2,0,NA
"Nototriche","Malvaceae","Malvales",0,0,1,94,1,0
"Notylia","Orchidaceae","Asparagales",0,0,1,56,1,0
"Notyliopsis","Orchidaceae","Asparagales",0,0,0,1,0,NA
"Nouelia","Asteraceae","Asterales",0,0,0,1,0,NA
"Novaguinea","Asteraceae","Asterales",0,0,0,1,0,NA
"Noveloa","Podostemaceae","Malpighiales",0,0,0,2,0,NA
"Novenia","Asteraceae","Asterales",0,0,0,1,0,NA
"Novopokrovskia","Asteraceae","Asterales",0,0,0,1,0,NA
"Nucularia","Amaranthaceae","Caryophyllales",0,0,0,1,0,NA
"Nummularia","Primulaceae","Ericales",0,0,0,3,0,NA
"Nuphar","Nymphaeaceae","Nymphaeales",0,0,10,18,10,0
"Nuttallanthus","Plantaginaceae","Lamiales",0,0,0,4,0,NA
"Nuttallia","Rosaceae","Rosales",0,0,0,9,0,NA
"Nuxia","Stilbaceae","Lamiales",5,0,0,15,5,1
"Nyctaginia","Nyctaginaceae","Caryophyllales",0,0,0,1,0,NA
"Nyctanthes","Oleaceae","Lamiales",1,0,0,2,1,1
"Nycterium","Solanaceae","Solanales",0,0,0,1,0,NA
"Nycticalanthus","Rutaceae","Sapindales",0,0,0,1,0,NA
"Nyctocalos","Bignoniaceae","Lamiales",0,0,0,4,0,NA
"Nyctocereus","Cactaceae","Caryophyllales",0,0,0,1,0,NA
"Nylandtia","Polygalaceae","Fabales",0,0,0,2,0,NA
"Nymania","Meliaceae","Sapindales",1,0,0,1,1,1
"Nymphaea","Nymphaeaceae","Nymphaeales",0,0,15,44,15,0
"Nymphoides","Menyanthaceae","Asterales",0,0,11,34,11,0
"Nymphozanthus","Nymphaeaceae","Nymphaeales",0,0,0,1,0,NA
"Nypa","Arecaceae","Arecales",1,0,0,1,1,1
"Nyssa","Cornaceae","Cornales",6,0,0,9,6,1
"Nyssanthes","Amaranthaceae","Caryophyllales",0,0,0,2,0,NA
"Oakesiella","Liliaceae","Liliales",0,0,0,1,0,NA
"Oaxacania","Asteraceae","Asterales",0,0,0,1,0,NA
"Oberna","Caryophyllaceae","Caryophyllales",0,0,0,9,0,NA
"Oberonia","Orchidaceae","Asparagales",0,0,6,324,6,0
"Oberonioides","Orchidaceae","Asparagales",0,0,0,2,0,NA
"Obetia","Urticaceae","Rosales",0,0,0,5,0,NA
"Oblivia","Asteraceae","Asterales",1,0,0,2,1,1
"Obolaria","Gentianaceae","Gentianales",0,0,1,1,1,0
"Obolinga","Fabaceae","Fabales",0,0,0,1,0,NA
"Obregonia","Cactaceae","Caryophyllales",0,0,0,1,0,NA
"Obtegomeria","Lamiaceae","Lamiales",0,0,0,1,0,NA
"Ochagavia","Bromeliaceae","Poales",0,0,2,4,2,0
"Ochetophila","Rhamnaceae","Rosales",0,0,0,2,0,NA
"Ochlandra","Poaceae","Poales",0,0,0,12,0,NA
"Ochna","Ochnaceae","Malpighiales",14,0,0,69,14,1
"Ochoterenaea","Anacardiaceae","Sapindales",1,0,0,1,1,1
"Ochotia","Apiaceae","Apiales",0,0,0,1,0,NA
"Ochradenus","Resedaceae","Brassicales",1,0,1,3,2,0.5
"Ochreinauclea","Rubiaceae","Gentianales",1,0,0,2,1,1
"Ochrocarpos","Clusiaceae","Malpighiales",0,0,0,2,0,NA
"Ochrocephala","Asteraceae","Asterales",0,0,0,1,0,NA
"Ochroma","Malvaceae","Malvales",1,0,0,1,1,1
"Ochropteris","Pteridaceae","Polypodiales",0,0,1,1,1,0
"Ochrosia","Apocynaceae","Gentianales",12,0,0,44,12,1
"Ochrosperma","Myrtaceae","Myrtales",3,0,0,6,3,1
"Ochthephilus","Melastomataceae","Myrtales",0,0,0,1,0,NA
"Ochthocharis","Melastomataceae","Myrtales",0,0,0,1,0,NA
"Ochthochloa","Poaceae","Poales",0,0,0,1,0,NA
"Ochthocosmus","Ixonanthaceae","Malpighiales",2,0,0,10,2,1
"Ochthodium","Brassicaceae","Brassicales",0,0,0,1,0,NA
"Ocimum","Lamiaceae","Lamiales",0,0,3,66,3,0
"Oclemena","Asteraceae","Asterales",0,0,1,4,1,0
"Ocotea","Lauraceae","Laurales",103,0,0,428,103,1
"Octamyrtus","Myrtaceae","Myrtales",0,0,0,6,0,NA
"Octarrhena","Orchidaceae","Asparagales",0,0,0,52,0,NA
"Octoceras","Brassicaceae","Brassicales",0,0,0,1,0,NA
"Octoknema","Olacaceae","Santalales",1,0,0,7,1,1
"Octolepis","Thymelaeaceae","Malvales",0,0,0,7,0,NA
"Octolobus","Malvaceae","Malvales",1,0,0,3,1,1
"Octomeria","Orchidaceae","Asparagales",0,0,1,162,1,0
"Octopoma","Aizoaceae","Caryophyllales",0,0,0,8,0,NA
"Octotropis","Rubiaceae","Gentianales",0,0,0,1,0,NA
"Oddoniodendron","Fabaceae","Fabales",1,0,0,3,1,1
"Odicardis","Plantaginaceae","Lamiales",0,0,0,1,0,NA
"Odisha","Orchidaceae","Asparagales",0,0,0,1,0,NA
"Odixia","Asteraceae","Asterales",1,0,0,2,1,1
"Odonellia","Convolvulaceae","Solanales",0,0,1,2,1,0
"Odonia","Fabaceae","Fabales",0,0,0,4,0,NA
"Odontadenia","Apocynaceae","Gentianales",2,2,0,20,2,1
"Odontanthera","Apocynaceae","Gentianales",0,0,0,1,0,NA
"Odontelytrum","Poaceae","Poales",0,0,0,1,0,NA
"Odontitella","Orobanchaceae","Lamiales",0,0,0,1,0,NA
"Odontites","Orobanchaceae","Lamiales",0,0,0,11,0,NA
"Odontocarya","Menispermaceae","Ranunculales",1,4,0,37,1,1
"Odontochilus","Orchidaceae","Asparagales",0,0,0,26,0,NA
"Odontocline","Asteraceae","Asterales",2,0,0,6,2,1
"Odontoglossum","Orchidaceae","Asparagales",0,0,0,3,0,NA
"Odontoloma","Lindsaeaceae","Polypodiales",0,0,0,1,0,NA
"Odontonema","Acanthaceae","Lamiales",0,0,0,22,0,NA
"Odontophorus","Aizoaceae","Caryophyllales",0,0,0,3,0,NA
"Odontorrhynchus","Orchidaceae","Asparagales",0,0,0,6,0,NA
"Odontosoria","Lindsaeaceae","Polypodiales",0,0,0,14,0,NA
"Odontostephana","Apocynaceae","Gentianales",0,0,0,4,0,NA
"Odontostomum","Tecophilaeaceae","Asparagales",0,0,1,1,1,0
"Odontotrichum","Asteraceae","Asterales",0,0,0,15,0,NA
"Odosicyos","Cucurbitaceae","Cucurbitales",0,1,0,1,0,NA
"Odostelma","Passifloraceae","Malpighiales",0,0,0,2,0,NA
"Odostemon","Berberidaceae","Ranunculales",1,0,0,13,1,1
"Odyendyea","Simaroubaceae","Sapindales",0,0,0,1,0,NA
"Odyssea","Poaceae","Poales",0,0,0,2,0,NA
"Oeceoclades","Orchidaceae","Asparagales",0,0,2,38,2,0
"Oecopetalum","Icacinaceae","UnknownOrder-Icacinaceae",1,0,0,2,1,1
"Oedematopus","Clusiaceae","Malpighiales",0,0,0,1,0,NA
"Oedera","Asteraceae","Asterales",1,0,0,18,1,1
"Oedibasis","Apiaceae","Apiales",0,0,0,3,0,NA
"Oedina","Loranthaceae","Santalales",0,0,0,4,0,NA
"Oehmea","Cactaceae","Caryophyllales",0,0,0,1,0,NA
"Oemleria","Rosaceae","Rosales",1,0,0,1,1,1
"Oenanthe","Apiaceae","Apiales",0,0,6,28,6,0
"Oenocarpus","Arecaceae","Arecales",9,0,0,10,9,1
"Oenostachys","Iridaceae","Asparagales",0,0,0,1,0,NA
"Oenothera","Onagraceae","Myrtales",0,0,9,150,9,0
"Oenotrichia","Dennstaedtiaceae","Polypodiales",0,0,0,3,0,NA
"Oeonia","Orchidaceae","Asparagales",0,0,1,5,1,0
"Oeoniella","Orchidaceae","Asparagales",0,0,1,2,1,0
"Oeosporangium","Pteridaceae","Polypodiales",0,0,0,1,0,NA
"Oerstedina","Gesneriaceae","Lamiales",0,1,0,3,0,NA
"Oestlundia","Orchidaceae","Asparagales",0,0,3,4,3,0
"Oetosis","Polypodiaceae","Polypodiales",0,0,0,1,0,NA
"Ofaiston","Amaranthaceae","Caryophyllales",0,0,1,1,1,0
"Oftia","Scrophulariaceae","Lamiales",0,0,1,3,1,0
"Ogastemma","Boraginaceae","UnknownOrder-Boraginaceae",0,0,1,1,1,0
"Ohbaea","Crassulaceae","Saxifragales",0,0,0,1,0,NA
"Ohwia","Fabaceae","Fabales",1,0,0,1,1,1
"Oiospermum","Asteraceae","Asterales",0,0,0,1,0,NA
"Okenia","Nyctaginaceae","Caryophyllales",0,0,1,1,1,0
"Okoubaka","Santalaceae","Santalales",1,0,0,2,1,1
"Olax","Olacaceae","Santalales",3,0,0,21,3,1
"Oldenburgia","Asteraceae","Asterales",1,0,0,4,1,1
"Oldenlandia","Rubiaceae","Gentianales",0,0,7,240,7,0
"Oldenlandiopsis","Rubiaceae","Gentianales",0,0,0,1,0,NA
"Oldfeltia","Asteraceae","Asterales",0,0,0,1,0,NA
"Oldfieldia","Picrodendraceae","Malpighiales",3,0,0,4,3,1
"Olea","Oleaceae","Lamiales",15,0,0,35,15,1
"Oleandra","Oleandraceae","Polypodiales",0,0,0,19,0,NA
"Oleandropsis","Polypodiaceae","Polypodiales",0,0,0,1,0,NA
"Olearia","Asteraceae","Asterales",19,0,0,180,19,1
"Olfersia","Dryopteridaceae","Polypodiales",0,0,0,2,0,NA
"Olgaea","Asteraceae","Asterales",0,0,1,18,1,0
"Oligactis","Asteraceae","Asterales",0,0,0,15,0,NA
"Oliganthes","Asteraceae","Asterales",0,0,0,6,0,NA
"Oligocarpus","Asteraceae","Asterales",0,0,0,1,0,NA
"Oligoceras","Euphorbiaceae","Malpighiales",0,0,0,1,0,NA
"Oligochaeta","Asteraceae","Asterales",0,0,0,4,0,NA
"Oligocladus","Apiaceae","Apiales",0,0,0,1,0,NA
"Oligocodon","Rubiaceae","Gentianales",0,0,0,1,0,NA
"Oligomeris","Resedaceae","Brassicales",0,0,4,4,4,0
"Oligoneuron","Asteraceae","Asterales",0,0,0,1,0,NA
"Oligophyton","Orchidaceae","Asparagales",0,0,0,1,0,NA
"Oligosporus","Asteraceae","Asterales",0,0,0,2,0,NA
"Oligostachyum","Poaceae","Poales",2,0,0,17,2,1
"Oligothrix","Asteraceae","Asterales",0,0,0,1,0,NA
"Olimarabidopsis","Brassicaceae","Brassicales",0,0,1,3,1,0
"Olinia","Penaeaceae","Myrtales",6,0,0,8,6,1
"Olivaea","Asteraceae","Asterales",0,0,0,2,0,NA
"Oliverella","Loranthaceae","Santalales",0,0,0,3,0,NA
"Oliveriana","Orchidaceae","Asparagales",0,0,0,6,0,NA
"Olmeca","Poaceae","Poales",0,0,0,2,0,NA
"Olmediella","Salicaceae","Malpighiales",1,0,0,1,1,1
"Olneya","Fabaceae","Fabales",1,0,0,1,1,1
"Olsynium","Iridaceae","Asparagales",0,0,8,17,8,0
"Olymposciadium","Apiaceae","Apiales",0,0,0,1,0,NA
"Olyra","Poaceae","Poales",0,0,1,23,1,0
"Omalocarpus","Sapindaceae","Sapindales",0,0,0,1,0,NA
"Omalotheca","Asteraceae","Asterales",0,0,2,4,2,0
"Ombrocharis","Lamiaceae","Lamiales",0,0,0,1,0,NA
"Ombrophytum","Balanophoraceae","Santalales",0,0,0,4,0,NA
"Omiltemia","Rubiaceae","Gentianales",0,0,0,2,0,NA
"Omoea","Orchidaceae","Asparagales",0,0,1,2,1,0
"Omphacomeria","Santalaceae","Santalales",0,0,0,1,0,NA
"Omphalea","Euphorbiaceae","Malpighiales",4,0,0,22,4,1
"Omphalocarpum","Sapotaceae","Ericales",6,0,0,27,6,1
"Omphalodes","Boraginaceae","UnknownOrder-Boraginaceae",0,0,1,16,1,0
"Omphalogonus","Apocynaceae","Gentianales",0,0,0,1,0,NA
"Omphalogramma","Primulaceae","Ericales",0,0,3,9,3,0
"Omphalopappus","Asteraceae","Asterales",0,0,0,1,0,NA
"Omphalotrigonotis","Boraginaceae","UnknownOrder-Boraginaceae",0,0,1,2,1,0
"Omphalotrix","Orobanchaceae","Lamiales",0,0,0,1,0,NA
"Onagra","Onagraceae","Myrtales",0,0,0,2,0,NA
"Oncella","Loranthaceae","Santalales",0,0,0,4,0,NA
"Oncidium","Orchidaceae","Asparagales",0,0,7,341,7,0
"Oncinema","Apocynaceae","Gentianales",0,1,0,1,0,NA
"Oncinocalyx","Lamiaceae","Lamiales",0,0,1,1,1,0
"Oncinotis","Apocynaceae","Gentianales",1,0,0,7,1,1
"Oncoba","Salicaceae","Malpighiales",3,0,0,29,3,1
"Oncocalamus","Arecaceae","Arecales",2,0,0,5,2,1
"Oncocalyx","Loranthaceae","Santalales",0,0,0,13,0,NA
"Oncosiphon","Asteraceae","Asterales",0,1,0,8,0,NA
"Oncosperma","Arecaceae","Arecales",3,0,0,6,3,1
"Oncostemma","Apocynaceae","Gentianales",0,0,0,1,0,NA
"Oncostemum","Primulaceae","Ericales",0,0,0,99,0,NA
"Oncotheca","Oncothecaceae","UnknownOrder-Oncothecaceae",1,0,0,1,1,1
"Ondetia","Asteraceae","Asterales",0,0,1,1,1,0
"Ongokea","Olacaceae","Santalales",1,0,0,1,1,1
"Onira","Iridaceae","Asparagales",0,0,1,1,1,0
"Onix","Fabaceae","Fabales",0,0,0,1,0,NA
"Onobroma","Asteraceae","Asterales",0,0,0,1,0,NA
"Onobrychis","Fabaceae","Fabales",0,0,4,148,4,0
"Onoclea","Onocleaceae","Polypodiales",0,0,1,5,1,0
"Onocleopsis","Onocleaceae","Polypodiales",0,0,0,1,0,NA
"Ononis","Fabaceae","Fabales",0,0,3,69,3,0
"Onopordum","Asteraceae","Asterales",0,0,3,46,3,0
"Onoseris","Asteraceae","Asterales",0,1,0,20,0,NA
"Onosma","Boraginaceae","UnknownOrder-Boraginaceae",1,0,0,77,1,1
"Onosmodium","Boraginaceae","UnknownOrder-Boraginaceae",0,0,0,10,0,NA
"Onuris","Brassicaceae","Brassicales",0,0,0,6,0,NA
"Onychium","Pteridaceae","Polypodiales",0,0,0,9,0,NA
"Onychopetalum","Annonaceae","Magnoliales",2,0,0,2,2,1
"Onychosepalum","Restionaceae","Poales",0,0,0,3,0,NA
"Oocephala","Asteraceae","Asterales",0,0,0,2,0,NA
"Ooia","Araceae","Alismatales",0,0,0,2,0,NA
"Oonopsis","Asteraceae","Asterales",0,0,0,4,0,NA
"Oophytum","Aizoaceae","Caryophyllales",0,0,0,2,0,NA
"Oparanthus","Asteraceae","Asterales",0,0,0,3,0,NA
"Opercularia","Rubiaceae","Gentianales",1,0,1,17,2,0.5
"Operculicarya","Anacardiaceae","Sapindales",2,0,0,6,2,1
"Operculina","Convolvulaceae","Solanales",0,2,0,14,0,NA
"Ophelia","Gentianaceae","Gentianales",0,0,0,4,0,NA
"Ophellantha","Euphorbiaceae","Malpighiales",2,0,0,2,2,1
"Ophiobotrys","Salicaceae","Malpighiales",1,0,0,1,1,1
"Ophiocarpus","Fabaceae","Fabales",0,0,0,1,0,NA
"Ophiocaryon","Sabiaceae","UnknownOrder-Sabiaceae",3,0,0,8,3,1
"Ophiochloa","Poaceae","Poales",0,0,1,2,1,0
"Ophiocolea","Bignoniaceae","Lamiales",2,0,0,10,2,1
"Ophioglossella","Orchidaceae","Asparagales",0,0,0,1,0,NA
"Ophioglossum","Ophioglossaceae","Ophioglossales",0,0,9,34,9,0
"Ophionella","Apocynaceae","Gentianales",0,0,0,1,0,NA
"Ophiopogon","Asparagaceae","Asparagales",0,0,3,67,3,0
"Ophiorrhiza","Rubiaceae","Gentianales",2,1,2,316,4,0.5
"Ophiorrhiziphyllon","Acanthaceae","Lamiales",0,0,0,2,0,NA
"Ophiuros","Poaceae","Poales",0,0,0,4,0,NA
"Ophrestia","Fabaceae","Fabales",0,0,2,15,2,0
"Ophryosporus","Asteraceae","Asterales",0,0,0,40,0,NA
"Ophrypetalum","Annonaceae","Magnoliales",0,0,0,1,0,NA
"Ophrys","Orchidaceae","Asparagales",0,0,2,149,2,0
"Ophthalmoblapton","Euphorbiaceae","Malpighiales",0,0,0,4,0,NA
"Ophthalmophyllum","Aizoaceae","Caryophyllales",0,0,0,24,0,NA
"Opilia","Opiliaceae","Santalales",2,0,0,2,2,1
"Opisthocentra","Melastomataceae","Myrtales",0,0,0,1,0,NA
"Opisthopappus","Asteraceae","Asterales",0,0,0,3,0,NA
"Opithandra","Gesneriaceae","Lamiales",0,0,1,3,1,0
"Opizia","Poaceae","Poales",0,0,0,2,0,NA
"Oplismenopsis","Poaceae","Poales",0,0,1,1,1,0
"Oplismenus","Poaceae","Poales",0,0,3,7,3,0
"Oplonia","Acanthaceae","Lamiales",1,0,0,17,1,1
"Oplopanax","Araliaceae","Apiales",2,0,0,3,2,1
"Opopanax","Apiaceae","Apiales",0,0,0,3,0,NA
"Opophytum","Aizoaceae","Caryophyllales",0,0,0,5,0,NA
"Oporinia","Asteraceae","Asterales",0,0,0,1,0,NA
"Opuntia","Cactaceae","Caryophyllales",11,0,1,194,12,0.916666666666667
"Orania","Arecaceae","Arecales",3,0,0,18,3,1
"Oraniopsis","Arecaceae","Arecales",1,0,0,1,1,1
"Orbea","Apocynaceae","Gentianales",0,0,0,30,0,NA
"Orbeanthus","Apocynaceae","Gentianales",0,0,0,2,0,NA
"Orbeopsis","Apocynaceae","Gentianales",0,0,0,5,0,NA
"Orbexilum","Fabaceae","Fabales",1,0,0,5,1,1
"Orbivestus","Asteraceae","Asterales",0,0,0,10,0,NA
"Orchidactyla","Orchidaceae","Asparagales",0,0,0,5,0,NA
"Orchidactylorhiza","Orchidaceae","Asparagales",0,0,0,1,0,NA
"Orchidantha","Lowiaceae","Zingiberales",0,0,3,17,3,0
"Orchigymnadenia","Orchidaceae","Asparagales",0,0,0,1,0,NA
"Orchimantoglossum","Orchidaceae","Asparagales",0,0,0,1,0,NA
"Orchinea","Orchidaceae","Asparagales",0,0,0,2,0,NA
"Orchipedum","Orchidaceae","Asparagales",0,0,0,3,0,NA
"Orchiplatanthera","Orchidaceae","Asparagales",0,0,0,1,0,NA
"Orchis","Orchidaceae","Asparagales",0,0,2,61,2,0
"Orchiserapias","Orchidaceae","Asparagales",0,0,0,1,0,NA
"Orcuttia","Poaceae","Poales",0,0,1,5,1,0
"Oreanthes","Ericaceae","Ericales",0,0,0,7,0,NA
"Orectanthe","Xyridaceae","Poales",0,0,1,2,1,0
"Oreinotinus","Adoxaceae","Dipsacales",0,0,0,3,0,NA
"Oreithales","Ranunculaceae","Ranunculales",0,0,0,1,0,NA
"Oreobambos","Poaceae","Poales",0,0,0,1,0,NA
"Oreoblastus","Brassicaceae","Brassicales",0,0,0,1,0,NA
"Oreobliton","Amaranthaceae","Caryophyllales",1,0,0,1,1,1
"Oreobolopsis","Cyperaceae","Poales",0,0,3,3,3,0
"Oreobolus","Cyperaceae","Poales",0,0,6,17,6,0
"Oreobroma","Montiaceae","Caryophyllales",0,0,0,1,0,NA
"Oreocallis","Ericaceae",NA,0,0,0,1,0,NA
"Oreocallis","Proteaceae","Proteales",1,0,0,1,1,1
"Oreocarya","Boraginaceae","UnknownOrder-Boraginaceae",0,0,0,16,0,NA
"Oreocereus","Cactaceae","Caryophyllales",0,0,0,11,0,NA
"Oreocharis","Gesneriaceae","Lamiales",0,0,0,55,0,NA
"Oreochloa","Poaceae","Poales",0,0,1,4,1,0
"Oreochrysum","Asteraceae","Asterales",0,0,0,1,0,NA
"Oreocnide","Urticaceae","Rosales",1,0,0,10,1,1
"Oreocomopsis","Apiaceae","Apiales",0,0,0,1,0,NA
"Oreodaphne","Lauraceae","Laurales",0,0,0,6,0,NA
"Oreogrammitis","Polypodiaceae","Polypodiales",0,0,0,8,0,NA
"Oreoleysera","Asteraceae","Asterales",1,0,0,1,1,1
"Oreoloma","Brassicaceae","Brassicales",0,1,0,3,0,NA
"Oreomunnea","Juglandaceae","Fagales",2,0,0,3,2,1
"Oreomyrrhis","Apiaceae","Apiales",0,0,1,4,1,0
"Oreonana","Apiaceae","Apiales",0,0,0,3,0,NA
"Oreopanax","Araliaceae","Apiales",6,0,0,152,6,1
"Oreophysa","Fabaceae","Fabales",0,0,0,2,0,NA
"Oreophyton","Brassicaceae","Brassicales",0,0,0,1,0,NA
"Oreopolus","Rubiaceae","Gentianales",0,0,1,1,1,0
"Oreopteris","Thelypteridaceae","Polypodiales",0,0,1,2,1,0
"Oreorchis","Orchidaceae","Asparagales",0,0,0,16,0,NA
"Oreoschimperella","Apiaceae","Apiales",0,0,0,2,0,NA
"Oreosolen","Scrophulariaceae","Lamiales",0,0,1,1,1,0
"Oreostemma","Asteraceae","Asterales",0,0,0,3,0,NA
"Oreostylidium","Stylidiaceae","Asterales",0,0,1,1,1,0
"Oreosyce","Cucurbitaceae","Cucurbitales",0,0,1,1,1,0
"Oreotrys","Saxifragaceae","Saxifragales",0,0,0,1,0,NA
"Oreoxis","Apiaceae","Apiales",0,0,0,3,0,NA
"Oresbia","Asteraceae","Asterales",0,0,0,1,0,NA
"Oresitrophe","Saxifragaceae","Saxifragales",0,0,0,1,0,NA
"Orestias","Orchidaceae","Asparagales",0,0,0,4,0,NA
"Orfilea","Euphorbiaceae","Malpighiales",0,0,0,4,0,NA
"Oriastrum","Asteraceae","Asterales",0,0,0,3,0,NA
"Oribasia","Rubiaceae","Gentianales",0,0,0,1,0,NA
"Oricia","Rutaceae","Sapindales",0,0,0,2,0,NA
"Origanum","Lamiaceae","Lamiales",0,0,4,56,4,0
"Orinus","Poaceae","Poales",0,0,1,4,1,0
"Orites","Proteaceae","Proteales",0,0,0,2,0,NA
"Oritrophium","Asteraceae","Asterales",0,0,1,18,1,0
"Orixa","Rutaceae","Sapindales",0,0,0,1,0,NA
"Orlaya","Apiaceae","Apiales",0,0,1,4,1,0
"Orleanesia","Orchidaceae","Asparagales",0,0,2,9,2,0
"Ormocarpopsis","Fabaceae","Fabales",0,0,0,6,0,NA
"Ormocarpum","Fabaceae","Fabales",1,0,0,23,1,1
"Ormoloma","Lindsaeaceae","Polypodiales",0,0,0,1,0,NA
"Ormosia","Fabaceae","Fabales",37,0,0,122,37,1
"Ormosolenia","Apiaceae","Apiales",0,0,0,1,0,NA
"Ornduffia","Menyanthaceae","Asterales",0,0,4,6,4,0
"Ornichia","Gentianaceae","Gentianales",0,0,0,3,0,NA
"Ornithidium","Orchidaceae","Asparagales",0,0,13,57,13,0
"Ornithoboea","Gesneriaceae","Lamiales",0,0,1,5,1,0
"Ornithocarpa","Brassicaceae","Brassicales",0,0,0,2,0,NA
"Ornithocephalus","Orchidaceae","Asparagales",0,0,3,56,3,0
"Ornithochilus","Orchidaceae","Asparagales",0,0,1,3,1,0
"Ornithocidium","Orchidaceae","Asparagales",0,0,0,1,0,NA
"Ornithogalum","Asparagaceae","Asparagales",0,0,16,190,16,0
"Ornithoglossum","Colchicaceae","Liliales",0,0,2,8,2,0
"Ornithopodium","Fabaceae","Fabales",0,0,0,4,0,NA
"Ornithopteris","Anemiaceae","Schizaeales",0,0,0,1,0,NA
"Ornithopus","Fabaceae","Fabales",0,0,2,6,2,0
"Ornithostaphylos","Ericaceae","Ericales",1,0,0,1,1,1
"Orobanche","Orobanchaceae","Lamiales",0,0,4,119,4,0
"Orobus","Fabaceae","Fabales",0,0,0,1,0,NA
"Orochaenactis","Asteraceae","Asterales",0,0,0,1,0,NA
"Orogenia","Apiaceae","Apiales",0,0,0,3,0,NA
"Orontium","Araceae","Alismatales",0,0,1,1,1,0
"Oropetium","Poaceae","Poales",0,0,0,6,0,NA
"Orophaca","Fabaceae","Fabales",0,0,0,8,0,NA
"Orophea","Annonaceae","Magnoliales",9,0,0,50,9,1
"Orophochilus","Acanthaceae","Lamiales",0,0,0,1,0,NA
"Orostachys","Crassulaceae","Saxifragales",0,0,2,12,2,0
"Orothamnus","Proteaceae","Proteales",1,0,0,1,1,1
"Oroxylum","Bignoniaceae","Lamiales",1,0,0,1,1,1
"Oroya","Cactaceae","Caryophyllales",0,0,0,3,0,NA
"Orphanodendron","Fabaceae","Fabales",0,0,0,2,0,NA
"Orphium","Gentianaceae","Gentianales",0,0,0,1,0,NA
"Ortachne","Poaceae","Poales",0,0,0,3,0,NA
"Ortegia","Caryophyllaceae","Caryophyllales",0,0,0,1,0,NA
"Ortegocactus","Cactaceae","Caryophyllales",0,0,0,1,0,NA
"Orthaea","Ericaceae","Ericales",0,0,0,34,0,NA
"Orthanthera","Apocynaceae","Gentianales",0,0,0,6,0,NA
"Orthilia","Ericaceae","Ericales",0,0,1,2,1,0
"Orthion","Violaceae","Malpighiales",1,0,0,5,1,1
"Orthiopteris","Saccolomataceae","Polypodiales",0,0,0,2,0,NA
"Orthocarpus","Orobanchaceae","Lamiales",0,0,0,9,0,NA
"Orthoceras","Orchidaceae","Asparagales",0,0,1,2,1,0
"Orthoclada","Poaceae","Poales",0,0,1,2,1,0
"Orthogramma","Blechnaceae","Polypodiales",0,0,0,1,0,NA
"Orthogynium","Menispermaceae","Ranunculales",0,0,0,1,0,NA
"Ortholoma","Gesneriaceae","Lamiales",0,0,0,1,0,NA
"Orthomene","Menispermaceae","Ranunculales",0,2,0,4,0,NA
"Orthopappus","Asteraceae","Asterales",0,0,0,1,0,NA
"Orthophytum","Bromeliaceae","Poales",0,0,0,68,0,NA
"Orthopichonia","Apocynaceae","Gentianales",0,0,0,6,0,NA
"Orthopterum","Aizoaceae","Caryophyllales",0,0,0,2,0,NA
"Orthopterygium","Anacardiaceae","Sapindales",1,0,0,1,1,1
"Orthosia","Apocynaceae","Gentianales",0,0,0,32,0,NA
"Orthosiphon","Lamiaceae","Lamiales",0,0,0,40,0,NA
"Orthosphenia","Celastraceae","Celastrales",0,0,0,1,0,NA
"Orthrosanthus","Iridaceae","Asparagales",0,0,8,9,8,0
"Orthurus","Rosaceae","Rosales",0,0,0,1,0,NA
"Orychophragmus","Brassicaceae","Brassicales",0,0,1,3,1,0
"Oryctanthus","Loranthaceae","Santalales",3,0,0,15,3,1
"Oryctes","Solanaceae","Solanales",0,0,0,1,0,NA
"Oryctina","Loranthaceae","Santalales",0,0,0,9,0,NA
"Oryticum","Poaceae","Poales",0,0,0,1,0,NA
"Oryxis","Fabaceae","Fabales",0,0,0,1,0,NA
"Oryza","Poaceae","Poales",0,0,6,18,6,0
"Oryzidium","Poaceae","Poales",0,0,0,1,0,NA
"Oryzopsis","Poaceae","Poales",0,0,5,9,5,0
"Osa","Rubiaceae","Gentianales",0,0,0,1,0,NA
"Osbeckia","Melastomataceae","Myrtales",0,1,1,11,1,0
"Osbertia","Asteraceae","Asterales",0,0,0,4,0,NA
"Osbornia","Myrtaceae","Myrtales",1,0,0,1,1,1
"Oschatzia","Apiaceae","Apiales",0,0,0,1,0,NA
"Oscularia","Aizoaceae","Caryophyllales",0,0,0,2,0,NA
"Oserya","Podostemaceae","Malpighiales",0,0,1,7,1,0
"Osmadenia","Asteraceae","Asterales",0,0,0,1,0,NA
"Osmanthus","Oleaceae","Lamiales",14,0,0,36,14,1
"Osmiopsis","Asteraceae","Asterales",0,0,0,1,0,NA
"Osmitopsis","Asteraceae","Asterales",1,0,0,9,1,1
"Osmorhiza","Apiaceae","Apiales",0,0,3,15,3,0
"Osmoxylon","Araliaceae","Apiales",3,0,0,60,3,1
"Osmunda","Osmundaceae","Osmundales",0,0,4,10,4,0
"Osmundastrum","Osmundaceae","Osmundales",0,0,0,2,0,NA
"Ossaea","Melastomataceae","Myrtales",3,0,0,45,3,1
"Ossiculum","Orchidaceae","Asparagales",0,0,0,1,0,NA
"Osteocarpum","Amaranthaceae","Caryophyllales",1,0,0,5,1,1
"Osteomeles","Rosaceae","Rosales",1,0,0,2,1,1
"Osteophloeum","Myristicaceae","Magnoliales",1,0,0,1,1,1
"Osteospermum","Asteraceae","Asterales",0,1,1,47,1,0
"Ostericum","Apiaceae","Apiales",0,0,1,2,1,0
"Ostodes","Euphorbiaceae","Malpighiales",1,0,0,2,1,1
"Ostrowskia","Campanulaceae","Asterales",0,0,0,1,0,NA
"Ostrya","Betulaceae","Fagales",5,0,0,9,5,1
"Ostryocarpus","Fabaceae","Fabales",0,0,0,2,0,NA
"Ostryopsis","Betulaceae","Fagales",1,0,0,3,1,1
"Osyridicarpos","Santalaceae","Santalales",0,0,0,1,0,NA
"Osyris","Santalaceae","Santalales",2,0,0,3,2,1
"Otachyrium","Poaceae","Poales",0,0,1,8,1,0
"Otanthus","Asteraceae","Asterales",0,0,0,1,0,NA
"Otatea","Poaceae","Poales",1,0,0,4,1,1
"Oteiza","Asteraceae","Asterales",0,0,1,4,1,0
"Othake","Asteraceae","Asterales",0,0,0,1,0,NA
"Otholobium","Fabaceae","Fabales",2,0,0,50,2,1
"Othonna","Asteraceae","Asterales",1,0,0,110,1,1
"Otiophora","Rubiaceae","Gentianales",1,0,1,18,2,0.5
"Otites","Caryophyllaceae","Caryophyllales",0,0,0,1,0,NA
"Otoba","Myristicaceae","Magnoliales",6,0,0,8,6,1
"Otocarpus","Brassicaceae","Brassicales",0,0,0,1,0,NA
"Otochilus","Orchidaceae","Asparagales",0,0,1,5,1,0
"Otoglossum","Orchidaceae","Asparagales",0,0,3,15,3,0
"Otomeria","Rubiaceae","Gentianales",0,0,1,8,1,0
"Otonephelium","Sapindaceae","Sapindales",1,0,0,1,1,1
"Otopappus","Asteraceae","Asterales",1,0,0,17,1,1
"Otophora","Sapindaceae","Sapindales",0,0,0,1,0,NA
"Otoptera","Fabaceae","Fabales",0,0,0,2,0,NA
"Otospermum","Asteraceae","Asterales",0,0,0,1,0,NA
"Otostegia","Lamiaceae","Lamiales",1,0,0,10,1,1
"Otostylis","Orchidaceae","Asparagales",0,0,1,4,1,0
"Ottelia","Hydrocharitaceae","Alismatales",0,0,4,19,4,0
"Ottleya","Fabaceae","Fabales",0,0,0,12,0,NA
"Ottoa","Apiaceae","Apiales",0,0,0,1,0,NA
"Ottochloa","Poaceae","Poales",0,0,0,3,0,NA
"Ottonia","Piperaceae","Piperales",0,0,0,6,0,NA
"Ottoschmidtia","Rubiaceae","Gentianales",0,0,0,1,0,NA
"Ottoschulzia","Icacinaceae","UnknownOrder-Icacinaceae",2,0,0,3,2,1
"Ottosonderia","Aizoaceae","Caryophyllales",0,0,0,2,0,NA
"Oubanguia","Lecythidaceae","Ericales",2,0,0,3,2,1
"Ouratea","Ochnaceae","Malpighiales",16,0,0,237,16,1
"Ourisia","Plantaginaceae","Lamiales",0,0,0,16,0,NA
"Ouvirandra","Aponogetonaceae","Alismatales",0,0,0,1,0,NA
"Ovidia","Thymelaeaceae","Malvales",2,0,0,3,2,1
"Ovieda","Lamiaceae","Lamiales",0,0,0,1,0,NA
"Oxalis","Oxalidaceae","Oxalidales",0,0,10,504,10,0
"Oxandra","Annonaceae","Magnoliales",15,0,0,27,15,1
"Oxera","Lamiaceae","Lamiales",6,1,0,20,6,1
"Oxyanthus","Rubiaceae","Gentianales",4,0,0,34,4,1
"Oxybaphus","Nyctaginaceae","Caryophyllales",0,0,0,8,0,NA
"Oxycarpha","Asteraceae","Asterales",0,0,0,1,0,NA
"Oxycaryum","Cyperaceae","Poales",0,0,1,1,1,0
"Oxyceros","Rubiaceae","Gentianales",0,0,0,12,0,NA
"Oxychloe","Juncaceae","Poales",0,0,1,5,1,0
"Oxychloris","Poaceae","Poales",0,0,1,1,1,0
"Oxycoccus","Ericaceae","Ericales",0,0,0,2,0,NA
"Oxydendrum","Ericaceae","Ericales",1,0,0,1,1,1
"Oxygonum","Polygonaceae","Caryophyllales",0,0,0,24,0,NA
"Oxygraphis","Ranunculaceae","Ranunculales",0,0,0,4,0,NA
"Oxygyne","Burmanniaceae","Dioscoreales",0,0,0,4,0,NA
"Oxylaena","Asteraceae","Asterales",0,0,0,1,0,NA
"Oxylobium","Fabaceae","Fabales",2,0,0,17,2,1
"Oxylobus","Asteraceae","Asterales",0,0,0,7,0,NA
"Oxymitra","Annonaceae","Magnoliales",0,0,0,3,0,NA
"Oxymyrrhine","Myrtaceae","Myrtales",0,0,0,4,0,NA
"Oxypappus","Asteraceae","Asterales",0,0,1,1,1,0
"Oxypetalum","Apocynaceae","Gentianales",0,1,0,123,0,NA
"Oxyphyllum","Asteraceae","Asterales",0,0,0,1,0,NA
"Oxypolis","Apiaceae","Apiales",0,0,1,9,1,0
"Oxyrhachis","Poaceae","Poales",0,0,0,1,0,NA
"Oxyrhynchus","Fabaceae","Fabales",1,0,1,3,2,0.5
"Oxyria","Polygonaceae","Caryophyllales",0,0,2,2,2,0
"Oxyspora","Melastomataceae","Myrtales",0,0,0,6,0,NA
"Oxystelma","Apocynaceae","Gentianales",0,0,0,2,0,NA
"Oxystigma","Fabaceae","Fabales",2,0,0,5,2,1
"Oxystophyllum","Orchidaceae","Asparagales",0,0,0,36,0,NA
"Oxystylis","Cleomaceae","Brassicales",0,0,0,1,0,NA
"Oxytenanthera","Poaceae","Poales",1,0,0,1,1,1
"Oxytenia","Asteraceae","Asterales",1,0,0,1,1,1
"Oxytheca","Polygonaceae","Caryophyllales",0,0,0,3,0,NA
"Oxytropis","Fabaceae","Fabales",0,0,13,586,13,0
"Oyedaea","Asteraceae","Asterales",1,0,0,20,1,1
"Oziroe","Asparagaceae","Asparagales",0,0,3,5,3,0
"Ozomelis","Saxifragaceae","Saxifragales",0,0,0,6,0,NA
"Ozoroa","Anacardiaceae","Sapindales",7,0,0,35,7,1
"Ozothamnus","Asteraceae","Asterales",6,0,1,54,7,0.857142857142857
"Pabellonia","Amaryllidaceae","Asparagales",0,0,0,2,0,NA
"Pabstia","Orchidaceae","Asparagales",0,0,2,5,2,0
"Pabstiella","Orchidaceae","Asparagales",0,0,1,29,1,0
"Pachecoa","Fabaceae","Fabales",0,0,0,1,0,NA
"Pachgerocereus","Cactaceae","Caryophyllales",0,0,0,1,0,NA
"Pachira","Malvaceae","Malvales",13,0,0,47,13,1
"Pachistima","Celastraceae","Celastrales",1,0,0,2,1,1
"Pachites","Orchidaceae","Asparagales",0,0,0,2,0,NA
"Pachyanthus","Melastomataceae","Myrtales",0,0,0,2,0,NA
"Pachycarpus","Apocynaceae","Gentianales",0,0,0,42,0,NA
"Pachycereus","Cactaceae","Caryophyllales",0,0,0,6,0,NA
"Pachycladon","Brassicaceae","Brassicales",0,0,6,10,6,0
"Pachycormus","Anacardiaceae","Sapindales",1,0,0,1,1,1
"Pachycornia","Amaranthaceae","Caryophyllales",1,0,0,1,1,1
"Pachyctenium","Apiaceae","Apiales",0,0,0,1,0,NA
"Pachycymbium","Apocynaceae","Gentianales",0,0,0,7,0,NA
"Pachyelasma","Fabaceae","Fabales",1,0,0,1,1,1
"Pachygenium","Orchidaceae","Asparagales",0,0,0,1,0,NA
"Pachygone","Menispermaceae","Ranunculales",0,0,0,5,0,NA
"Pachylaena","Asteraceae","Asterales",0,0,0,2,0,NA
"Pachyloma","Melastomataceae","Myrtales",0,0,0,4,0,NA
"Pachylophis","Onagraceae","Myrtales",0,0,0,2,0,NA
"Pachylophus","Onagraceae","Myrtales",0,0,0,1,0,NA
"Pachymitus","Brassicaceae","Brassicales",0,0,0,1,0,NA
"Pachyneurum","Brassicaceae","Brassicales",0,0,0,1,0,NA
"Pachyphytum","Crassulaceae","Saxifragales",0,0,0,17,0,NA
"Pachyplectron","Orchidaceae","Asparagales",0,0,0,3,0,NA
"Pachypleuria","Davalliaceae","Polypodiales",0,0,0,3,0,NA
"Pachypleurum","Apiaceae","Apiales",0,0,0,5,0,NA
"Pachypodanthium","Annonaceae","Magnoliales",0,0,0,1,0,NA
"Pachypodium","Apocynaceae","Gentianales",4,0,0,20,4,1
"Pachyptera","Bignoniaceae","Lamiales",2,0,0,4,2,1
"Pachypterygium","Brassicaceae","Brassicales",0,0,0,2,0,NA
"Pachyrhizus","Fabaceae","Fabales",0,0,1,5,1,0
"Pachysandra","Buxaceae","Buxales",3,0,0,3,3,1
"Pachystachys","Acanthaceae","Lamiales",1,0,0,12,1,1
"Pachystegia","Asteraceae","Asterales",0,0,0,3,0,NA
"Pachystoma","Orchidaceae","Asparagales",0,0,0,3,0,NA
"Pachystrobilus","Acanthaceae","Lamiales",0,0,0,1,0,NA
"Pachystroma","Euphorbiaceae","Malpighiales",1,0,0,1,1,1
"Pachystylidium","Euphorbiaceae","Malpighiales",0,0,0,1,0,NA
"Pachystylus","Rubiaceae","Gentianales",0,0,0,2,0,NA
"Pachythamnus","Asteraceae","Asterales",0,0,0,1,0,NA
"Pachyveria","Crassulaceae","Saxifragales",0,0,0,3,0,NA
"Packera","Asteraceae","Asterales",0,0,2,66,2,0
"Pacouria","Apocynaceae","Gentianales",1,0,0,3,1,1
"Pacourina","Asteraceae","Asterales",0,0,0,1,0,NA
"Paederia","Rubiaceae","Gentianales",3,6,0,33,3,1
"Paederotella","Plantaginaceae","Lamiales",0,0,0,3,0,NA
"Paenula","Asteraceae","Asterales",0,0,0,1,0,NA
"Paeonia","Paeoniaceae","Saxifragales",4,0,19,36,23,0.173913043478261
"Paepalanthus","Eriocaulaceae","Poales",0,0,1,424,1,0
"Paesia","Dennstaedtiaceae","Polypodiales",0,0,0,7,0,NA
"Pagamea","Rubiaceae","Gentianales",3,0,0,25,3,1
"Pagameopsis","Rubiaceae","Gentianales",1,0,0,2,1,1
"Pagesia","Plantaginaceae","Lamiales",0,0,0,1,0,NA
"Painteria","Fabaceae","Fabales",0,0,0,4,0,NA
"Pajanelia","Bignoniaceae","Lamiales",1,0,0,1,1,1
"Pakaraimaea","Dipterocarpaceae","Malvales",0,0,0,1,0,NA
"Pala","Apocynaceae","Gentianales",0,0,0,1,0,NA
"Palafoxia","Asteraceae","Asterales",0,0,1,12,1,0
"Palaoea","Sapindaceae","Sapindales",0,0,0,1,0,NA
"Palaquium","Sapotaceae","Ericales",52,0,0,120,52,1
"Palaua","Malvaceae","Malvales",0,0,0,16,0,NA
"Paleaepappus","Asteraceae","Asterales",0,0,0,1,0,NA
"Paleodicraeia","Podostemaceae","Malpighiales",0,0,0,1,0,NA
"Palhinhaea","Lycopodiaceae","Lycopodiales",0,0,8,10,8,0
"Paliavana","Gesneriaceae","Lamiales",1,0,0,8,1,1
"Palicourea","Rubiaceae","Gentianales",6,0,0,339,6,1
"Palimbia","Apiaceae","Apiales",0,0,0,2,0,NA
"Palisota","Commelinaceae","Commelinales",0,0,6,25,6,0
"Paliurus","Rhamnaceae","Rosales",2,0,0,5,2,1
"Pallenis","Asteraceae","Asterales",0,0,3,6,3,0
"Palmerella","Campanulaceae","Asterales",0,0,0,1,0,NA
"Palmorchis","Orchidaceae","Asparagales",0,0,1,22,1,0
"Paloue","Fabaceae","Fabales",0,0,0,4,0,NA
"Paloveopsis","Fabaceae","Fabales",0,0,0,1,0,NA
"Pamburus","Rutaceae","Sapindales",0,0,0,1,0,NA
"Pamianthe","Amaryllidaceae","Asparagales",0,0,1,3,1,0
"Pamphalea","Asteraceae","Asterales",0,0,0,1,0,NA
"Pamphilia","Styracaceae","Ericales",0,0,0,1,0,NA
"Panamanthus","Loranthaceae","Santalales",0,0,0,1,0,NA
"Panax","Araliaceae","Apiales",7,0,1,12,8,0.875
"Pancovia","Sapindaceae","Sapindales",4,0,0,12,4,1
"Pancratium","Amaryllidaceae","Asparagales",0,0,5,21,5,0
"Panda","Pandaceae","Malpighiales",1,0,0,1,1,1
"Pandanus","Pandanaceae","Pandanales",30,0,0,746,30,1
"Panderia","Amaranthaceae","Caryophyllales",0,0,1,1,1,0
"Pandiaka","Amaranthaceae","Caryophyllales",0,0,1,13,1,0
"Pandorea","Bignoniaceae","Lamiales",4,0,0,9,4,1
"Paneroa","Asteraceae","Asterales",0,0,0,1,0,NA
"Pangium","Achariaceae","Malpighiales",1,0,0,1,1,1
"Panicum","Poaceae","Poales",0,0,104,442,104,0
"Panisea","Orchidaceae","Asparagales",0,0,1,11,1,0
"Panopsis","Proteaceae","Proteales",7,0,0,19,7,1
"Panphalea","Asteraceae","Asterales",0,0,0,9,0,NA
"Pantacantha","Solanaceae","Solanales",0,0,0,1,0,NA
"Pantadenia","Euphorbiaceae","Malpighiales",0,0,0,1,0,NA
"Panthocarpa","Fabaceae","Fabales",0,0,0,1,0,NA
"Panurea","Fabaceae","Fabales",0,0,0,1,0,NA
"Panzeria","Solanaceae","Solanales",0,0,0,1,0,NA
"Panzerina","Lamiaceae","Lamiales",0,0,0,2,0,NA
"Papaver","Papaveraceae","Ranunculales",0,0,5,55,5,0
"Papaya","Caricaceae","Brassicales",0,0,0,4,0,NA
"Paphinia","Orchidaceae","Asparagales",0,0,1,16,1,0
"Paphiopedilum","Orchidaceae","Asparagales",0,0,7,119,7,0
"Papilionanthe","Orchidaceae","Asparagales",0,0,1,11,1,0
"Papillilabium","Orchidaceae","Asparagales",0,0,0,1,0,NA
"Pappea","Sapindaceae","Sapindales",1,0,0,1,1,1
"Pappobolus","Asteraceae","Asterales",0,0,0,23,0,NA
"Pappophorum","Poaceae","Poales",0,0,3,7,3,0
"Papuacalia","Asteraceae","Asterales",0,0,0,17,0,NA
"Papuacedrus","Cupressaceae","Cupressales",0,0,0,1,0,NA
"Papuaea","Orchidaceae","Asparagales",0,0,0,1,0,NA
"Papualthia","Annonaceae","Magnoliales",0,0,0,7,0,NA
"Papuanthes","Loranthaceae","Santalales",0,0,0,1,0,NA
"Papuechites","Apocynaceae","Gentianales",0,1,0,1,0,NA
"Paquerina","Asteraceae","Asterales",0,0,0,1,0,NA
"Parabaena","Menispermaceae","Ranunculales",0,0,1,1,1,0
"Parabambusa","Poaceae","Poales",0,0,0,1,0,NA
"Parablechnum","Blechnaceae","Polypodiales",0,0,0,1,0,NA
"Paraboea","Gesneriaceae","Lamiales",0,0,1,27,1,0
"Paracaleana","Orchidaceae","Asparagales",0,0,0,13,0,NA
"Paracalia","Asteraceae","Asterales",0,0,0,3,0,NA
"Paracalyx","Fabaceae","Fabales",0,0,0,6,0,NA
"Paracaryum","Boraginaceae","UnknownOrder-Boraginaceae",0,0,0,4,0,NA
"Paracelastrus","Celastraceae","Celastrales",0,0,0,1,0,NA
"Paracephaelis","Rubiaceae","Gentianales",1,0,0,4,1,1
"Paraceterach","Pteridaceae","Polypodiales",0,0,0,6,0,NA
"Parachimarrhis","Rubiaceae","Gentianales",0,0,0,1,0,NA
"Paracoffea","Rubiaceae","Gentianales",1,0,0,13,1,1
"Paracorynanthe","Rubiaceae","Gentianales",1,0,0,2,1,1
"Paracostus","Costaceae","Zingiberales",0,0,0,2,0,NA
"Paracroton","Euphorbiaceae","Malpighiales",1,0,0,4,1,1
"Paracryphia","Paracryphiaceae","Paracryphiales",1,0,0,1,1,1
"Paractaenum","Poaceae","Poales",0,0,1,1,1,0
"Paradavallodes","Davalliaceae","Polypodiales",0,0,0,1,0,NA
"Paradennstaedtia","Dennstaedtiaceae","Polypodiales",0,0,0,1,0,NA
"Paraderris","Fabaceae","Fabales",0,0,0,7,0,NA
"Paradisanthus","Orchidaceae","Asparagales",0,0,1,4,1,0
"Paradisea","Asparagaceae","Asparagales",0,0,0,2,0,NA
"Paradombeya","Malvaceae","Malvales",0,0,0,1,0,NA
"Paradrymonia","Gesneriaceae","Lamiales",0,0,3,31,3,0
"Paradrypetes","Rhizophoraceae","Malpighiales",1,0,0,2,1,1
"Parafaujasia","Asteraceae","Asterales",0,0,0,1,0,NA
"Parafestuca","Poaceae","Poales",0,0,0,1,0,NA
"Paragenipa","Rubiaceae","Gentianales",1,0,0,1,1,1
"Paragramma","Polypodiaceae","Polypodiales",0,0,0,1,0,NA
"Paragutzlaffia","Acanthaceae","Lamiales",0,0,0,2,0,NA
"Paragynoxys","Asteraceae","Asterales",0,0,0,11,0,NA
"Parahancornia","Apocynaceae","Gentianales",2,0,0,7,2,1
"Parahebe","Plantaginaceae","Lamiales",1,0,0,1,1,1
"Parahemionitis","Pteridaceae","Polypodiales",0,0,2,2,2,0
"Parahyparrhenia","Poaceae","Poales",0,0,0,6,0,NA
"Paraia","Lauraceae","Laurales",0,0,0,1,0,NA
"Parajubaea","Arecaceae","Arecales",2,0,0,3,2,1
"Parakaempferia","Zingiberaceae","Zingiberales",0,0,0,1,0,NA
"Parakeelya","Montiaceae","Caryophyllales",0,0,0,2,0,NA
"Paraknoxia","Rubiaceae","Gentianales",0,0,0,1,0,NA
"Parakohleria","Gesneriaceae","Lamiales",0,0,0,4,0,NA
"Paralagarosolen","Gesneriaceae","Lamiales",0,0,0,1,0,NA
"Paralamium","Lamiaceae","Lamiales",0,0,0,1,0,NA
"Paralepistemon","Convolvulaceae","Solanales",0,0,1,1,1,0
"Paraleptochilus","Polypodiaceae","Polypodiales",0,0,0,1,0,NA
"Paralophia","Orchidaceae","Asparagales",0,0,0,2,0,NA
"Paralychnophora","Asteraceae","Asterales",0,0,0,4,0,NA
"Paramachaerium","Fabaceae","Fabales",1,0,0,5,1,1
"Paramacrolobium","Fabaceae","Fabales",1,0,0,1,1,1
"Paramapania","Cyperaceae","Poales",0,0,0,8,0,NA
"Paramelhania","Malvaceae","Malvales",0,0,0,1,0,NA
"Parameria","Apocynaceae","Gentianales",0,1,0,3,0,NA
"Paramesus","Fabaceae","Fabales",0,0,0,2,0,NA
"Paramiflos","Asteraceae","Asterales",0,0,0,1,0,NA
"Paramignya","Rutaceae","Sapindales",0,0,0,2,0,NA
"Paramoltkia","Boraginaceae","UnknownOrder-Boraginaceae",0,0,0,1,0,NA
"Paramongaia","Amaryllidaceae","Asparagales",0,0,1,2,1,0
"Paramyristica","Myristicaceae","Magnoliales",0,0,0,1,0,NA
"Paranecepsia","Euphorbiaceae","Malpighiales",1,0,0,1,1,1
"Paranephelium","Sapindaceae","Sapindales",0,0,0,3,0,NA
"Paranephelius","Asteraceae","Asterales",0,0,0,7,0,NA
"Paraneurachne","Poaceae","Poales",0,0,1,1,1,0
"Paranomus","Proteaceae","Proteales",3,0,0,18,3,1
"Parantennaria","Asteraceae","Asterales",0,0,1,1,1,0
"Parapachygone","Menispermaceae","Ranunculales",0,0,0,1,0,NA
"Parapantadenia","Euphorbiaceae","Malpighiales",0,0,0,1,0,NA
"Parapentas","Rubiaceae","Gentianales",0,0,1,3,1,0
"Paraphalaenopsis","Orchidaceae","Asparagales",0,0,0,5,0,NA
"Paraphlomis","Lamiaceae","Lamiales",0,0,1,24,1,0
"Parapholis","Poaceae","Poales",0,0,2,6,2,0
"Parapiptadenia","Fabaceae","Fabales",3,0,0,6,3,1
"Parapiqueria","Asteraceae","Asterales",0,0,0,1,0,NA
"Parapodium","Apocynaceae","Gentianales",0,0,0,3,0,NA
"Parapolydora","Asteraceae","Asterales",0,0,0,1,0,NA
"Paraprenanthes","Asteraceae","Asterales",0,0,1,16,1,0
"Parapteroceras","Orchidaceae","Asparagales",0,0,1,8,1,0
"Parapteropyrum","Polygonaceae","Caryophyllales",0,0,0,1,0,NA
"Paraquilegia","Ranunculaceae","Ranunculales",0,0,0,4,0,NA
"Pararchidendron","Fabaceae","Fabales",1,0,0,1,1,1
"Pararistolochia","Aristolochiaceae","Piperales",1,0,1,10,2,0.5
"Pararuellia","Acanthaceae","Lamiales",0,0,0,6,0,NA
"Parasassafras","Lauraceae","Laurales",0,0,0,1,0,NA
"Paraselinum","Apiaceae","Apiales",0,0,0,1,0,NA
"Paraselliguea","Polypodiaceae","Polypodiales",0,0,0,1,0,NA
"Parasenecio","Asteraceae","Asterales",0,0,6,71,6,0
"Paraserianthes","Fabaceae","Fabales",2,0,0,3,2,1
"Parashorea","Dipterocarpaceae","Malvales",0,0,0,1,0,NA
"Parasicyos","Cucurbitaceae","Cucurbitales",0,0,1,2,1,0
"Parasilaus","Apiaceae","Apiales",0,0,0,1,0,NA
"Parasitaxus","Podocarpaceae","Araucariales",1,0,0,1,1,1
"Parasopubia","Scrophulariaceae","Lamiales",0,0,0,1,0,NA
"Parastemon","Chrysobalanaceae","Malpighiales",2,0,0,3,2,1
"Parastrephia","Asteraceae","Asterales",0,0,0,3,0,NA
"Parastriga","Orobanchaceae","Lamiales",0,0,0,1,0,NA
"Parastrobilanthes","Acanthaceae","Lamiales",0,0,0,1,0,NA
"Parastyrax","Styracaceae","Ericales",0,0,0,2,0,NA
"Parasyncalathium","Asteraceae","Asterales",0,0,0,1,0,NA
"Paratecoma","Bignoniaceae","Lamiales",1,0,0,1,1,1
"Paratephrosia","Fabaceae","Fabales",0,0,0,1,0,NA
"Parathelypteris","Thelypteridaceae","Polypodiales",0,0,0,27,0,NA
"Paratheria","Poaceae","Poales",0,0,0,2,0,NA
"Parathesis","Primulaceae","Ericales",6,0,0,85,6,1
"Pardoglossum","Boraginaceae","UnknownOrder-Boraginaceae",0,0,1,4,1,0
"Parentucellia","Orobanchaceae","Lamiales",0,0,1,2,1,0
"Parepigynum","Apocynaceae","Gentianales",0,0,0,1,0,NA
"Pariana","Poaceae","Poales",0,0,1,29,1,0
"Parietaria","Urticaceae","Rosales",0,0,2,14,2,0
"Parinari","Chrysobalanaceae","Malpighiales",17,0,0,39,17,1
"Paris","Melanthiaceae","Liliales",0,0,9,27,9,0
"Paritium","Malvaceae","Malvales",0,0,0,1,0,NA
"Parkia","Fabaceae","Fabales",22,0,0,39,22,1
"Parkinsonia","Fabaceae","Fabales",3,0,0,9,3,1
"Parlatoria","Brassicaceae","Brassicales",0,0,1,2,1,0
"Parmentiera","Bignoniaceae","Lamiales",1,0,0,10,1,1
"Parnassia","Celastraceae","Celastrales",0,0,8,72,8,0
"Parochetus","Fabaceae","Fabales",0,0,1,2,1,0
"Parodia","Cactaceae","Caryophyllales",1,0,0,82,1,1
"Parodianthus","Verbenaceae","Lamiales",0,0,0,2,0,NA
"Parodiodendron","Picrodendraceae","Malpighiales",0,0,0,1,0,NA
"Parodiodoxa","Brassicaceae","Brassicales",0,0,0,1,0,NA
"Parodiolyra","Poaceae","Poales",0,0,0,5,0,NA
"Parolinia","Brassicaceae","Brassicales",0,0,0,5,0,NA
"Paronychia","Caryophyllaceae","Caryophyllales",0,0,1,72,1,0
"Paropsia","Passifloraceae","Malpighiales",0,0,0,11,0,NA
"Paropsiopsis","Passifloraceae","Malpighiales",0,0,0,1,0,NA
"Parosela","Fabaceae","Fabales",0,0,0,11,0,NA
"Parrotia","Hamamelidaceae","Saxifragales",1,0,0,1,1,1
"Parrotiopsis","Hamamelidaceae","Saxifragales",1,0,0,2,1,1
"Parrya","Brassicaceae","Brassicales",0,0,0,35,0,NA
"Parryella","Fabaceae","Fabales",0,0,0,1,0,NA
"Parsonsia","Apocynaceae","Gentianales",19,0,0,87,19,1
"Parsonsia","Lythraceae",NA,0,0,0,2,0,NA
"Parthenice","Asteraceae","Asterales",0,0,0,1,0,NA
"Parthenium","Asteraceae","Asterales",0,0,1,14,1,0
"Parthenocissus","Vitaceae","Vitales",1,0,0,13,1,1
"Parthenoxylon","Lauraceae","Laurales",0,0,0,1,0,NA
"Parvisedum","Crassulaceae","Saxifragales",0,0,0,4,0,NA
"Pasaccardoa","Asteraceae","Asterales",0,0,0,4,0,NA
"Pascalia","Asteraceae","Asterales",0,0,0,1,0,NA
"Pasithea","Xanthorrhoeaceae","Asparagales",0,0,1,1,1,0
"Paspalidium","Poaceae","Poales",0,0,9,34,9,0
"Paspalum","Poaceae","Poales",0,0,30,329,30,0
"Passerina","Thymelaeaceae","Malvales",9,0,0,21,9,1
"Passiflora","Passifloraceae","Malpighiales",6,1,4,513,10,0.6
"Passovia","Loranthaceae","Santalales",0,0,0,1,0,NA
"Pastinaca","Apiaceae","Apiales",0,0,1,5,1,0
"Patagonica","Boraginaceae","UnknownOrder-Boraginaceae",1,0,0,1,1,1
"Patagonium","Fabaceae","Fabales",0,0,0,25,0,NA
"Patania","Dennstaedtiaceae","Polypodiales",0,0,0,1,0,NA
"Patellifolia","Amaranthaceae","Caryophyllales",0,0,1,1,1,0
"Patersonia","Iridaceae","Asparagales",0,0,6,19,6,0
"Patima","Rubiaceae","Gentianales",0,0,0,2,0,NA
"Patinoa","Malvaceae","Malvales",1,0,0,4,1,1
"Patosia","Juncaceae","Poales",0,0,1,1,1,0
"Patrinia","Caprifoliaceae","Dipsacales",0,0,4,12,4,0
"Pauldopia","Bignoniaceae","Lamiales",0,0,0,1,0,NA
"Paulia","Apiaceae","Apiales",0,0,0,1,0,NA
"Paullinia","Sapindaceae","Sapindales",37,0,0,167,37,1
"Paulownia","Paulowniaceae","Lamiales",6,0,0,7,6,1
"Pauridia","Hypoxidaceae","Asparagales",0,0,1,2,1,0
"Pauridiantha","Rubiaceae","Gentianales",2,0,0,50,2,1
"Paurolepis","Asteraceae","Asterales",0,0,0,1,0,NA
"Pausandra","Euphorbiaceae","Malpighiales",2,0,0,8,2,1
"Pausinystalia","Rubiaceae","Gentianales",5,0,0,5,5,1
"Pavetta","Rubiaceae","Gentianales",11,0,0,358,11,1
"Pavieasia","Sapindaceae","Sapindales",1,0,0,3,1,1
"Pavonia","Malvaceae","Malvales",8,0,1,250,9,0.888888888888889
"Paxia","Connaraceae","Oxalidales",0,0,0,3,0,NA
"Paxistima","Celastraceae","Celastrales",1,0,0,2,1,1
"Payena","Sapotaceae","Ericales",11,0,0,20,11,1
"Payera","Rubiaceae","Gentianales",0,0,0,10,0,NA
"Payeria","Meliaceae","Sapindales",0,0,0,1,0,NA
"Paypayrola","Violaceae","Malpighiales",3,0,0,6,3,1
"Paysonia","Brassicaceae","Brassicales",0,0,0,8,0,NA
"Pearcea","Gesneriaceae","Lamiales",0,0,1,16,1,0
"Pearsonia","Fabaceae","Fabales",0,0,0,12,0,NA
"Pechuel-loeschea","Asteraceae","Asterales",1,0,0,1,1,1
"Peckia","Primulaceae","Ericales",0,0,0,3,0,NA
"Pecluma","Polypodiaceae","Polypodiales",0,0,0,36,0,NA
"Pecteilis","Orchidaceae","Asparagales",0,0,0,8,0,NA
"Pectiantia","Saxifragaceae","Saxifragales",0,0,0,3,0,NA
"Pectinaria","Apocynaceae","Gentianales",0,0,0,10,0,NA
"Pectis","Asteraceae","Asterales",0,0,0,93,0,NA
"Pectocarya","Boraginaceae","UnknownOrder-Boraginaceae",0,0,0,11,0,NA
"Pedaliodiscus","Pedaliaceae","Lamiales",0,0,0,1,0,NA
"Pedalium","Pedaliaceae","Lamiales",0,0,0,1,0,NA
"Peddiea","Thymelaeaceae","Malvales",2,0,0,14,2,1
"Pedersenia","Amaranthaceae","Caryophyllales",0,0,0,3,0,NA
"Pedicellarum","Araceae","Alismatales",0,0,0,1,0,NA
"Pedicularis","Orobanchaceae","Lamiales",0,0,17,484,17,0
"Pedilochilus","Orchidaceae","Asparagales",0,0,0,36,0,NA
"Pediocactus","Cactaceae","Caryophyllales",0,0,0,10,0,NA
"Pediomelum","Fabaceae","Fabales",0,0,0,11,0,NA
"Pedistylis","Loranthaceae","Santalales",0,0,0,1,0,NA
"Pedrosia","Fabaceae","Fabales",0,0,0,1,0,NA
"Peersia","Aizoaceae","Caryophyllales",0,0,0,1,0,NA
"Pegaeophyton","Brassicaceae","Brassicales",0,0,0,7,0,NA
"Peganum","Nitrariaceae","Sapindales",0,0,2,4,2,0
"Pegia","Anacardiaceae","Sapindales",1,0,0,2,1,1
"Pegolettia","Asteraceae","Asterales",2,0,0,9,2,1
"Pehria","Lythraceae","Myrtales",0,0,0,1,0,NA
"Peiranisia","Fabaceae","Fabales",0,0,0,2,0,NA
"Peixotoa","Malpighiaceae","Malpighiales",5,0,0,29,5,1
"Pelagodoxa","Arecaceae","Arecales",0,0,0,1,0,NA
"Pelargonium","Geraniaceae","Geraniales",12,4,3,250,15,0.8
"Pelatantheria","Orchidaceae","Asparagales",0,0,2,8,2,0
"Pelea","Rutaceae","Sapindales",0,0,0,68,0,NA
"Pelecynthis","Fabaceae","Fabales",0,0,0,1,0,NA
"Pelecyphora","Cactaceae","Caryophyllales",0,0,0,2,0,NA
"Pelexia","Orchidaceae","Asparagales",0,0,0,78,0,NA
"Peliosanthes","Asparagaceae","Asparagales",0,0,3,18,3,0
"Peliostomum","Scrophulariaceae","Lamiales",0,0,1,7,1,0
"Pellacalyx","Rhizophoraceae","Malpighiales",0,0,0,1,0,NA
"Pellaea","Pteridaceae","Polypodiales",0,0,7,50,7,0
"Pellegrinia","Ericaceae","Ericales",0,0,0,6,0,NA
"Pellegriniodendron","Fabaceae","Fabales",0,0,0,1,0,NA
"Pelletiera","Primulaceae","Ericales",0,0,0,1,0,NA
"Pelliciera","Tetrameristaceae","Ericales",1,0,0,1,1,1
"Pellionia","Urticaceae","Rosales",0,0,0,22,0,NA
"Pelozia","Onagraceae","Myrtales",0,0,0,1,0,NA
"Peltaea","Malvaceae","Malvales",0,0,0,18,0,NA
"Peltandra","Araceae","Alismatales",0,0,1,2,1,0
"Peltanthera","Gesneriaceae","Lamiales",1,0,0,1,1,1
"Peltapteris","Dryopteridaceae","Polypodiales",0,0,0,1,0,NA
"Peltaria","Brassicaceae","Brassicales",0,0,0,4,0,NA
"Peltariopsis","Brassicaceae","Brassicales",0,0,0,2,0,NA
"Peltastes","Apocynaceae","Gentianales",2,0,0,10,2,1
"Peltidium","Asteraceae","Asterales",0,0,0,1,0,NA
"Peltiera","Fabaceae","Fabales",0,0,0,2,0,NA
"Peltoboykinia","Saxifragaceae","Saxifragales",0,0,1,1,1,0
"Peltocalathos","Ranunculaceae","Ranunculales",0,0,1,1,1,0
"Peltodon","Lamiaceae","Lamiales",0,0,0,5,0,NA
"Peltogyne","Fabaceae","Fabales",14,0,0,25,14,1
"Peltophorum","Fabaceae","Fabales",5,0,0,10,5,1
"Peltophyllum","Triuridaceae","Pandanales",0,0,0,2,0,NA
"Peltostigma","Rutaceae","Sapindales",0,0,0,2,0,NA
"Pelucha","Asteraceae","Asterales",0,0,0,1,0,NA
"Pembertonia","Asteraceae","Asterales",0,0,0,1,0,NA
"Pemphis","Lythraceae","Myrtales",1,0,0,2,1,1
"Penaea","Penaeaceae","Myrtales",4,0,0,4,4,1
"Penducella","Orchidaceae","Asparagales",0,0,0,1,0,NA
"Penianthus","Menispermaceae","Ranunculales",1,0,0,3,1,1
"Peniocereus","Cactaceae","Caryophyllales",0,0,0,19,0,NA
"Peniophyllum","Onagraceae","Myrtales",0,0,0,1,0,NA
"Penkimia","Orchidaceae","Asparagales",0,0,0,1,0,NA
"Pennellia","Brassicaceae","Brassicales",0,0,2,10,2,0
"Pennellianthus","Plantaginaceae","Lamiales",0,0,0,1,0,NA
"Pennilabium","Orchidaceae","Asparagales",0,0,0,15,0,NA
"Pennisetum","Poaceae","Poales",0,0,11,83,11,0
"Penstemon","Plantaginaceae","Lamiales",7,8,12,301,19,0.368421052631579
"Pentabrachion","Phyllanthaceae","Malpighiales",1,0,0,1,1,1
"Pentacalia","Asteraceae","Asterales",1,0,0,223,1,1
"Pentaceras","Rutaceae","Sapindales",1,0,0,1,1,1
"Pentachaeta","Asteraceae","Asterales",0,0,0,5,0,NA
"Pentachlaena","Sarcolaenaceae","Malvales",0,0,0,3,0,NA
"Pentachondra","Ericaceae","Ericales",1,0,0,1,1,1
"Pentaclethra","Fabaceae","Fabales",3,0,0,3,3,1
"Pentacme","Dipterocarpaceae","Malvales",0,0,0,1,0,NA
"Pentactina","Rosaceae","Rosales",0,0,0,1,0,NA
"Pentacyphus","Apocynaceae","Gentianales",0,0,0,2,0,NA
"Pentadesma","Clusiaceae","Malpighiales",2,0,0,2,2,1
"Pentadiplandra","Pentadiplandraceae","Brassicales",1,0,0,1,1,1
"Pentaglottis","Boraginaceae","UnknownOrder-Boraginaceae",0,0,1,1,1,0
"Pentagonia","Rubiaceae","Gentianales",3,0,0,37,3,1
"Pentagramma","Pteridaceae","Polypodiales",0,0,0,2,0,NA
"Pentalepis","Asteraceae","Asterales",0,0,0,2,0,NA
"Pentalinon","Apocynaceae","Gentianales",0,0,0,2,0,NA
"Pentaloncha","Rubiaceae","Gentianales",0,0,0,2,0,NA
"Pentalophus","Boraginaceae","UnknownOrder-Boraginaceae",0,0,0,2,0,NA
"Pentameris","Poaceae","Poales",1,0,0,10,1,1
"Pentamerista","Tetrameristaceae","Ericales",1,0,0,1,1,1
"Pentanema","Asteraceae","Asterales",0,1,0,21,0,NA
"Pentanisia","Rubiaceae","Gentianales",1,0,2,19,3,0.333333333333333
"Pentanopsis","Rubiaceae","Gentianales",1,0,0,2,1,1
"Pentapanax","Araliaceae","Apiales",0,0,0,1,0,NA
"Pentapeltis","Apiaceae","Apiales",0,0,0,1,0,NA
"Pentapetes","Malvaceae","Malvales",0,0,0,1,0,NA
"Pentaphragma","Pentaphragmataceae","Asterales",0,0,0,2,0,NA
"Pentaphylax","Pentaphylacaceae","Ericales",1,0,0,1,1,1
"Pentaphylloides","Rosaceae","Rosales",0,0,0,1,0,NA
"Pentaphyllum","Rosaceae","Rosales",0,0,0,1,0,NA
"Pentaplaris","Malvaceae","Malvales",2,0,0,3,2,1
"Pentapleura","Lamiaceae","Lamiales",0,0,0,1,0,NA
"Pentapogon","Poaceae","Poales",0,0,0,1,0,NA
"Pentaptilon","Goodeniaceae","Asterales",0,0,1,1,1,0
"Pentaraphia","Gesneriaceae","Lamiales",0,0,0,1,0,NA
"Pentarhopalopilia","Opiliaceae","Santalales",0,0,0,4,0,NA
"Pentarrhaphis","Poaceae","Poales",0,0,0,3,0,NA
"Pentarrhinum","Apocynaceae","Gentianales",0,0,0,7,0,NA
"Pentas","Rubiaceae","Gentianales",1,0,0,16,1,1
"Pentasachme","Apocynaceae","Gentianales",0,0,1,1,1,0
"Pentaschistis","Poaceae","Poales",0,0,2,64,2,0
"Pentascyphus","Sapindaceae","Sapindales",0,0,0,1,0,NA
"Pentaspadon","Anacardiaceae","Sapindales",0,0,0,1,0,NA
"Pentastelma","Apocynaceae","Gentianales",0,0,0,1,0,NA
"Pentastemona","Stemonaceae","Pandanales",0,0,2,2,2,0
"Pentatrichia","Asteraceae","Asterales",0,0,0,4,0,NA
"Pentatropis","Apocynaceae","Gentianales",0,0,0,5,0,NA
"Penthorum","Penthoraceae","Saxifragales",0,0,2,2,2,0
"Pentodon","Rubiaceae","Gentianales",0,0,1,2,1,0
"Pentopetia","Apocynaceae","Gentianales",1,0,0,12,1,1
"Pentossaea","Melastomataceae","Myrtales",0,0,0,7,0,NA
"Pentstemonopsis","Plantaginaceae","Lamiales",0,0,0,1,0,NA
"Pentzia","Asteraceae","Asterales",1,0,0,23,1,1
"Peperomia","Piperaceae","Piperales",0,0,17,1161,17,0
"Peplonia","Apocynaceae","Gentianales",0,0,0,5,0,NA
"Pepo","Cucurbitaceae","Cucurbitales",0,0,0,1,0,NA
"Peponidium","Rubiaceae","Gentianales",0,0,0,47,0,NA
"Peponium","Cucurbitaceae","Cucurbitales",0,0,2,20,2,0
"Peponopsis","Cucurbitaceae","Cucurbitales",0,0,1,1,1,0
"Pera","Peraceae","Malpighiales",7,0,0,39,7,1
"Peracarpa","Campanulaceae","Asterales",0,0,0,1,0,NA
"Perakanthus","Rubiaceae","Gentianales",0,0,0,1,0,NA
"Perama","Rubiaceae","Gentianales",0,0,0,14,0,NA
"Peranema","Dryopteridaceae","Polypodiales",0,0,0,4,0,NA
"Peraphyllum","Rosaceae","Rosales",1,0,0,1,1,1
"Peraxilla","Loranthaceae","Santalales",2,0,0,2,2,1
"Perdicium","Asteraceae","Asterales",0,0,0,2,0,NA
"Perebea","Moraceae","Rosales",9,0,0,10,9,1
"Peregrina","Malpighiaceae","Malpighiales",0,0,0,1,0,NA
"Pereilema","Poaceae","Poales",0,0,0,4,0,NA
"Pereskia","Cactaceae","Caryophyllales",15,0,0,18,15,1
"Pereskiopsis","Cactaceae","Caryophyllales",2,0,0,6,2,1
"Perezia","Asteraceae","Asterales",1,0,0,36,1,1
"Pergularia","Apocynaceae","Gentianales",2,0,0,14,2,1
"Periandra","Fabaceae","Fabales",0,0,0,7,0,NA
"Perianthomega","Bignoniaceae","Lamiales",1,0,0,1,1,1
"Periballia","Poaceae","Poales",0,0,0,3,0,NA
"Periblepharis","Ochnaceae","Malpighiales",0,0,0,1,0,NA
"Pericallis","Asteraceae","Asterales",0,0,0,15,0,NA
"Pericalymma","Myrtaceae","Myrtales",1,0,0,4,1,1
"Pericalypta","Acanthaceae","Lamiales",0,0,0,1,0,NA
"Pericampylus","Menispermaceae","Ranunculales",0,0,0,2,0,NA
"Perichasma","Menispermaceae","Ranunculales",0,0,0,1,0,NA
"Perichlaena","Bignoniaceae","Lamiales",1,0,0,1,1,1
"Pericome","Asteraceae","Asterales",0,1,0,3,0,NA
"Pericopsis","Fabaceae","Fabales",4,0,0,4,4,1
"Perideridia","Apiaceae","Apiales",0,0,1,15,1,0
"Peridiscus","Peridiscaceae","Saxifragales",1,0,0,1,1,1
"Periestes","Acanthaceae","Lamiales",0,0,0,1,0,NA
"Periglossum","Apocynaceae","Gentianales",0,0,0,4,0,NA
"Perilla","Lamiaceae","Lamiales",0,0,1,1,1,0
"Perillula","Lamiaceae","Lamiales",0,0,0,1,0,NA
"Peripeplus","Rubiaceae","Gentianales",0,0,0,1,0,NA
"Peripleura","Asteraceae","Asterales",0,0,0,5,0,NA
"Periploca","Apocynaceae","Gentianales",3,1,0,15,3,1
"Periptera","Malvaceae","Malvales",0,0,0,5,0,NA
"Peripterygia","Celastraceae","Celastrales",1,0,0,1,1,1
"Perissocarpa","Ochnaceae","Malpighiales",0,0,0,3,0,NA
"Perissocoeleum","Apiaceae","Apiales",0,0,0,3,0,NA
"Peristeranthus","Orchidaceae","Asparagales",0,0,0,1,0,NA
"Peristeria","Orchidaceae","Asparagales",0,0,2,13,2,0
"Peristethium","Loranthaceae","Santalales",0,0,0,2,0,NA
"Peristrophe","Acanthaceae","Lamiales",0,0,0,20,0,NA
"Peristylus","Orchidaceae","Asparagales",0,0,0,103,0,NA
"Peritassa","Celastraceae","Celastrales",2,0,0,19,2,1
"Peritoma","Cleomaceae","Brassicales",0,0,0,1,0,NA
"Perityle","Asteraceae","Asterales",1,0,0,68,1,1
"Pernettya","Ericaceae","Ericales",0,0,0,6,0,NA
"Peronema","Lamiaceae","Lamiales",1,0,0,1,1,1
"Perotis","Poaceae","Poales",0,0,3,13,3,0
"Perovskia","Lamiaceae","Lamiales",0,0,2,9,2,0
"Perplexia","Asteraceae","Asterales",0,0,0,1,0,NA
"Perralderia","Asteraceae","Asterales",0,0,0,3,0,NA
"Perriera","Simaroubaceae","Sapindales",1,0,0,2,1,1
"Perrierbambus","Poaceae","Poales",0,0,0,2,0,NA
"Perrierodendron","Sarcolaenaceae","Malvales",0,0,0,5,0,NA
"Perrierophytum","Malvaceae","Malvales",1,0,0,3,1,1
"Perrierosedum","Crassulaceae","Saxifragales",0,0,0,1,0,NA
"Perrottetia","Dipentodontaceae","Huerteales",2,0,0,20,2,1
"Persea","Lauraceae","Laurales",25,0,0,118,25,1
"Persicaria","Polygonaceae","Caryophyllales",0,0,15,66,15,0
"Persoonia","Proteaceae","Proteales",1,0,0,9,1,1
"Pertusadina","Rubiaceae","Gentianales",3,0,0,4,3,1
"Pertya","Asteraceae","Asterales",0,0,0,25,0,NA
"Pervillaea","Apocynaceae","Gentianales",1,0,0,4,1,1
"Perymeniopsis","Asteraceae","Asterales",1,0,0,1,1,1
"Perymenium","Asteraceae","Asterales",0,0,1,49,1,0
"Pescatoria","Orchidaceae","Asparagales",0,0,7,26,7,0
"Pessopteris","Polypodiaceae","Polypodiales",0,0,0,6,0,NA
"Petalacte","Asteraceae","Asterales",1,0,0,1,1,1
"Petaladenium","Fabaceae","Fabales",0,0,0,1,0,NA
"Petalidium","Acanthaceae","Lamiales",0,0,1,34,1,0
"Petalonyx","Loasaceae","Cornales",5,0,0,6,5,1
"Petalostelma","Apocynaceae","Gentianales",0,0,0,7,0,NA
"Petalostemon","Fabaceae","Fabales",0,0,1,5,1,0
"Petalostigma","Picrodendraceae","Malpighiales",5,0,0,5,5,1
"Petalostylis","Fabaceae","Fabales",1,0,0,2,1,1
"Petasites","Asteraceae","Asterales",0,0,4,19,4,0
"Petchia","Apocynaceae","Gentianales",2,0,0,8,2,1
"Petenaea","Petenaeaceae","Huerteales",0,0,0,1,0,NA
"Peteravenia","Asteraceae","Asterales",0,0,0,6,0,NA
"Peteria","Fabaceae","Fabales",0,0,1,4,1,0
"Petermannia","Petermanniaceae","Liliales",0,0,1,1,1,0
"Peterodendron","Achariaceae","Malpighiales",0,0,0,1,0,NA
"Petersianthus","Lecythidaceae","Ericales",2,0,0,2,2,1
"Petesiodes","Primulaceae","Ericales",1,0,0,1,1,1
"Petiniotia","Brassicaceae","Brassicales",0,0,0,1,0,NA
"Petitia","Lamiaceae","Lamiales",1,0,0,2,1,1
"Petitiocodon","Rubiaceae","Gentianales",0,0,0,1,0,NA
"Petitmenginia","Orobanchaceae","Lamiales",0,0,0,2,0,NA
"Petiveria","Phytolaccaceae","Caryophyllales",0,0,0,1,0,NA
"Petopentia","Apocynaceae","Gentianales",1,0,0,1,1,1
"Petradoria","Asteraceae","Asterales",0,0,0,1,0,NA
"Petraeomyrtus","Myrtaceae","Myrtales",0,0,0,1,0,NA
"Petraeovitex","Lamiaceae","Lamiales",0,0,0,8,0,NA
"Petrea","Verbenaceae","Lamiales",2,0,0,12,2,1
"Petrobium","Asteraceae","Asterales",0,0,0,1,0,NA
"Petrocallis","Brassicaceae","Brassicales",0,0,1,1,1,0
"Petrocodon","Gesneriaceae","Lamiales",0,0,0,12,0,NA
"Petrocosmea","Gesneriaceae","Lamiales",0,0,1,23,1,0
"Petrogenia","Convolvulaceae","Solanales",0,1,0,1,0,NA
"Petromarula","Campanulaceae","Asterales",0,0,1,1,1,0
"Petronymphe","Asparagaceae","Asparagales",0,0,0,1,0,NA
"Petrophytum","Rosaceae","Rosales",1,0,0,1,1,1
"Petroravenia","Brassicaceae","Brassicales",0,0,0,1,0,NA
"Petrorhagia","Caryophyllaceae","Caryophyllales",0,0,1,19,1,0
"Petrosavia","Petrosaviaceae","Petrosaviales",0,0,2,3,2,0
"Petroselinum","Apiaceae","Apiales",0,0,2,2,2,0
"Petrosimonia","Amaranthaceae","Caryophyllales",1,0,0,9,1,1
"Petteria","Fabaceae","Fabales",1,0,0,1,1,1
"Petunia","Solanaceae","Solanales",0,0,13,21,13,0
"Peucedanum","Apiaceae","Apiales",0,0,5,114,5,0
"Peucephyllum","Asteraceae","Asterales",1,0,0,1,1,1
"Peumus","Monimiaceae","Laurales",1,0,0,1,1,1
"Peyritschia","Poaceae","Poales",0,0,0,5,0,NA
"Pezisicarpus","Apocynaceae","Gentianales",0,0,0,1,0,NA
"Pfaffia","Amaranthaceae","Caryophyllales",0,0,0,28,0,NA
"Pfeiffera","Cactaceae","Caryophyllales",2,0,0,3,2,1
"Phaca","Fabaceae","Fabales",0,0,0,9,0,NA
"Phacelia","Boraginaceae","UnknownOrder-Boraginaceae",0,0,20,186,20,0
"Phacellanthus","Orobanchaceae","Lamiales",0,0,0,1,0,NA
"Phacellaria","Santalaceae","Santalales",0,0,0,6,0,NA
"Phacellothrix","Asteraceae","Asterales",0,0,0,1,0,NA
"Phacelurus","Poaceae","Poales",0,0,3,9,3,0
"Phacocapnos","Papaveraceae","Ranunculales",0,0,0,1,0,NA
"Phaeanthus","Annonaceae","Magnoliales",2,0,0,4,2,1
"Phaedranassa","Amaryllidaceae","Asparagales",0,0,1,9,1,0
"Phaenanthoecium","Poaceae","Poales",0,0,0,1,0,NA
"Phaenocoma","Asteraceae","Asterales",0,0,0,1,0,NA
"Phaenosperma","Poaceae","Poales",0,0,1,2,1,0
"Phaeoneuron","Melastomataceae","Myrtales",0,0,0,2,0,NA
"Phaeonychium","Brassicaceae","Brassicales",1,0,0,7,1,1
"Phaeopappus","Asteraceae","Asterales",0,0,0,1,0,NA
"Phaeoptilum","Nyctaginaceae","Caryophyllales",0,0,0,1,0,NA
"Phagnalon","Asteraceae","Asterales",2,0,0,27,2,1
"Phainantha","Melastomataceae","Myrtales",0,0,0,5,0,NA
"Phaius","Orchidaceae","Asparagales",0,0,0,45,0,NA
"Phalacrachena","Asteraceae","Asterales",0,0,0,2,0,NA
"Phalacraea","Asteraceae","Asterales",0,0,0,4,0,NA
"Phalacrocarpum","Asteraceae","Asterales",0,0,0,3,0,NA
"Phalacroloma","Asteraceae","Asterales",0,0,0,1,0,NA
"Phalacroseris","Asteraceae","Asterales",0,0,0,1,0,NA
"Phalaenopsis","Orchidaceae","Asparagales",0,0,10,70,10,0
"Phalaris","Poaceae","Poales",0,0,6,19,6,0
"Phaleria","Thymelaeaceae","Malvales",8,0,0,24,8,1
"Phalocallis","Iridaceae","Asparagales",0,0,0,1,0,NA
"Phanera","Fabaceae","Fabales",0,0,0,36,0,NA
"Phanerandra","Ericaceae","Ericales",0,0,0,1,0,NA
"Phanerodiscus","Olacaceae","Santalales",0,0,0,2,0,NA
"Phaneroglossa","Asteraceae","Asterales",1,0,0,1,1,1
"Phanerophlebia","Dryopteridaceae","Polypodiales",0,0,0,11,0,NA
"Phanerophlebiopsis","Dryopteridaceae","Polypodiales",0,0,0,10,0,NA
"Phanerosorus","Matoniaceae","Gleicheniales",0,0,0,1,0,NA
"Phanerostylis","Asteraceae","Asterales",0,0,0,4,0,NA
"Phania","Asteraceae","Asterales",0,0,0,6,0,NA
"Pharbitis","Convolvulaceae","Solanales",0,0,0,3,0,NA
"Pharnaceum","Molluginaceae","Caryophyllales",0,0,0,28,0,NA
"Pharus","Poaceae","Poales",0,0,3,7,3,0
"Phaseolodes","Fabaceae","Fabales",0,0,0,36,0,NA
"Phaseolus","Fabaceae","Fabales",0,0,4,97,4,0
"Phaulopsis","Acanthaceae","Lamiales",0,0,0,18,0,NA
"Phaulothamnus","Achatocarpaceae","Caryophyllales",1,0,0,1,1,1
"Phebalium","Rutaceae","Sapindales",0,0,0,5,0,NA
"Phedimus","Crassulaceae","Saxifragales",0,0,0,4,0,NA
"Phegopteris","Thelypteridaceae","Polypodiales",0,0,3,15,3,0
"Pheidochloa","Poaceae","Poales",0,0,0,2,0,NA
"Pheidonocarpa","Gesneriaceae","Lamiales",0,0,0,1,0,NA
"Pheladenia","Orchidaceae","Asparagales",0,0,0,1,0,NA
"Phellocalyx","Rubiaceae","Gentianales",0,0,0,1,0,NA
"Phellodendron","Rutaceae","Sapindales",1,0,0,5,1,1
"Phellolophium","Apiaceae","Apiales",0,0,0,1,0,NA
"Phellopterus","Apiaceae","Apiales",0,0,0,1,0,NA
"Phelpsiella","Rapateaceae","Poales",0,0,0,1,0,NA
"Phelypaea","Orobanchaceae","Lamiales",0,0,0,2,0,NA
"Phemeranthus","Montiaceae","Caryophyllales",0,0,4,19,4,0
"Phenakospermum","Strelitziaceae","Zingiberales",0,0,0,1,0,NA
"Phenax","Urticaceae","Rosales",0,0,0,16,0,NA
"Phenianthus","Caprifoliaceae","Dipsacales",0,0,0,1,0,NA
"Pherosphaera","Podocarpaceae","Araucariales",1,0,0,2,1,1
"Pherotrichis","Apocynaceae","Gentianales",0,0,0,3,0,NA
"Phialanthus","Rubiaceae","Gentianales",1,0,0,22,1,1
"Phialiphora","Rubiaceae","Gentianales",0,0,0,2,0,NA
"Philacra","Ochnaceae","Malpighiales",0,0,0,4,0,NA
"Philactis","Asteraceae","Asterales",1,0,0,3,1,1
"Philadelphus","Hydrangeaceae","Cornales",7,0,0,66,7,1
"Philbornea","Linaceae","Malpighiales",0,0,0,1,0,NA
"Philcoxia","Scrophulariaceae","Lamiales",0,0,0,3,0,NA
"Philenoptera","Fabaceae","Fabales",1,0,0,6,1,1
"Philesia","Philesiaceae","Liliales",1,0,0,1,1,1
"Philgamia","Malpighiaceae","Malpighiales",0,0,0,4,0,NA
"Philibertia","Apocynaceae","Gentianales",0,0,0,43,0,NA
"Philippia","Ericaceae","Ericales",0,0,0,16,0,NA
"Philippiella","Caryophyllaceae","Caryophyllales",0,0,0,1,0,NA
"Phillyrea","Oleaceae","Lamiales",2,0,0,2,2,1
"Philodendron","Araceae","Alismatales",0,0,12,487,12,0
"Philodice","Eriocaulaceae","Poales",0,0,0,2,0,NA
"Philoglossa","Asteraceae","Asterales",0,0,0,2,0,NA
"Philonotion","Araceae","Alismatales",0,0,0,3,0,NA
"Philotheca","Rutaceae","Sapindales",1,0,0,15,1,1
"Philoxerus","Amaranthaceae","Caryophyllales",0,0,0,1,0,NA
"Philydrella","Philydraceae","Commelinales",0,0,1,2,1,0
"Philydrum","Philydraceae","Commelinales",0,0,1,1,1,0
"Philyra","Euphorbiaceae","Malpighiales",1,0,0,1,1,1
"Philyrophyllum","Asteraceae","Asterales",0,0,0,2,0,NA
"Phinaea","Gesneriaceae","Lamiales",0,0,1,3,1,0
"Phippsia","Poaceae","Poales",0,0,0,3,0,NA
"Phitosia","Asteraceae","Asterales",0,0,0,1,0,NA
"Phlebocarya","Haemodoraceae","Commelinales",0,0,0,3,0,NA
"Phlebodium","Polypodiaceae","Polypodiales",0,0,0,5,0,NA
"Phlebolobium","Brassicaceae","Brassicales",0,0,0,1,0,NA
"Phlegmariurus","Lycopodiaceae","Lycopodiales",0,0,12,42,12,0
"Phlegmatospermum","Brassicaceae","Brassicales",0,0,1,4,1,0
"Phleum","Poaceae","Poales",0,0,7,18,7,0
"Phloeophila","Orchidaceae","Asparagales",0,0,2,11,2,0
"Phlogacanthus","Acanthaceae","Lamiales",0,0,0,3,0,NA
"Phlojodicarpus","Apiaceae","Apiales",0,0,0,4,0,NA
"Phlomidoschema","Lamiaceae","Lamiales",0,0,0,1,0,NA
"Phlomis","Lamiaceae","Lamiales",6,0,2,113,8,0.75
"Phlomoides","Lamiaceae","Lamiales",0,0,0,139,0,NA
"Phlomostachys","Bromeliaceae","Poales",0,0,0,1,0,NA
"Phlox","Polemoniaceae","Ericales",0,3,6,85,6,0
"Phlyctidocarpa","Apiaceae","Apiales",0,0,0,1,0,NA
"Phoebanthus","Asteraceae","Asterales",0,0,2,2,2,0
"Phoebe","Lauraceae","Laurales",14,0,0,50,14,1
"Phoenicanthus","Annonaceae","Magnoliales",0,0,0,2,0,NA
"Phoenicaulis","Brassicaceae","Brassicales",0,0,1,1,1,0
"Phoenicophorium","Arecaceae","Arecales",1,0,0,1,1,1
"Phoenix","Arecaceae","Arecales",7,0,0,14,7,1
"Pholidocarpus","Arecaceae","Arecales",1,0,0,6,1,1
"Pholidostachys","Arecaceae","Arecales",4,0,0,4,4,1
"Pholidota","Orchidaceae","Asparagales",0,0,3,39,3,0
"Pholisma","Boraginaceae","UnknownOrder-Boraginaceae",0,0,1,3,1,0
"Pholistoma","Boraginaceae","UnknownOrder-Boraginaceae",0,0,1,3,1,0
"Pholiurus","Poaceae","Poales",0,0,0,1,0,NA
"Phoradendron","Santalaceae","Santalales",5,0,0,269,5,1
"Phormium","Xanthorrhoeaceae","Asparagales",0,0,2,2,2,0
"Photinia","Rosaceae","Rosales",9,0,0,46,9,1
"Photinopteris","Polypodiaceae","Polypodiales",0,0,0,1,0,NA
"Phragmanthera","Loranthaceae","Santalales",2,0,0,34,2,1
"Phragmipedium","Orchidaceae","Asparagales",0,0,5,27,5,0
"Phragmites","Poaceae","Poales",0,0,2,4,2,0
"Phragmocarpidium","Malvaceae","Malvales",0,0,0,1,0,NA
"Phragmorchis","Orchidaceae","Asparagales",0,0,0,1,0,NA
"Phragmotheca","Malvaceae","Malvales",1,0,0,5,1,1
"Phreatia","Orchidaceae","Asparagales",0,0,1,211,1,0
"Phrodus","Solanaceae","Solanales",0,0,0,1,0,NA
"Phrygilanthus","Loranthaceae","Santalales",0,0,0,3,0,NA
"Phryma","Phrymaceae","Lamiales",0,0,1,1,1,0
"Phrynium","Marantaceae","Zingiberales",0,0,1,38,1,0
"Phtheirospermum","Orobanchaceae","Lamiales",0,0,0,5,0,NA
"Phthirusa","Loranthaceae","Santalales",1,0,0,28,1,1
"Phuopsis","Rubiaceae","Gentianales",0,0,1,1,1,0
"Phycella","Amaryllidaceae","Asparagales",0,0,2,5,2,0
"Phygelius","Scrophulariaceae","Lamiales",0,0,0,2,0,NA
"Phyla","Verbenaceae","Lamiales",0,0,0,13,0,NA
"Phylacium","Fabaceae","Fabales",0,0,1,2,1,0
"Phylica","Rhamnaceae","Rosales",2,0,0,145,2,1
"Phyllacanthus","Rubiaceae","Gentianales",0,0,0,1,0,NA
"Phyllachne","Stylidiaceae","Asterales",0,0,1,1,1,0
"Phyllactis","Caprifoliaceae","Dipsacales",0,0,0,4,0,NA
"Phyllagathis","Melastomataceae","Myrtales",0,0,0,25,0,NA
"Phyllanoa","Violaceae","Malpighiales",0,0,0,1,0,NA
"Phyllanthera","Apocynaceae","Gentianales",0,0,0,1,0,NA
"Phyllanthopsis","Phyllanthaceae","Malpighiales",2,0,0,2,2,1
"Phyllanthus","Phyllanthaceae","Malpighiales",59,2,18,936,77,0.766233766233766
"Phyllarthron","Bignoniaceae","Lamiales",2,0,0,18,2,1
"Phyllis","Rubiaceae","Gentianales",1,0,0,2,1,1
"Phyllitis","Aspleniaceae","Polypodiales",0,0,0,3,0,NA
"Phyllitopsis","Aspleniaceae","Polypodiales",0,0,0,1,0,NA
"Phyllobolus","Aizoaceae","Caryophyllales",0,0,0,1,0,NA
"Phyllobotryon","Salicaceae","Malpighiales",0,0,0,2,0,NA
"Phyllocarpus","Fabaceae","Fabales",1,0,0,2,1,1
"Phyllocephalum","Asteraceae","Asterales",0,0,0,13,0,NA
"Phyllocladus","Podocarpaceae","Araucariales",3,0,0,4,3,1
"Phyllocosmus","Ixonanthaceae","Malpighiales",3,0,0,4,3,1
"Phyllocrater","Rubiaceae","Gentianales",0,0,0,1,0,NA
"Phylloctenium","Bignoniaceae","Lamiales",0,0,0,2,0,NA
"Phyllodium","Fabaceae","Fabales",0,0,0,6,0,NA
"Phyllodoce","Ericaceae","Ericales",3,0,0,8,3,1
"Phyllolobium","Fabaceae","Fabales",0,0,0,19,0,NA
"Phyllomelia","Rubiaceae","Gentianales",0,0,0,1,0,NA
"Phyllonoma","Phyllonomaceae","Aquifoliales",3,0,0,5,3,1
"Phyllopentas","Rubiaceae","Gentianales",0,0,0,12,0,NA
"Phyllopodium","Scrophulariaceae","Lamiales",0,0,0,14,0,NA
"Phyllorachis","Poaceae","Poales",0,0,0,1,0,NA
"Phyllorchis","Orchidaceae","Asparagales",0,0,0,12,0,NA
"Phyllosasa","Poaceae","Poales",0,0,0,1,0,NA
"Phylloscirpus","Cyperaceae","Poales",0,0,2,3,2,0
"Phyllosma","Rutaceae","Sapindales",0,0,0,2,0,NA
"Phyllospadix","Zosteraceae","Alismatales",0,0,3,6,3,0
"Phyllostachys","Poaceae","Poales",8,0,0,51,8,1
"Phyllostegia","Lamiaceae","Lamiales",0,0,4,38,4,0
"Phyllostemonodaphne","Lauraceae","Laurales",0,0,0,1,0,NA
"Phyllostylon","Ulmaceae","Rosales",2,0,0,2,2,1
"Phyllota","Fabaceae","Fabales",2,0,0,10,2,1
"Phylloxylon","Fabaceae","Fabales",2,0,0,7,2,1
"Phylohydrax","Rubiaceae","Gentianales",0,0,1,2,1,0
"Phymaspermum","Asteraceae","Asterales",1,0,0,20,1,1
"Phymatarum","Araceae","Alismatales",0,0,0,1,0,NA
"Phymatidium","Orchidaceae","Asparagales",0,0,1,10,1,0
"Phymatocarpus","Myrtaceae","Myrtales",1,0,0,3,1,1
"Phymatodes","Dipteridaceae","Gleicheniales",0,0,0,9,0,NA
"Phymatopsis","Polypodiaceae","Polypodiales",0,0,0,2,0,NA
"Phymatopteris","Polypodiaceae","Polypodiales",0,0,0,58,0,NA
"Phymatosorus","Polypodiaceae","Polypodiales",0,0,3,19,3,0
"Phymosia","Malvaceae","Malvales",0,0,0,8,0,NA
"Physacanthus","Acanthaceae","Lamiales",0,0,0,3,0,NA
"Physaliastrum","Solanaceae","Solanales",0,0,0,8,0,NA
"Physalis","Solanaceae","Solanales",0,0,6,124,6,0
"Physandra","Amaranthaceae","Caryophyllales",0,0,0,1,0,NA
"Physaria","Brassicaceae","Brassicales",0,0,1,107,1,0
"Physematium","Woodsiaceae","Polypodiales",0,0,0,1,0,NA
"Physena","Physenaceae","Caryophyllales",2,0,0,2,2,1
"Physeterostemon","Melastomataceae","Myrtales",0,0,0,3,0,NA
"Physocalymma","Lythraceae","Myrtales",1,0,0,1,1,1
"Physocalyx","Orobanchaceae","Lamiales",0,0,0,3,0,NA
"Physocardamum","Brassicaceae","Brassicales",0,0,0,1,0,NA
"Physocarpus","Rosaceae","Rosales",4,0,0,10,4,1
"Physoceras","Orchidaceae","Asparagales",0,0,0,12,0,NA
"Physochlaina","Solanaceae","Solanales",0,0,0,6,0,NA
"Physodium","Malvaceae","Malvales",0,0,0,1,0,NA
"Physogyne","Orchidaceae","Asparagales",0,0,0,3,0,NA
"Physokentia","Arecaceae","Arecales",1,0,0,7,1,1
"Physoplexis","Campanulaceae","Asterales",0,0,1,1,1,0
"Physopsis","Lamiaceae","Lamiales",0,0,0,5,0,NA
"Physoptychis","Brassicaceae","Brassicales",0,0,0,3,0,NA
"Physorhynchus","Brassicaceae","Brassicales",0,0,0,2,0,NA
"Physospermopsis","Apiaceae","Apiales",0,0,0,9,0,NA
"Physospermum","Apiaceae","Apiales",0,0,1,2,1,0
"Physostegia","Lamiaceae","Lamiales",0,0,2,13,2,0
"Physostelma","Apocynaceae","Gentianales",0,0,0,1,0,NA
"Physostemon","Cleomaceae","Brassicales",0,0,0,2,0,NA
"Physostigma","Fabaceae","Fabales",0,0,0,5,0,NA
"Physotrichia","Apiaceae","Apiales",0,0,0,4,0,NA
"Phytelephas","Arecaceae","Arecales",6,0,0,7,6,1
"Phyteuma","Campanulaceae","Asterales",0,0,9,26,9,0
"Phytocrene","Icacinaceae","UnknownOrder-Icacinaceae",3,0,0,11,3,1
"Phytolacca","Phytolaccaceae","Caryophyllales",1,0,4,24,5,0.2
"Piaranthus","Apocynaceae","Gentianales",0,0,0,16,0,NA
"Picardaea","Rubiaceae","Gentianales",0,0,0,1,0,NA
"Picconia","Oleaceae","Lamiales",1,0,0,2,1,1
"Picea","Pinaceae","Pinales",24,0,0,40,24,1
"Pichinia","Araceae","Alismatales",0,0,0,1,0,NA
"Pichisermollodes","Polypodiaceae","Polypodiales",0,0,0,11,0,NA
"Pichonia","Sapotaceae","Ericales",2,0,0,8,2,1
"Pickeringia","Fabaceae","Fabales",1,0,0,1,1,1
"Picnomon","Asteraceae","Asterales",0,0,1,1,1,0
"Picradenia","Asteraceae","Asterales",0,0,0,1,0,NA
"Picradeniopsis","Asteraceae","Asterales",0,0,0,2,0,NA
"Picralima","Apocynaceae","Gentianales",1,0,0,1,1,1
"Picramnia","Picramniaceae","Picramniales",10,0,0,39,10,1
"Picrasma","Simaroubaceae","Sapindales",4,0,0,6,4,1
"Picrella","Rutaceae","Sapindales",0,0,0,1,0,NA
"Picria","Linderniaceae","Lamiales",0,0,0,1,0,NA
"Picridium","Asteraceae","Asterales",0,0,0,3,0,NA
"Picris","Asteraceae","Asterales",0,0,1,61,1,0
"Picrodendron","Picrodendraceae","Malpighiales",1,0,0,1,1,1
"Picrolemma","Simaroubaceae","Sapindales",1,0,0,2,1,1
"Picrosia","Asteraceae","Asterales",0,0,0,2,0,NA
"Picrothamnus","Asteraceae","Asterales",1,0,0,1,1,1
"Pictetia","Fabaceae","Fabales",1,0,0,10,1,1
"Pieris","Ericaceae","Ericales",4,0,0,6,4,1
"Pierranthus","Linderniaceae","Lamiales",0,0,0,1,0,NA
"Pierreodendron","Simaroubaceae","Sapindales",1,0,0,2,1,1
"Pierrina","Lecythidaceae","Ericales",0,0,0,1,0,NA
"Pigafetta","Arecaceae","Arecales",0,0,0,2,0,NA
"Pilea","Urticaceae","Rosales",0,0,7,279,7,0
"Pileanthus","Myrtaceae","Myrtales",2,0,0,8,2,1
"Pileostegia","Hydrangeaceae","Cornales",0,0,0,2,0,NA
"Pilgerodendron","Cupressaceae","Cupressales",1,0,0,1,1,1
"Pilidiostigma","Myrtaceae","Myrtales",4,0,0,6,4,1
"Piliocalyx","Myrtaceae","Myrtales",4,0,0,8,4,1
"Piliostigma","Fabaceae","Fabales",0,0,0,2,0,NA
"Pillansia","Iridaceae","Asparagales",0,0,1,1,1,0
"Piloblephis","Lamiaceae","Lamiales",0,0,0,1,0,NA
"Pilocarpus","Rutaceae","Sapindales",1,0,0,17,1,1
"Pilocereus","Cactaceae","Caryophyllales",0,0,0,4,0,NA
"Pilocosta","Melastomataceae","Myrtales",0,0,0,5,0,NA
"Pilogyne","Cucurbitaceae","Cucurbitales",0,0,0,2,0,NA
"Pilophyllum","Orchidaceae","Asparagales",0,0,0,1,0,NA
"Pilopleura","Apiaceae","Apiales",0,0,0,2,0,NA
"Pilosella","Asteraceae","Asterales",0,0,4,217,4,0
"Pilosocereus","Cactaceae","Caryophyllales",0,0,0,54,0,NA
"Pilostaxis","Polygalaceae","Fabales",0,0,0,6,0,NA
"Pilostemon","Asteraceae","Asterales",0,0,0,2,0,NA
"Pilostigma","Loranthaceae","Santalales",0,0,0,1,0,NA
"Pilostyles","Apodanthaceae","UnknownOrder-Apodanthaceae",0,0,11,19,11,0
"Pilularia","Marsileaceae","Salviniales",0,0,0,1,0,NA
"Pimelea","Thymelaeaceae","Malvales",20,0,1,130,21,0.952380952380952
"Pimelodendron","Euphorbiaceae","Malpighiales",3,0,0,4,3,1
"Pimenta","Myrtaceae","Myrtales",4,0,0,16,4,1
"Pimentelia","Rubiaceae","Gentianales",0,0,0,1,0,NA
"Pimpinella","Apiaceae","Apiales",0,0,2,106,2,0
"Pinacopodium","Erythroxylaceae","Malpighiales",1,0,0,2,1,1
"Pinalia","Orchidaceae","Asparagales",0,0,0,106,0,NA
"Pinanga","Arecaceae","Arecales",1,0,0,138,1,1
"Pinaropappus","Asteraceae","Asterales",0,0,0,10,0,NA
"Pinarophyllon","Rubiaceae","Gentianales",0,0,0,2,0,NA
"Pinckneya","Rubiaceae","Gentianales",1,0,0,1,1,1
"Pinda","Apiaceae","Apiales",0,0,0,1,0,NA
"Pineda","Salicaceae","Malpighiales",1,0,0,1,1,1
"Pinellia","Araceae","Alismatales",0,0,3,9,3,0
"Pinga","Poaceae","Poales",0,0,0,1,0,NA
"Pinguicula","Lentibulariaceae","Lamiales",0,0,5,73,5,0
"Pinillosia","Asteraceae","Asterales",0,0,0,1,0,NA
"Pinochia","Apocynaceae","Gentianales",1,0,0,4,1,1
"Pintoa","Zygophyllaceae","Zygophyllales",0,0,0,1,0,NA
"Pinus","Pinaceae","Pinales",96,0,0,130,96,1
"Pinzona","Dilleniaceae","Dilleniales",1,0,0,1,1,1
"Pioctonon","Boraginaceae","UnknownOrder-Boraginaceae",0,0,0,1,0,NA
"Pionandra","Solanaceae","Solanales",0,0,0,4,0,NA
"Piora","Asteraceae","Asterales",0,0,0,1,0,NA
"Piper","Piperaceae","Piperales",55,3,2,1457,57,0.964912280701754
"Piperanthera","Piperaceae","Piperales",0,0,0,1,0,NA
"Pippenalia","Asteraceae","Asterales",0,0,0,1,0,NA
"Piptadenia","Fabaceae","Fabales",6,0,0,37,6,1
"Piptadeniastrum","Fabaceae","Fabales",1,0,0,2,1,1
"Piptadeniopsis","Fabaceae","Fabales",1,0,0,1,1,1
"Piptanthus","Fabaceae","Fabales",1,0,0,3,1,1
"Piptatherum","Poaceae","Poales",0,0,1,34,1,0
"Piptocarpha","Asteraceae","Asterales",3,0,0,51,3,1
"Piptochaetium","Poaceae","Poales",0,0,2,36,2,0
"Piptocoma","Asteraceae","Asterales",1,0,0,19,1,1
"Piptolepis","Asteraceae","Asterales",0,0,0,7,0,NA
"Piptomeris","Fabaceae","Fabales",0,0,0,34,0,NA
"Piptophyllum","Poaceae","Poales",0,0,0,1,0,NA
"Piptospatha","Araceae","Alismatales",0,0,0,12,0,NA
"Piptostigma","Annonaceae","Magnoliales",2,0,0,11,2,1
"Piptothrix","Asteraceae","Asterales",0,0,0,5,0,NA
"Pipturus","Urticaceae","Rosales",2,0,0,15,2,1
"Piqueria","Asteraceae","Asterales",0,0,0,9,0,NA
"Piqueriella","Asteraceae","Asterales",0,0,0,1,0,NA
"Piqueriopsis","Asteraceae","Asterales",0,0,0,1,0,NA
"Piquetia","Theaceae","Ericales",0,0,0,1,0,NA
"Piranhea","Picrodendraceae","Malpighiales",3,0,0,4,3,1
"Piresia","Poaceae","Poales",0,0,0,5,0,NA
"Piresiella","Poaceae","Poales",0,0,0,1,0,NA
"Piriqueta","Passifloraceae","Malpighiales",0,0,2,46,2,0
"Piscidia","Fabaceae","Fabales",2,0,0,7,2,1
"Pisonia","Nyctaginaceae","Caryophyllales",8,0,0,24,8,1
"Pisoniella","Nyctaginaceae","Caryophyllales",1,0,0,2,1,1
"Pistacia","Anacardiaceae","Sapindales",8,0,0,12,8,1
"Pistia","Araceae","Alismatales",0,0,1,1,1,0
"Pistorinia","Crassulaceae","Saxifragales",0,0,0,2,0,NA
"Pisum","Fabaceae","Fabales",0,0,1,7,1,0
"Pitardella","Rubiaceae","Gentianales",0,0,0,3,0,NA
"Pitavia","Rutaceae","Sapindales",1,0,0,1,1,1
"Pitcairnia","Bromeliaceae","Poales",0,0,16,402,16,0
"Pithecellobium","Fabaceae","Fabales",4,0,0,79,4,1
"Pithecolobium","Fabaceae","Fabales",0,0,0,1,0,NA
"Pithecoseris","Asteraceae","Asterales",0,0,0,1,0,NA
"Pithocarpa","Asteraceae","Asterales",0,0,0,2,0,NA
"Pitraea","Verbenaceae","Lamiales",0,0,0,1,0,NA
"Pittocaulon","Asteraceae","Asterales",0,0,0,2,0,NA
"Pittoniotis","Rubiaceae","Gentianales",1,0,0,3,1,1
"Pittosporopsis","Icacinaceae","UnknownOrder-Icacinaceae",1,0,0,1,1,1
"Pittosporum","Pittosporaceae","Apiales",27,0,0,110,27,1
"Pityopsis","Asteraceae","Asterales",0,0,0,6,0,NA
"Pityopus","Ericaceae","Ericales",0,0,0,1,0,NA
"Pityphyllum","Orchidaceae","Asparagales",0,0,2,5,2,0
"Pityrocarpa","Fabaceae","Fabales",0,0,0,5,0,NA
"Pityrodia","Lamiaceae","Lamiales",7,0,0,36,7,1
"Pityrogramma","Pteridaceae","Polypodiales",0,0,3,21,3,0
"Pityromeria","Pteridaceae","Polypodiales",0,0,0,3,0,NA
"Placea","Amaryllidaceae","Asparagales",0,0,2,6,2,0
"Placocarpa","Rubiaceae","Gentianales",0,0,0,1,0,NA
"Placodiscus","Sapindaceae","Sapindales",4,0,0,18,4,1
"Placolobium","Fabaceae","Fabales",0,0,0,3,0,NA
"Plagiantha","Poaceae","Poales",0,0,1,1,1,0
"Plagianthus","Malvaceae","Malvales",2,0,0,3,2,1
"Plagiobasis","Asteraceae","Asterales",0,0,0,1,0,NA
"Plagiobothrys","Boraginaceae","UnknownOrder-Boraginaceae",0,0,0,79,0,NA
"Plagiocarpus","Fabaceae","Fabales",0,0,0,1,0,NA
"Plagiocheilus","Asteraceae","Asterales",0,0,0,7,0,NA
"Plagiocladus","Phyllanthaceae","Malpighiales",1,0,0,1,1,1
"Plagiogyria","Plagiogyriaceae","Cyatheales",0,0,0,13,0,NA
"Plagiolirion","Amaryllidaceae","Asparagales",0,0,0,1,0,NA
"Plagiolophus","Asteraceae","Asterales",0,0,0,1,0,NA
"Plagiopetalum","Melastomataceae","Myrtales",0,0,0,2,0,NA
"Plagiopteron","Celastraceae","Celastrales",1,0,0,1,1,1
"Plagiorhegma","Berberidaceae","Ranunculales",0,0,0,1,0,NA
"Plagioscyphus","Sapindaceae","Sapindales",2,0,0,10,2,1
"Plagiosetum","Poaceae","Poales",0,0,0,1,0,NA
"Plagiosiphon","Fabaceae","Fabales",1,0,0,5,1,1
"Plagiostachys","Zingiberaceae","Zingiberales",0,0,0,27,0,NA
"Plagiostyles","Euphorbiaceae","Malpighiales",1,0,0,2,1,1
"Plagius","Asteraceae","Asterales",0,0,0,3,0,NA
"Planaltina","Rubiaceae","Gentianales",0,0,0,3,0,NA
"Planaltoa","Asteraceae","Asterales",0,0,0,2,0,NA
"Plananthus","Lycopodiaceae","Lycopodiales",0,0,1,1,1,0
"Planchonella","Sapotaceae","Ericales",25,0,0,108,25,1
"Planchonia","Lecythidaceae","Ericales",6,0,0,9,6,1
"Planea","Asteraceae","Asterales",0,0,0,1,0,NA
"Planera","Ulmaceae","Rosales",1,0,0,1,1,1
"Planodes","Brassicaceae","Brassicales",0,0,0,1,0,NA
"Plantago","Plantaginaceae","Lamiales",0,0,22,158,22,0
"Platanthera","Orchidaceae","Asparagales",0,0,6,152,6,0
"Platanus","Platanaceae","Proteales",5,0,0,9,5,1
"Platea","Icacinaceae","UnknownOrder-Icacinaceae",3,0,0,5,3,1
"Plateilema","Asteraceae","Asterales",0,0,0,1,0,NA
"Plathymenia","Fabaceae","Fabales",1,0,0,2,1,1
"Platonia","Clusiaceae","Malpighiales",1,0,0,1,1,1
"Platostoma","Lamiaceae","Lamiales",0,0,1,44,1,0
"Platycapnos","Papaveraceae","Ranunculales",0,0,0,3,0,NA
"Platycarpha","Asteraceae","Asterales",0,0,0,3,0,NA
"Platycarpum","Rubiaceae","Gentianales",0,0,0,12,0,NA
"Platycarya","Juglandaceae","Fagales",1,0,0,2,1,1
"Platycaulos","Restionaceae","Poales",0,0,2,12,2,0
"Platycelyphium","Fabaceae","Fabales",0,0,0,1,0,NA
"Platycerium","Polypodiaceae","Polypodiales",0,0,2,9,2,0
"Platychaete","Asteraceae","Asterales",0,0,0,3,0,NA
"Platychorda","Restionaceae","Poales",0,0,0,2,0,NA
"Platycladus","Cupressaceae","Cupressales",1,0,0,1,1,1
"Platycodon","Campanulaceae","Asterales",0,0,1,1,1,0
"Platycoryne","Orchidaceae","Asparagales",0,0,0,19,0,NA
"Platycraspedum","Brassicaceae","Brassicales",0,0,0,2,0,NA
"Platycrater","Hydrangeaceae","Cornales",1,0,0,1,1,1
"Platycyamus","Fabaceae","Fabales",1,0,0,2,1,1
"Platydesma","Rutaceae","Sapindales",0,0,0,3,0,NA
"Platygyna","Euphorbiaceae","Malpighiales",0,0,0,7,0,NA
"Platygyria","Polypodiaceae","Polypodiales",0,0,0,4,0,NA
"Platylepis","Orchidaceae","Asparagales",0,0,0,17,0,NA
"Platylobium","Fabaceae","Fabales",1,0,0,4,1,1
"Platylophus","Cunoniaceae","Oxalidales",1,0,0,1,1,1
"Platymiscium","Fabaceae","Fabales",8,0,0,37,8,1
"Platymitra","Annonaceae","Magnoliales",1,0,0,1,1,1
"Platyopuntia","Cactaceae","Caryophyllales",0,0,0,2,0,NA
"Platypodanthera","Asteraceae","Asterales",0,0,0,2,0,NA
"Platypodium","Fabaceae","Fabales",2,0,0,2,2,1
"Platypterocarpus","Celastraceae","Celastrales",0,0,0,1,0,NA
"Platyrhiza","Orchidaceae","Asparagales",0,0,0,1,0,NA
"Platysace","Apiaceae","Apiales",0,0,0,2,0,NA
"Platyschkuhria","Asteraceae","Asterales",0,0,0,2,0,NA
"Platysepalum","Fabaceae","Fabales",1,0,0,12,1,1
"Platystele","Orchidaceae","Asparagales",0,0,1,101,1,0
"Platystemma","Gesneriaceae","Lamiales",0,0,0,1,0,NA
"Platystemon","Papaveraceae","Ranunculales",0,0,1,2,1,0
"Platytaenia","Pteridaceae","Polypodiales",0,0,0,2,0,NA
"Platythelys","Orchidaceae","Asparagales",0,0,1,13,1,0
"Plazia","Asteraceae","Asterales",0,0,0,2,0,NA
"Pleconax","Caryophyllaceae","Caryophyllales",0,0,0,4,0,NA
"Plecostachys","Asteraceae","Asterales",1,0,0,2,1,1
"Plectaneia","Apocynaceae","Gentianales",2,0,0,3,2,1
"Plectocephalus","Asteraceae","Asterales",0,0,0,2,0,NA
"Plectocomia","Arecaceae","Arecales",1,0,0,15,1,1
"Plectocomiopsis","Arecaceae","Arecales",0,0,0,6,0,NA
"Plectopoma","Gesneriaceae","Lamiales",0,0,0,1,0,NA
"Plectorrhiza","Orchidaceae","Asparagales",0,0,1,3,1,0
"Plectranthus","Lamiaceae","Lamiales",9,0,10,325,19,0.473684210526316
"Plectrelminthus","Orchidaceae","Asparagales",0,0,0,1,0,NA
"Plectritis","Caprifoliaceae","Dipsacales",0,0,1,11,1,0
"Plectrocarpa","Zygophyllaceae","Zygophyllales",1,0,0,2,1,1
"Plectroniella","Rubiaceae","Gentianales",1,0,0,1,1,1
"Plectrophora","Orchidaceae","Asparagales",0,0,0,10,0,NA
"Pleea","Tofieldiaceae","Alismatales",0,0,1,1,1,0
"Pleiacanthus","Asteraceae","Asterales",0,1,0,1,0,NA
"Pleiarina","Salicaceae","Malpighiales",0,0,0,4,0,NA
"Pleioblastus","Poaceae","Poales",0,0,0,21,0,NA
"Pleiocardia","Brassicaceae","Brassicales",0,0,0,1,0,NA
"Pleiocarpa","Apocynaceae","Gentianales",3,0,0,6,3,1
"Pleioceras","Apocynaceae","Gentianales",1,0,0,5,1,1
"Pleiochiton","Melastomataceae","Myrtales",0,0,0,5,0,NA
"Pleiocoryne","Rubiaceae","Gentianales",0,0,0,1,0,NA
"Pleiocraterium","Rubiaceae","Gentianales",0,0,0,4,0,NA
"Pleiogynium","Anacardiaceae","Sapindales",1,0,0,2,1,1
"Pleiomeris","Primulaceae","Ericales",1,0,0,1,1,1
"Pleione","Orchidaceae","Asparagales",0,0,14,26,14,0
"Pleioneura","Caryophyllaceae","Caryophyllales",0,0,0,1,0,NA
"Pleiospermium","Rutaceae","Sapindales",1,0,0,1,1,1
"Pleiospilos","Aizoaceae","Caryophyllales",0,0,0,5,0,NA
"Pleiostachya","Marantaceae","Zingiberales",0,0,1,3,1,0
"Pleiotaenia","Apiaceae","Apiales",0,0,0,1,0,NA
"Pleiotaxis","Asteraceae","Asterales",0,0,0,34,0,NA
"Plenasium","Osmundaceae","Osmundales",0,0,0,1,0,NA
"Plenckia","Celastraceae","Celastrales",0,0,0,3,0,NA
"Pleocarphus","Asteraceae","Asterales",0,0,0,1,0,NA
"Pleocaulus","Acanthaceae","Lamiales",0,0,0,1,0,NA
"Pleocnemia","Tectariaceae","Polypodiales",0,0,0,15,0,NA
"Pleodendron","Canellaceae","Canellales",2,0,0,3,2,1
"Pleonotoma","Bignoniaceae","Lamiales",6,0,0,17,6,1
"Pleopeltis","Polypodiaceae","Polypodiales",0,0,0,57,0,NA
"Pleopodium","Polypodiaceae","Polypodiales",0,0,0,3,0,NA
"Pleradenophora","Euphorbiaceae","Malpighiales",0,0,0,1,0,NA
"Pleroma","Melastomataceae","Myrtales",0,0,0,2,0,NA
"Plesiatropha","Euphorbiaceae","Malpighiales",0,0,0,3,0,NA
"Plesioneuron","Thelypteridaceae","Polypodiales",0,0,0,1,0,NA
"Plethadenia","Rutaceae","Sapindales",0,0,0,1,0,NA
"Plettkea","Caryophyllaceae","Caryophyllales",0,0,0,1,0,NA
"Pleuranthodendron","Salicaceae","Malpighiales",1,0,0,1,1,1
"Pleuranthodium","Zingiberaceae","Zingiberales",0,0,0,23,0,NA
"Pleuricospora","Ericaceae","Ericales",0,0,0,2,0,NA
"Pleurisanthes","Icacinaceae","UnknownOrder-Icacinaceae",1,0,0,7,1,1
"Pleurocalyptus","Myrtaceae","Myrtales",2,0,0,2,2,1
"Pleurocarpaea","Asteraceae","Asterales",0,0,0,2,0,NA
"Pleurocoronis","Asteraceae","Asterales",0,0,0,3,0,NA
"Pleuroderris","Tectariaceae","Polypodiales",0,0,0,1,0,NA
"Pleurofossa","Pteridaceae","Polypodiales",0,0,0,1,0,NA
"Pleurogramme","Polypodiaceae","Polypodiales",0,0,3,3,3,0
"Pleurogynella","Gentianaceae","Gentianales",0,0,0,1,0,NA
"Pleurolobus","Fabaceae","Fabales",0,0,0,3,0,NA
"Pleuromanes","Hymenophyllaceae","Hymenophyllales",0,0,0,1,0,NA
"Pleuropappus","Asteraceae","Asterales",0,0,1,1,1,0
"Pleuropetalum","Amaranthaceae","Caryophyllales",1,0,0,3,1,1
"Pleurophora","Lythraceae","Myrtales",1,0,0,7,1,1
"Pleurophyllum","Asteraceae","Asterales",0,0,1,4,1,0
"Pleuropogon","Poaceae","Poales",0,0,0,6,0,NA
"Pleuropterantha","Amaranthaceae","Caryophyllales",0,0,0,1,0,NA
"Pleuropteropyrum","Polygonaceae","Caryophyllales",0,0,0,1,0,NA
"Pleurosoriopsis","Polypodiaceae","Polypodiales",0,0,0,1,0,NA
"Pleurosorus","Aspleniaceae","Polypodiales",0,0,0,1,0,NA
"Pleurospermopsis","Apiaceae","Apiales",0,0,0,1,0,NA
"Pleurospermum","Apiaceae","Apiales",0,0,1,41,1,0
"Pleurostachys","Cyperaceae","Poales",0,0,0,33,0,NA
"Pleurostelma","Apocynaceae","Gentianales",0,0,0,2,0,NA
"Pleurostylia","Celastraceae","Celastrales",3,0,0,5,3,1
"Pleurothallis","Orchidaceae","Asparagales",0,0,3,557,3,0
"Pleurothallopsis","Orchidaceae","Asparagales",0,0,1,18,1,0
"Pleurothyrium","Lauraceae","Laurales",14,0,0,48,14,1
"Plexipus","Verbenaceae","Lamiales",0,0,0,8,0,NA
"Plicosepalus","Loranthaceae","Santalales",1,0,0,12,1,1
"Plinia","Myrtaceae","Myrtales",2,0,0,69,2,1
"Plinthanthesis","Poaceae","Poales",0,0,1,3,1,0
"Plinthus","Aizoaceae","Caryophyllales",0,0,0,4,0,NA
"Plocama","Rubiaceae","Gentianales",10,0,0,34,10,1
"Plocaniophyllon","Rubiaceae","Gentianales",0,0,0,1,0,NA
"Plocoglottis","Orchidaceae","Asparagales",0,0,0,41,0,NA
"Plocosperma","Plocospermataceae","Lamiales",1,0,0,1,1,1
"Ploiarium","Bonnetiaceae","Malpighiales",1,0,0,1,1,1
"Plowmania","Solanaceae","Solanales",0,0,0,1,0,NA
"Plowmanianthus","Commelinaceae","Commelinales",0,0,0,5,0,NA
"Pluchea","Asteraceae","Asterales",8,0,1,56,9,0.888888888888889
"Plukenetia","Euphorbiaceae","Malpighiales",0,2,0,20,0,NA
"Plumbagella","Plumbaginaceae","Caryophyllales",0,0,0,1,0,NA
"Plumbago","Plumbaginaceae","Caryophyllales",3,0,0,17,3,1
"Plumeria","Apocynaceae","Gentianales",4,0,0,11,4,1
"Plutarchia","Ericaceae","Ericales",1,0,0,10,1,1
"Pneumatopteris","Thelypteridaceae","Polypodiales",0,0,1,9,1,0
"Poa","Poaceae","Poales",0,0,89,537,89,0
"Poaephyllum","Orchidaceae","Asparagales",0,0,0,6,0,NA
"Poagrostis","Poaceae","Poales",0,0,0,1,0,NA
"Podachaenium","Asteraceae","Asterales",1,0,0,5,1,1
"Podadenia","Euphorbiaceae","Malpighiales",0,0,0,1,0,NA
"Podalyria","Fabaceae","Fabales",12,2,0,28,12,1
"Podandrogyne","Cleomaceae","Brassicales",0,1,0,16,0,NA
"Podangis","Orchidaceae","Asparagales",0,0,1,1,1,0
"Podanthus","Asteraceae","Asterales",1,0,0,2,1,1
"Podistera","Apiaceae","Apiales",0,0,0,4,0,NA
"Podocalyx","Picrodendraceae","Malpighiales",1,0,0,1,1,1
"Podocarpium","Fabaceae","Fabales",0,0,0,7,0,NA
"Podocarpus","Podocarpaceae","Araucariales",41,0,0,108,41,1
"Podochilus","Orchidaceae","Asparagales",0,0,1,62,1,0
"Podococcus","Arecaceae","Arecales",1,0,0,2,1,1
"Podocoma","Asteraceae","Asterales",0,0,0,8,0,NA
"Podocytisus","Fabaceae","Fabales",0,0,0,1,0,NA
"Podolasia","Araceae","Alismatales",0,0,0,1,0,NA
"Podolepis","Asteraceae","Asterales",0,0,14,20,14,0
"Podolobium","Fabaceae","Fabales",1,0,0,1,1,1
"Podolotus","Fabaceae","Fabales",0,0,0,1,0,NA
"Podonephelium","Sapindaceae","Sapindales",1,0,0,1,1,1
"Podophorus","Poaceae","Poales",0,0,0,1,0,NA
"Podophyllum","Berberidaceae","Ranunculales",0,0,1,1,1,0
"Podopterus","Polygonaceae","Caryophyllales",0,0,0,3,0,NA
"Podorungia","Acanthaceae","Lamiales",0,0,0,4,0,NA
"Podospermum","Asteraceae","Asterales",0,0,2,20,2,0
"Podostemum","Podostemaceae","Malpighiales",0,0,1,17,1,0
"Podotheca","Asteraceae","Asterales",0,0,1,6,1,0
"Podranea","Bignoniaceae","Lamiales",1,0,0,2,1,1
"Poecilandra","Ochnaceae","Malpighiales",1,0,0,2,1,1
"Poecilanthe","Fabaceae","Fabales",4,0,0,9,4,1
"Poecilocalyx","Rubiaceae","Gentianales",0,0,0,1,0,NA
"Poecilolepis","Asteraceae","Asterales",0,0,0,2,0,NA
"Poecilopteris","Dryopteridaceae","Polypodiales",0,0,0,1,0,NA
"Poecilostachys","Poaceae","Poales",0,0,0,11,0,NA
"Poenosedum","Crassulaceae","Saxifragales",0,0,0,1,0,NA
"Poeppigia","Fabaceae","Fabales",1,0,0,1,1,1
"Poga","Anisophylleaceae","Cucurbitales",1,0,0,1,1,1
"Poggea","Achariaceae","Malpighiales",0,0,0,2,0,NA
"Pogogyne","Lamiaceae","Lamiales",0,0,2,8,2,0
"Pogonachne","Poaceae","Poales",0,0,0,1,0,NA
"Pogonarthria","Poaceae","Poales",0,0,0,4,0,NA
"Pogonatherum","Poaceae","Poales",0,0,2,4,2,0
"Pogonia","Orchidaceae","Asparagales",0,0,3,5,3,0
"Pogoniopsis","Orchidaceae","Asparagales",0,0,0,2,0,NA
"Pogonochloa","Poaceae","Poales",0,0,0,1,0,NA
"Pogonolepis","Asteraceae","Asterales",0,0,1,2,1,0
"Pogononeura","Poaceae","Poales",0,0,0,1,0,NA
"Pogonophora","Peraceae","Malpighiales",1,0,0,2,1,1
"Pogonopus","Rubiaceae","Gentianales",1,0,0,3,1,1
"Pogonorrhinum","Plantaginaceae","Lamiales",0,0,0,1,0,NA
"Pogonotium","Arecaceae","Arecales",0,0,0,3,0,NA
"Pogostemon","Lamiaceae","Lamiales",0,0,3,94,3,0
"Pohlidium","Poaceae","Poales",0,0,1,1,1,0
"Poikilacanthus","Acanthaceae","Lamiales",0,0,0,9,0,NA
"Poikilospermum","Urticaceae","Rosales",0,0,0,4,0,NA
"Poincianella","Fabaceae","Fabales",0,0,0,1,0,NA
"Poiretia","Fabaceae","Fabales",0,0,0,11,0,NA
"Poissonia","Fabaceae","Fabales",0,0,0,2,0,NA
"Poitea","Fabaceae","Fabales",4,0,0,13,4,1
"Pojarkovia","Asteraceae","Asterales",0,0,0,2,0,NA
"Polanisia","Cleomaceae","Brassicales",0,0,1,6,1,0
"Polaskia","Cactaceae","Caryophyllales",0,0,0,2,0,NA
"Polemannia","Apiaceae","Apiales",0,0,0,4,0,NA
"Polemanniopsis","Apiaceae","Apiales",1,0,0,1,1,1
"Polemonium","Polemoniaceae","Ericales",0,0,4,38,4,0
"Polevansia","Poaceae","Poales",0,0,0,1,0,NA
"Polhillia","Fabaceae","Fabales",0,0,1,6,1,0
"Polianthes","Asparagaceae","Asparagales",0,0,3,18,3,0
"Poliomintha","Lamiaceae","Lamiales",1,0,0,8,1,1
"Poliothyrsis","Salicaceae","Malpighiales",1,0,0,1,1,1
"Pollalesta","Asteraceae","Asterales",0,0,0,2,0,NA
"Pollia","Commelinaceae","Commelinales",0,0,4,22,4,0
"Pollichia","Caryophyllaceae","Caryophyllales",0,0,0,1,0,NA
"Polpoda","Molluginaceae","Caryophyllales",0,0,0,2,0,NA
"Polyachyrus","Asteraceae","Asterales",0,0,0,7,0,NA
"Polyadenia","Lauraceae","Laurales",0,0,0,7,0,NA
"Polyalthia","Annonaceae","Magnoliales",24,0,0,80,24,1
"Polyanthina","Asteraceae","Asterales",0,0,0,1,0,NA
"Polyarrhena","Asteraceae","Asterales",0,1,0,4,0,NA
"Polybotrya","Dryopteridaceae","Polypodiales",0,0,2,36,2,0
"Polycalymma","Asteraceae","Asterales",0,0,1,1,1,0
"Polycardia","Celastraceae","Celastrales",0,0,0,4,0,NA
"Polycarena","Scrophulariaceae","Lamiales",0,0,1,37,1,0
"Polycarpaea","Caryophyllaceae","Caryophyllales",0,0,0,19,0,NA
"Polycarpon","Caryophyllaceae","Caryophyllales",0,0,1,9,1,0
"Polycephalium","Icacinaceae","UnknownOrder-Icacinaceae",0,0,0,2,0,NA
"Polyceratocarpus","Annonaceae","Magnoliales",1,0,0,9,1,1
"Polychrysum","Asteraceae","Asterales",0,0,0,1,0,NA
"Polyclathra","Cucurbitaceae","Cucurbitales",0,0,1,1,1,0
"Polyclita","Ericaceae","Ericales",1,0,0,1,1,1
"Polycnemum","Amaranthaceae","Caryophyllales",0,0,2,5,2,0
"Polycodium","Ericaceae","Ericales",0,0,0,12,0,NA
"Polyctenium","Brassicaceae","Brassicales",0,0,1,1,1,0
"Polycycnis","Orchidaceae","Asparagales",0,0,3,17,3,0
"Polydora","Asteraceae","Asterales",0,0,0,8,0,NA
"Polygala","Polygalaceae","Fabales",6,0,14,623,20,0.3
"Polygaloides","Polygalaceae","Fabales",0,0,0,1,0,NA
"Polygonanthus","Anisophylleaceae","Cucurbitales",1,0,0,1,1,1
"Polygonatum","Asparagaceae","Asparagales",0,0,10,71,10,0
"Polygonella","Polygonaceae","Caryophyllales",1,0,1,11,2,0.5
"Polygonum","Polygonaceae","Caryophyllales",2,0,15,217,17,0.117647058823529
"Polylepis","Rosaceae","Rosales",2,0,0,15,2,1
"Polylychnis","Acanthaceae","Lamiales",0,0,0,1,0,NA
"Polymita","Aizoaceae","Caryophyllales",0,0,0,2,0,NA
"Polymnia","Asteraceae","Asterales",0,0,0,7,0,NA
"Polyosma","Escalloniaceae","Escalloniales",2,0,0,2,2,1
"Polyotidium","Orchidaceae","Asparagales",0,0,0,1,0,NA
"Polyouratea","Ochnaceae","Malpighiales",0,0,0,4,0,NA
"Polyphlebium","Hymenophyllaceae","Hymenophyllales",0,0,0,1,0,NA
"Polypleurella","Podostemaceae","Malpighiales",0,0,0,1,0,NA
"Polypleurum","Podostemaceae","Malpighiales",0,0,0,4,0,NA
"Polypodiastrum","Polypodiaceae","Polypodiales",0,0,0,4,0,NA
"Polypodiodes","Polypodiaceae","Polypodiales",0,0,0,14,0,NA
"Polypodiopsis","Polypodiaceae","Polypodiales",0,0,0,1,0,NA
"Polypodiopteris","Polypodiaceae","Polypodiales",0,0,0,2,0,NA
"Polypodium","Polypodiaceae","Polypodiales",0,0,6,166,6,0
"Polypogon","Poaceae","Poales",0,0,4,21,4,0
"Polypogonagrostis","Poaceae","Poales",0,0,0,1,0,NA
"Polyporandra","Icacinaceae","UnknownOrder-Icacinaceae",1,0,0,1,1,1
"Polypremum","Tetrachondraceae","Lamiales",0,0,1,1,1,0
"Polypsecadium","Brassicaceae","Brassicales",0,0,0,14,0,NA
"Polyscias","Araliaceae","Apiales",15,0,0,176,15,1
"Polyspatha","Commelinaceae","Commelinales",0,0,1,3,1,0
"Polysphaeria","Rubiaceae","Gentianales",3,0,0,22,3,1
"Polyspora","Theaceae","Ericales",4,0,0,4,4,1
"Polystachya","Orchidaceae","Asparagales",0,0,10,245,10,0
"Polystemma","Apocynaceae","Gentianales",1,0,0,3,1,1
"Polystemonanthus","Fabaceae","Fabales",0,0,0,1,0,NA
"Polystichopsis","Dryopteridaceae","Polypodiales",0,0,0,4,0,NA
"Polystichum","Dryopteridaceae","Polypodiales",0,0,12,276,12,0
"Polytaenia","Apiaceae","Apiales",0,0,0,2,0,NA
"Polytaenium","Pteridaceae","Polypodiales",0,0,0,8,0,NA
"Polytaxis","Asteraceae","Asterales",0,0,0,3,0,NA
"Polytepalum","Caryophyllaceae","Caryophyllales",0,0,0,1,0,NA
"Polytoca","Poaceae","Poales",0,0,0,2,0,NA
"Polytrias","Poaceae","Poales",0,0,1,1,1,0
"Polyura","Rubiaceae","Gentianales",0,0,0,1,0,NA
"Pomaderris","Rhamnaceae","Rosales",1,0,0,1,1,1
"Pomaria","Fabaceae","Fabales",0,0,0,16,0,NA
"Pomatocalpa","Orchidaceae","Asparagales",0,0,2,25,2,0
"Pomatosace","Primulaceae","Ericales",0,0,1,1,1,0
"Pomax","Rubiaceae","Gentianales",1,0,0,1,1,1
"Pommereschea","Zingiberaceae","Zingiberales",0,0,0,2,0,NA
"Pommereulla","Poaceae","Poales",0,0,0,1,0,NA
"Ponapea","Arecaceae","Arecales",1,0,0,3,1,1
"Ponera","Orchidaceae","Asparagales",0,0,2,8,2,0
"Ponerorchis","Orchidaceae","Asparagales",0,0,0,20,0,NA
"Pongamia","Fabaceae","Fabales",1,0,0,1,1,1
"Pongamiopsis","Fabaceae","Fabales",1,0,0,3,1,1
"Pontechium","Boraginaceae","UnknownOrder-Boraginaceae",0,0,0,1,0,NA
"Pontederia","Pontederiaceae","Commelinales",0,0,3,6,3,0
"Ponthieva","Orchidaceae","Asparagales",0,0,1,65,1,0
"Popowia","Annonaceae","Magnoliales",3,0,0,18,3,1
"Populina","Acanthaceae","Lamiales",0,0,0,2,0,NA
"Populus","Salicaceae","Malpighiales",33,0,0,98,33,1
"Porana","Convolvulaceae","Solanales",1,0,0,3,1,1
"Porandra","Commelinaceae","Commelinales",0,0,0,3,0,NA
"Poranopsis","Convolvulaceae","Solanales",0,0,1,3,1,0
"Poranthera","Phyllanthaceae","Malpighiales",2,0,3,15,5,0.4
"Poraqueiba","Icacinaceae","UnknownOrder-Icacinaceae",2,0,0,3,2,1
"Porcelia","Annonaceae","Magnoliales",4,0,0,8,4,1
"Porfiria","Cactaceae","Caryophyllales",0,0,0,1,0,NA
"Porlieria","Zygophyllaceae","Zygophyllales",2,0,0,5,2,1
"Porocystis","Sapindaceae","Sapindales",0,0,0,2,0,NA
"Porodittia","Calceolariaceae","Lamiales",1,0,0,1,1,1
"Porolabium","Orchidaceae","Asparagales",0,0,0,1,0,NA
"Porophyllum","Asteraceae","Asterales",1,0,0,28,1,1
"Porpax","Orchidaceae","Asparagales",0,0,0,13,0,NA
"Porphyrodesme","Orchidaceae","Asparagales",0,0,0,3,0,NA
"Porphyroglottis","Orchidaceae","Asparagales",0,0,0,1,0,NA
"Porphyrostachys","Orchidaceae","Asparagales",0,0,0,2,0,NA
"Porphyrostemma","Asteraceae","Asterales",0,0,1,3,1,0
"Porroglossum","Orchidaceae","Asparagales",0,0,1,43,1,0
"Porrorhachis","Orchidaceae","Asparagales",0,0,0,2,0,NA
"Porsildia","Caryophyllaceae","Caryophyllales",0,0,0,1,0,NA
"Portea","Bromeliaceae","Poales",0,0,1,8,1,0
"Portenschlagiella","Apiaceae","Apiales",0,0,0,1,0,NA
"Porterandia","Rubiaceae","Gentianales",2,0,0,23,2,1
"Porterella","Campanulaceae","Asterales",0,0,0,1,0,NA
"Porteresia","Poaceae","Poales",0,0,0,1,0,NA
"Portlandia","Rubiaceae","Gentianales",0,0,0,6,0,NA
"Portulaca","Portulacaceae","Caryophyllales",0,0,14,109,14,0
"Portulacaria","Didiereaceae","Caryophyllales",1,0,0,2,1,1
"Posidonia","Posidoniaceae","Alismatales",0,0,2,10,2,0
"Posoqueria","Rubiaceae","Gentianales",4,0,0,25,4,1
"Postia","Asteraceae","Asterales",0,0,0,2,0,NA
"Postiella","Apiaceae","Apiales",0,0,0,1,0,NA
"Potalia","Gentianaceae","Gentianales",2,0,0,9,2,1
"Potameia","Lauraceae","Laurales",4,0,0,24,4,1
"Potamogeton","Potamogetonaceae","Alismatales",0,0,44,160,44,0
"Potamophila","Poaceae","Poales",0,0,0,1,0,NA
"Potarophytum","Rapateaceae","Poales",0,0,0,1,0,NA
"Potentilla","Rosaceae","Rosales",1,0,25,325,26,0.0384615384615385
"Poteranthera","Melastomataceae","Myrtales",0,0,0,2,0,NA
"Pothoidium","Araceae","Alismatales",0,0,0,1,0,NA
"Pothomorphe","Piperaceae","Piperales",0,0,0,2,0,NA
"Pothos","Araceae","Alismatales",0,0,2,58,2,0
"Potosia","Orchidaceae","Asparagales",0,0,0,3,0,NA
"Potoxylon","Lauraceae","Laurales",1,0,0,1,1,1
"Pottsia","Apocynaceae","Gentianales",0,1,0,3,0,NA
"Pouchetia","Rubiaceae","Gentianales",2,0,0,4,2,1
"Poulsenia","Moraceae","Rosales",1,0,0,1,1,1
"Poupartia","Anacardiaceae","Sapindales",1,0,0,3,1,1
"Pourouma","Urticaceae","Rosales",14,0,0,29,14,1
"Pouteria","Sapotaceae","Ericales",171,0,0,238,171,1
"Pouzolzia","Urticaceae","Rosales",1,0,0,30,1,1
"Povedadaphne","Lauraceae","Laurales",1,0,0,1,1,1
"Pozoa","Apiaceae","Apiales",0,0,1,2,1,0
"Pradosia","Sapotaceae","Ericales",17,0,0,24,17,1
"Praealstonia","Symplocaceae","Ericales",0,0,0,1,0,NA
"Praecereus","Cactaceae","Caryophyllales",0,0,0,2,0,NA
"Praecitrullus","Cucurbitaceae","Cucurbitales",0,0,1,1,1,0
"Praecoxanthus","Orchidaceae","Asparagales",0,0,0,1,0,NA
"Pranceacanthus","Acanthaceae","Lamiales",0,0,0,1,0,NA
"Prangos","Apiaceae","Apiales",0,0,0,19,0,NA
"Praravinia","Rubiaceae","Gentianales",1,0,0,49,1,1
"Prasium","Lamiaceae","Lamiales",1,0,0,1,1,1
"Prasophyllum","Orchidaceae","Asparagales",0,0,1,131,1,0
"Praxeliopsis","Asteraceae","Asterales",0,0,0,1,0,NA
"Praxelis","Asteraceae","Asterales",0,0,0,18,0,NA
"Premna","Lamiaceae","Lamiales",17,0,0,194,17,1
"Prenanthella","Asteraceae","Asterales",0,0,0,1,0,NA
"Prenanthes","Asteraceae","Asterales",0,0,1,26,1,0
"Prenia","Aizoaceae","Caryophyllales",0,0,0,4,0,NA
"Prepodesma","Aizoaceae","Caryophyllales",0,0,0,1,0,NA
"Prepusa","Gentianaceae","Gentianales",0,0,0,5,0,NA
"Prescottia","Orchidaceae","Asparagales",0,0,1,26,1,0
"Presliophytum","Loasaceae","Cornales",0,0,1,3,1,0
"Prestelia","Asteraceae","Asterales",0,0,0,1,0,NA
"Prestoea","Arecaceae","Arecales",9,0,0,10,9,1
"Prestonia","Apocynaceae","Gentianales",3,6,0,64,3,1
"Preussiella","Melastomataceae","Myrtales",0,0,0,2,0,NA
"Preussiodora","Rubiaceae","Gentianales",0,0,0,1,0,NA
"Priestleya","Fabaceae","Fabales",0,0,0,15,0,NA
"Primula","Primulaceae","Ericales",0,0,110,392,110,0
"Primulina","Gesneriaceae","Lamiales",0,0,1,121,1,0
"Principina","Cyperaceae","Poales",0,0,0,1,0,NA
"Pringlea","Brassicaceae","Brassicales",0,0,0,1,0,NA
"Pringleochloa","Poaceae","Poales",0,0,0,1,0,NA
"Prinos","Aquifoliaceae","Aquifoliales",0,0,0,1,0,NA
"Prinsepia","Rosaceae","Rosales",3,0,0,4,3,1
"Printzia","Asteraceae","Asterales",1,0,0,6,1,1
"Priogymnanthus","Oleaceae","Lamiales",1,0,0,2,1,1
"Prionanthium","Poaceae","Poales",0,0,1,3,1,0
"Prionium","Thurniaceae","Poales",0,0,1,1,1,0
"Prionosciadium","Apiaceae","Apiales",0,0,0,11,0,NA
"Prionostemma","Celastraceae","Celastrales",1,0,0,4,1,1
"Prioria","Fabaceae","Fabales",3,0,0,13,3,1
"Prismatocarpus","Campanulaceae","Asterales",1,1,0,29,1,1
"Prismatomeris","Rubiaceae","Gentianales",1,0,0,15,1,1
"Pristimera","Celastraceae","Celastrales",1,0,0,26,1,1
"Pritchardia","Arecaceae","Arecales",1,0,0,29,1,1
"Priva","Verbenaceae","Lamiales",0,0,2,23,2,0
"Proboscidea","Martyniaceae","Lamiales",0,0,5,10,5,0
"Prochnyanthes","Asparagaceae","Asparagales",0,0,1,1,1,0
"Prockia","Salicaceae","Malpighiales",2,0,0,5,2,1
"Prockiopsis","Achariaceae","Malpighiales",0,0,0,3,0,NA
"Procris","Urticaceae","Rosales",0,0,0,2,0,NA
"Proferea","Thelypteridaceae","Polypodiales",0,0,0,1,0,NA
"Proiphys","Amaryllidaceae","Asparagales",0,0,1,4,1,0
"Prolobus","Asteraceae","Asterales",0,0,0,1,0,NA
"Prolongoa","Asteraceae","Asterales",0,0,0,1,0,NA
"Promenaea","Orchidaceae","Asparagales",0,0,3,18,3,0
"Prometheum","Crassulaceae","Saxifragales",0,0,0,2,0,NA
"Pronacron","Asteraceae","Asterales",0,0,0,1,0,NA
"Pronephrium","Thelypteridaceae","Polypodiales",0,0,0,52,0,NA
"Prosaptia","Polypodiaceae","Polypodiales",0,0,0,3,0,NA
"Prosartes","Liliaceae","Liliales",0,0,4,6,4,0
"Proserpinaca","Haloragaceae","Saxifragales",0,0,1,4,1,0
"Prosopanche","Hydnoraceae","Piperales",0,0,1,3,1,0
"Prosopidastrum","Fabaceae","Fabales",1,0,0,5,1,1
"Prosopis","Fabaceae","Fabales",24,0,0,47,24,1
"Prospero","Asparagaceae","Asparagales",0,0,1,14,1,0
"Prosphytochloa","Poaceae","Poales",0,0,0,1,0,NA
"Prostanthera","Lamiaceae","Lamiales",14,0,0,92,14,1
"Prostea","Sapindaceae","Sapindales",0,0,0,1,0,NA
"Prosthechea","Orchidaceae","Asparagales",0,0,13,118,13,0
"Protarum","Araceae","Alismatales",0,0,0,1,0,NA
"Protea","Proteaceae","Proteales",47,0,0,101,47,1
"Proteopsis","Asteraceae","Asterales",0,0,0,1,0,NA
"Protium","Burseraceae","Sapindales",49,0,0,104,49,1
"Protomegabaria","Phyllanthaceae","Malpighiales",1,0,0,3,1,1
"Protorhus","Anacardiaceae","Sapindales",1,0,0,2,1,1
"Protoschwenkia","Solanaceae","Solanales",0,0,0,1,0,NA
"Prototulbaghia","Amaryllidaceae","Asparagales",0,0,0,1,0,NA
"Proustia","Asteraceae","Asterales",0,0,0,3,0,NA
"Prumnopitys","Podocarpaceae","Araucariales",8,0,0,9,8,1
"Prunella","Lamiaceae","Lamiales",0,0,5,13,5,0
"Prunus","Rosaceae","Rosales",73,0,0,254,73,1
"Przewalskia","Solanaceae","Solanales",0,0,1,1,1,0
"Psacadopaepale","Acanthaceae","Lamiales",0,0,0,1,0,NA
"Psacaliopsis","Asteraceae","Asterales",0,0,0,4,0,NA
"Psacalium","Asteraceae","Asterales",0,0,0,47,0,NA
"Psammagrostis","Poaceae","Poales",0,0,0,1,0,NA
"Psammetes","Plantaginaceae","Lamiales",0,0,0,1,0,NA
"Psammiosorus","Tectariaceae","Polypodiales",0,0,0,1,0,NA
"Psammisia","Ericaceae","Ericales",4,0,0,45,4,1
"Psammochloa","Poaceae","Poales",0,0,1,1,1,0
"Psammogeton","Apiaceae","Apiales",0,0,0,3,0,NA
"Psammomoya","Celastraceae","Celastrales",1,0,0,1,1,1
"Psammophiliella","Caryophyllaceae","Caryophyllales",0,0,0,4,0,NA
"Psammophora","Aizoaceae","Caryophyllales",0,0,0,4,0,NA
"Psammosilene","Caryophyllaceae","Caryophyllales",0,0,0,1,0,NA
"Psammotropha","Molluginaceae","Caryophyllales",0,0,0,11,0,NA
"Psathura","Rubiaceae","Gentianales",1,0,0,8,1,1
"Psathyrostachys","Poaceae","Poales",0,0,7,10,7,0
"Psathyrotes","Asteraceae","Asterales",1,0,0,3,1,1
"Psathyrotopsis","Asteraceae","Asterales",0,0,0,3,0,NA
"Psedera","Vitaceae","Vitales",0,0,0,2,0,NA
"Psednotrichia","Asteraceae","Asterales",0,0,0,2,0,NA
"Psephellus","Asteraceae","Asterales",0,0,1,90,1,0
"Pseudabutilon","Malvaceae","Malvales",0,0,0,19,0,NA
"Pseudadenia","Orchidaceae","Asparagales",0,0,0,3,0,NA
"Pseudagrostistachys","Euphorbiaceae","Malpighiales",1,0,0,2,1,1
"Pseudaidia","Rubiaceae","Gentianales",0,0,0,1,0,NA
"Pseudanamomis","Myrtaceae","Myrtales",0,0,0,1,0,NA
"Pseudanastatica","Brassicaceae","Brassicales",0,0,0,1,0,NA
"Pseudannona","Annonaceae","Magnoliales",0,0,0,2,0,NA
"Pseudanthera","Orchidaceae","Asparagales",0,0,0,1,0,NA
"Pseudanthistiria","Poaceae","Poales",0,0,1,4,1,0
"Pseudanthus","Picrodendraceae","Malpighiales",1,0,0,9,1,1
"Pseudartabotrys","Annonaceae","Magnoliales",1,0,0,1,1,1
"Pseudarthria","Fabaceae","Fabales",0,0,0,6,0,NA
"Pseudechinolaena","Poaceae","Poales",0,0,3,6,3,0
"Pseudelephantopus","Asteraceae","Asterales",0,0,0,1,0,NA
"Pseudeminia","Fabaceae","Fabales",0,0,1,4,1,0
"Pseudephedranthus","Annonaceae","Magnoliales",1,0,0,1,1,1
"Pseuderanthemum","Acanthaceae","Lamiales",0,0,2,47,2,0
"Pseuderia","Orchidaceae","Asparagales",0,0,1,20,1,0
"Pseuderucaria","Brassicaceae","Brassicales",0,0,0,2,0,NA
"Pseudibatia","Apocynaceae","Gentianales",0,0,0,2,0,NA
"Pseudima","Sapindaceae","Sapindales",1,0,0,2,1,1
"Pseudinium","Orchidaceae","Asparagales",0,0,0,1,0,NA
"Pseudiosma","Rutaceae","Sapindales",0,0,0,1,0,NA
"Pseudiris","Iridaceae","Asparagales",0,0,0,1,0,NA
"Pseuditella","Orchidaceae","Asparagales",0,0,0,2,0,NA
"Pseudoacanthocereus","Cactaceae","Caryophyllales",0,0,0,2,0,NA
"Pseudoarabidopsis","Brassicaceae","Brassicales",0,0,0,1,0,NA
"Pseudobaeckea","Bruniaceae","Bruniales",0,0,0,1,0,NA
"Pseudobahia","Asteraceae","Asterales",0,0,0,3,0,NA
"Pseudobartsia","Orobanchaceae","Lamiales",0,0,0,1,0,NA
"Pseudoberlinia","Fabaceae","Fabales",0,0,0,3,0,NA
"Pseudobersama","Meliaceae","Sapindales",1,0,0,1,1,1
"Pseudobetckea","Caprifoliaceae","Dipsacales",0,0,0,1,0,NA
"Pseudoblepharispermum","Asteraceae","Asterales",0,0,0,2,0,NA
"Pseudobombax","Malvaceae","Malvales",7,0,0,22,7,1
"Pseudobotrys","Cardiopteridaceae","Aquifoliales",0,0,0,2,0,NA
"Pseudobrickellia","Asteraceae","Asterales",0,0,0,3,0,NA
"Pseudocalyx","Acanthaceae","Lamiales",0,0,0,5,0,NA
"Pseudocamelina","Brassicaceae","Brassicales",0,0,0,3,0,NA
"Pseudocannaboides","Apiaceae","Apiales",0,0,0,1,0,NA
"Pseudocarpidium","Lamiaceae","Lamiales",0,0,0,9,0,NA
"Pseudocarum","Apiaceae","Apiales",0,0,0,2,0,NA
"Pseudocaryopteris","Lamiaceae","Lamiales",2,0,0,3,2,1
"Pseudocedrela","Meliaceae","Sapindales",1,0,0,1,1,1
"Pseudocentrum","Orchidaceae","Asparagales",0,0,0,7,0,NA
"Pseudocerastium","Caryophyllaceae","Caryophyllales",0,0,0,1,0,NA
"Pseudochamaesphacos","Lamiaceae","Lamiales",0,0,0,1,0,NA
"Pseudochirita","Gesneriaceae","Lamiales",0,0,0,1,0,NA
"Pseudoclappia","Asteraceae","Asterales",1,0,0,2,1,1
"Pseudoclausena","Meliaceae","Sapindales",1,0,0,1,1,1
"Pseudoclausia","Brassicaceae","Brassicales",0,0,0,10,0,NA
"Pseudocolysis","Polypodiaceae","Polypodiales",0,0,0,1,0,NA
"Pseudoconnarus","Connaraceae","Oxalidales",0,0,0,5,0,NA
"Pseudocorchorus","Malvaceae","Malvales",0,0,0,5,0,NA
"Pseudocyclanthera","Cucurbitaceae","Cucurbitales",0,0,0,1,0,NA
"Pseudocyclosorus","Thelypteridaceae","Polypodiales",0,0,0,39,0,NA
"Pseudocymopterus","Apiaceae","Apiales",0,0,0,2,0,NA
"Pseudocystopteris","Athyriaceae","Polypodiales",0,0,0,7,0,NA
"Pseudodanthonia","Poaceae","Poales",0,0,0,1,0,NA
"Pseudodichanthium","Poaceae","Poales",0,0,0,1,0,NA
"Pseudodicliptera","Acanthaceae","Lamiales",0,0,0,4,0,NA
"Pseudodiphasium","Lycopodiaceae","Lycopodiales",0,0,1,1,1,0
"Pseudodiplospora","Rubiaceae","Gentianales",0,0,0,1,0,NA
"Pseudodracontium","Araceae","Alismatales",0,0,2,7,2,0
"Pseudodrynaria","Polypodiaceae","Polypodiales",0,0,0,1,0,NA
"Pseudoeriosema","Fabaceae","Fabales",0,0,0,5,0,NA
"Pseudofortuynia","Brassicaceae","Brassicales",0,0,0,1,0,NA
"Pseudofumaria","Papaveraceae","Ranunculales",0,0,0,2,0,NA
"Pseudogaltonia","Asparagaceae","Asparagales",0,0,1,1,1,0
"Pseudogaltonia","Liliaceae",NA,0,0,0,1,0,NA
"Pseudoglossanthis","Asteraceae","Asterales",0,0,0,1,0,NA
"Pseudognaphalium","Asteraceae","Asterales",0,0,0,84,0,NA
"Pseudogoodyera","Orchidaceae","Asparagales",0,0,0,1,0,NA
"Pseudogynoxys","Asteraceae","Asterales",0,0,0,15,0,NA
"Pseudohamelia","Rubiaceae","Gentianales",0,0,0,1,0,NA
"Pseudohandelia","Asteraceae","Asterales",0,0,0,1,0,NA
"Pseudohydrosme","Araceae","Alismatales",0,0,0,2,0,NA
"Pseudojacobaea","Asteraceae","Asterales",0,0,0,1,0,NA
"Pseudokyrsteniopsis","Asteraceae","Asterales",0,0,0,1,0,NA
"Pseudolachnostylis","Phyllanthaceae","Malpighiales",1,0,0,1,1,1
"Pseudolaelia","Orchidaceae","Asparagales",0,0,2,19,2,0
"Pseudolarix","Pinaceae","Pinales",1,0,0,1,1,1
"Pseudoligandra","Asteraceae","Asterales",0,0,0,1,0,NA
"Pseudolinosyris","Asteraceae","Asterales",0,0,0,3,0,NA
"Pseudolithos","Apocynaceae","Gentianales",0,0,0,6,0,NA
"Pseudolmedia","Moraceae","Rosales",6,0,0,10,6,1
"Pseudolopezia","Onagraceae","Myrtales",0,0,0,2,0,NA
"Pseudolotus","Fabaceae","Fabales",0,0,0,1,0,NA
"Pseudolycopodiella","Lycopodiaceae","Lycopodiales",0,0,5,6,5,0
"Pseudolycopodium","Lycopodiaceae","Lycopodiales",0,0,1,1,1,0
"Pseudolysimachion","Plantaginaceae","Lamiales",0,0,0,4,0,NA
"Pseudomacrolobium","Fabaceae","Fabales",0,0,0,1,0,NA
"Pseudomalmea","Annonaceae","Magnoliales",1,0,0,4,1,1
"Pseudomantalania","Rubiaceae","Gentianales",0,0,0,1,0,NA
"Pseudomarrubium","Lamiaceae","Lamiales",0,0,0,1,0,NA
"Pseudomertensia","Boraginaceae","UnknownOrder-Boraginaceae",0,0,0,12,0,NA
"Pseudomiltemia","Rubiaceae","Gentianales",0,0,0,2,0,NA
"Pseudomitrocereus","Cactaceae","Caryophyllales",0,0,0,1,0,NA
"Pseudomorus","Moraceae","Rosales",1,0,0,1,1,1
"Pseudomuscari","Asparagaceae","Asparagales",0,0,0,7,0,NA
"Pseudomussaenda","Rubiaceae","Gentianales",1,0,0,6,1,1
"Pseudonemacladus","Campanulaceae","Asterales",0,0,1,1,1,0
"Pseudonesohedyotis","Rubiaceae","Gentianales",0,0,0,1,0,NA
"Pseudonoseris","Asteraceae","Asterales",0,0,0,4,0,NA
"Pseudopanax","Araliaceae","Apiales",3,0,0,7,3,1
"Pseudopancovia","Sapindaceae","Sapindales",0,0,0,1,0,NA
"Pseudoparis","Commelinaceae","Commelinales",0,0,0,3,0,NA
"Pseudopectinaria","Apocynaceae","Gentianales",0,0,0,1,0,NA
"Pseudopentameris","Poaceae","Poales",0,0,1,3,1,0
"Pseudophegopteris","Thelypteridaceae","Polypodiales",0,0,0,18,0,NA
"Pseudophoenix","Arecaceae","Arecales",4,0,0,4,4,1
"Pseudophyllanthus","Phyllanthaceae","Malpighiales",1,0,0,1,1,1
"Pseudopilocereus","Cactaceae","Caryophyllales",0,0,0,2,0,NA
"Pseudopiptadenia","Fabaceae","Fabales",3,0,0,11,3,1
"Pseudopiptocarpha","Asteraceae","Asterales",0,0,0,4,0,NA
"Pseudoplantago","Amaranthaceae","Caryophyllales",0,0,1,2,1,0
"Pseudoprosopis","Fabaceae","Fabales",1,0,0,7,1,1
"Pseudoprospero","Asparagaceae","Asparagales",0,0,1,1,1,0
"Pseudopteris","Sapindaceae","Sapindales",0,0,0,3,0,NA
"Pseudopteryxia","Apiaceae","Apiales",0,0,0,1,0,NA
"Pseudopyxis","Rubiaceae","Gentianales",0,0,0,3,0,NA
"Pseudoraphis","Poaceae","Poales",0,0,2,6,2,0
"Pseudorchis","Orchidaceae","Asparagales",0,0,0,1,0,NA
"Pseudoreoxis","Apiaceae","Apiales",0,0,0,1,0,NA
"Pseudorhipsalis","Cactaceae","Caryophyllales",0,0,0,7,0,NA
"Pseudorhiza","Orchidaceae","Asparagales",0,0,0,5,0,NA
"Pseudorlaya","Apiaceae","Apiales",0,0,0,2,0,NA
"Pseudoroegneria","Poaceae","Poales",0,0,0,1,0,NA
"Pseudorontium","Plantaginaceae","Lamiales",0,0,0,1,0,NA
"Pseudoruellia","Acanthaceae","Lamiales",0,0,0,1,0,NA
"Pseudosalacia","Celastraceae","Celastrales",1,0,0,1,1,1
"Pseudosamanea","Fabaceae","Fabales",0,0,0,1,0,NA
"Pseudosaponaria","Caryophyllaceae","Caryophyllales",0,0,0,1,0,NA
"Pseudosarcopera","Marcgraviaceae","Ericales",0,0,0,1,0,NA
"Pseudosasa","Poaceae","Poales",2,0,0,21,2,1
"Pseudoschoenus","Cyperaceae","Poales",0,0,0,1,0,NA
"Pseudosclerochloa","Poaceae","Poales",0,0,2,2,2,0
"Pseudoscolopia","Salicaceae","Malpighiales",0,0,0,1,0,NA
"Pseudosedum","Crassulaceae","Saxifragales",0,0,0,7,0,NA
"Pseudoselago","Scrophulariaceae","Lamiales",0,0,2,27,2,0
"Pseudoselinum","Apiaceae","Apiales",0,0,0,1,0,NA
"Pseudosempervivum","Brassicaceae","Brassicales",0,0,0,4,0,NA
"Pseudosenefeldera","Euphorbiaceae","Malpighiales",1,0,0,1,1,1
"Pseudosericocoma","Amaranthaceae","Caryophyllales",0,0,0,1,0,NA
"Pseudosicydium","Cucurbitaceae","Cucurbitales",0,0,0,1,0,NA
"Pseudosindora","Fabaceae","Fabales",1,0,0,1,1,1
"Pseudosmodingium","Anacardiaceae","Sapindales",2,0,0,7,2,1
"Pseudosorghum","Poaceae","Poales",0,0,0,2,0,NA
"Pseudospondias","Anacardiaceae","Sapindales",1,0,0,2,1,1
"Pseudostachyum","Poaceae","Poales",0,0,0,1,0,NA
"Pseudostellaria","Caryophyllaceae","Caryophyllales",0,0,0,17,0,NA
"Pseudostenosiphonium","Acanthaceae","Lamiales",0,0,0,1,0,NA
"Pseudostifftia","Asteraceae","Asterales",0,0,0,1,0,NA
"Pseudotaenidia","Apiaceae","Apiales",0,0,0,1,0,NA
"Pseudotaxus","Taxaceae","Cupressales",1,0,0,1,1,1
"Pseudotectaria","Tectariaceae","Polypodiales",0,0,0,1,0,NA
"Pseudotrachydium","Apiaceae","Apiales",0,0,0,1,0,NA
"Pseudotrillium","Melanthiaceae","Liliales",0,0,1,1,1,0
"Pseudotrimezia","Iridaceae","Asparagales",0,0,4,18,4,0
"Pseudotsuga","Pinaceae","Pinales",3,0,0,4,3,1
"Pseudovanilla","Orchidaceae","Asparagales",0,0,2,8,2,0
"Pseudovesicaria","Brassicaceae","Brassicales",0,0,0,1,0,NA
"Pseudovigna","Fabaceae","Fabales",0,0,1,2,1,0
"Pseudoweinmannia","Cunoniaceae","Oxalidales",1,0,0,2,1,1
"Pseudowintera","Winteraceae","Canellales",3,0,0,3,3,1
"Pseudoxandra","Annonaceae","Magnoliales",4,0,0,18,4,1
"Pseudoxytenanthera","Poaceae","Poales",0,0,0,4,0,NA
"Pseudoyoungia","Asteraceae","Asterales",0,0,0,8,0,NA
"Pseudozoysia","Poaceae","Poales",0,0,0,1,0,NA
"Pseuduvaria","Annonaceae","Magnoliales",5,0,0,28,5,1
"Psiadia","Asteraceae","Asterales",0,0,0,42,0,NA
"Psiadiella","Asteraceae","Asterales",0,0,0,1,0,NA
"Psidium","Myrtaceae","Myrtales",7,0,0,112,7,1
"Psiguria","Cucurbitaceae","Cucurbitales",0,0,2,6,2,0
"Psila","Asteraceae","Asterales",1,0,0,1,1,1
"Psilactis","Asteraceae","Asterales",0,0,0,5,0,NA
"Psilanthele","Acanthaceae","Lamiales",0,0,0,1,0,NA
"Psilocarphus","Asteraceae","Asterales",0,0,0,6,0,NA
"Psilocarya","Cyperaceae","Poales",0,0,0,1,0,NA
"Psilocaulon","Aizoaceae","Caryophyllales",1,0,0,65,1,1
"Psilochilus","Orchidaceae","Asparagales",0,0,0,7,0,NA
"Psilogramme","Pteridaceae","Polypodiales",0,0,0,3,0,NA
"Psilolaemus","Boraginaceae","UnknownOrder-Boraginaceae",0,0,0,1,0,NA
"Psilolemma","Poaceae","Poales",0,0,0,1,0,NA
"Psilopeganum","Rutaceae","Sapindales",0,0,0,1,0,NA
"Psilorhegma","Fabaceae","Fabales",0,0,0,1,0,NA
"Psilostrophe","Asteraceae","Asterales",0,1,0,7,0,NA
"Psilotrichopsis","Amaranthaceae","Caryophyllales",0,0,0,1,0,NA
"Psilotrichum","Amaranthaceae","Caryophyllales",1,0,1,16,2,0.5
"Psilotum","Psilotaceae","Psilotales",0,0,2,2,2,0
"Psiloxylon","Myrtaceae","Myrtales",1,0,0,1,1,1
"Psilurus","Poaceae","Poales",0,0,0,1,0,NA
"Psittacanthus","Loranthaceae","Santalales",2,0,0,74,2,1
"Psomiocarpa","Tectariaceae","Polypodiales",0,0,0,1,0,NA
"Psophocarpus","Fabaceae","Fabales",0,0,2,10,2,0
"Psoralea","Fabaceae","Fabales",1,0,4,101,5,0.2
"Psoralidium","Fabaceae","Fabales",0,0,0,2,0,NA
"Psorospermum","Hypericaceae","Malpighiales",1,0,0,43,1,1
"Psorothamnus","Fabaceae","Fabales",4,0,0,10,4,1
"Psychilis","Orchidaceae","Asparagales",0,0,2,17,2,0
"Psychine","Brassicaceae","Brassicales",0,0,0,1,0,NA
"Psychopsis","Orchidaceae","Asparagales",0,0,1,5,1,0
"Psychopterys","Malpighiaceae","Malpighiales",0,0,0,3,0,NA
"Psychotria","Rubiaceae","Gentianales",78,0,1,1865,79,0.987341772151899
"Psychrogeton","Asteraceae","Asterales",0,0,0,14,0,NA
"Psychrophila","Ranunculaceae","Ranunculales",0,0,0,1,0,NA
"Psydrax","Rubiaceae","Gentianales",13,0,0,80,13,1
"Psylliostachys","Plumbaginaceae","Caryophyllales",0,0,1,3,1,0
"Psyllocarpus","Rubiaceae","Gentianales",0,0,1,9,1,0
"Psytonia","Orchidaceae","Asparagales",0,0,0,1,0,NA
"Ptaeroxylon","Rutaceae","Sapindales",1,0,0,1,1,1
"Ptarmica","Asteraceae","Asterales",0,0,0,9,0,NA
"Ptelea","Rutaceae","Sapindales",1,0,0,5,1,1
"Pteleopsis","Combretaceae","Myrtales",4,0,0,10,4,1
"Ptelidium","Celastraceae","Celastrales",0,0,0,2,0,NA
"Pteracanthus","Acanthaceae","Lamiales",0,0,0,3,0,NA
"Pterachaenia","Asteraceae","Asterales",0,0,0,1,0,NA
"Pteralyxia","Apocynaceae","Gentianales",1,0,0,3,1,1
"Pterandra","Malpighiaceae","Malpighiales",1,0,0,13,1,1
"Pteranthus","Caryophyllaceae","Caryophyllales",0,0,0,1,0,NA
"Pteretis","Onocleaceae","Polypodiales",0,0,0,1,0,NA
"Pterichis","Orchidaceae","Asparagales",0,0,0,20,0,NA
"Pteridella","Pteridaceae","Polypodiales",0,0,0,1,0,NA
"Pteridium","Dennstaedtiaceae","Polypodiales",0,0,2,11,2,0
"Pteridocalyx","Rubiaceae","Gentianales",0,0,0,2,0,NA
"Pteridrys","Tectariaceae","Polypodiales",0,0,0,7,0,NA
"Pterigeron","Asteraceae","Asterales",0,0,0,1,0,NA
"Pteris","Pteridaceae","Polypodiales",0,0,147,187,147,0
"Pternandra","Melastomataceae","Myrtales",2,0,0,3,2,1
"Pternopetalum","Apiaceae","Apiales",0,0,1,26,1,0
"Pterocactus","Cactaceae","Caryophyllales",0,0,0,6,0,NA
"Pterocarpus","Fabaceae","Fabales",17,0,0,66,17,1
"Pterocarya","Juglandaceae","Fagales",5,0,0,6,5,1
"Pterocaulon","Asteraceae","Asterales",0,0,2,20,2,0
"Pterocelastrus","Celastraceae","Celastrales",1,0,0,4,1,1
"Pteroceltis","Cannabaceae","Rosales",1,0,0,1,1,1
"Pterocephalidium","Caprifoliaceae","Dipsacales",0,0,0,1,0,NA
"Pterocephalodes","Caprifoliaceae","Dipsacales",0,0,0,1,0,NA
"Pterocephalus","Caprifoliaceae","Dipsacales",0,0,1,11,1,0
"Pteroceras","Orchidaceae","Asparagales",0,0,2,27,2,0
"Pterocereus","Cactaceae","Caryophyllales",0,0,0,1,0,NA
"Pterochaeta","Asteraceae","Asterales",0,0,1,1,1,0
"Pterochlamys","Convolvulaceae","Solanales",0,0,0,1,0,NA
"Pterocypsela","Asteraceae","Asterales",0,0,0,1,0,NA
"Pterodiscus","Pedaliaceae","Lamiales",0,0,0,5,0,NA
"Pterodon","Fabaceae","Fabales",1,0,0,2,1,1
"Pterogaillonia","Rubiaceae","Gentianales",1,0,0,1,1,1
"Pterogastra","Melastomataceae","Myrtales",0,0,0,2,0,NA
"Pteroglossa","Orchidaceae","Asparagales",0,0,0,11,0,NA
"Pterogyne","Fabaceae","Fabales",1,0,0,1,1,1
"Pterolepis","Melastomataceae","Myrtales",1,0,0,16,1,1
"Pterolobium","Fabaceae","Fabales",0,0,0,11,0,NA
"Pteromanes","Hymenophyllaceae","Hymenophyllales",0,0,0,2,0,NA
"Pteromonnina","Polygalaceae","Fabales",0,0,0,19,0,NA
"Pteronia","Asteraceae","Asterales",1,0,0,72,1,1
"Pteropepon","Cucurbitaceae","Cucurbitales",0,0,1,4,1,0
"Pteropsis","Polypodiaceae","Polypodiales",0,0,1,2,1,0
"Pteroptychia","Acanthaceae","Lamiales",0,0,0,1,0,NA
"Pteropyrum","Polygonaceae","Caryophyllales",0,0,0,2,0,NA
"Pterospermum","Malvaceae","Malvales",5,0,0,10,5,1
"Pterospora","Ericaceae","Ericales",0,0,0,1,0,NA
"Pterostegia","Polygonaceae","Caryophyllales",0,0,0,1,0,NA
"Pterostemma","Orchidaceae","Asparagales",0,0,0,3,0,NA
"Pterostemon","Iteaceae","Saxifragales",0,0,0,1,0,NA
"Pterostylis","Orchidaceae","Asparagales",0,0,12,215,12,0
"Pterostyrax","Styracaceae","Ericales",3,0,0,3,3,1
"Pterotheca","Asteraceae","Asterales",0,0,0,1,0,NA
"Pteroxygonum","Polygonaceae","Caryophyllales",0,0,0,1,0,NA
"Pterozonium","Pteridaceae","Polypodiales",0,0,0,14,0,NA
"Pterygiella","Orobanchaceae","Lamiales",0,0,0,5,0,NA
"Pterygocalyx","Gentianaceae","Gentianales",0,0,0,1,0,NA
"Pterygodium","Orchidaceae","Asparagales",0,0,1,19,1,0
"Pterygopappus","Asteraceae","Asterales",0,0,0,1,0,NA
"Pterygopleurum","Apiaceae","Apiales",0,0,0,1,0,NA
"Pterygostemon","Brassicaceae","Brassicales",0,0,0,1,0,NA
"Pterygota","Malvaceae","Malvales",4,0,0,11,4,1
"Pteryxia","Apiaceae","Apiales",0,0,0,3,0,NA
"Ptilimnium","Apiaceae","Apiales",0,0,0,7,0,NA
"Ptilochaeta","Malpighiaceae","Malpighiales",2,0,0,4,2,1
"Ptilophyllum","Hymenophyllaceae","Hymenophyllales",0,0,0,5,0,NA
"Ptiloria","Asteraceae","Asterales",0,0,0,1,0,NA
"Ptilostemon","Asteraceae","Asterales",0,0,1,18,1,0
"Ptilothrix","Cyperaceae","Poales",0,0,1,1,1,0
"Ptilotrichum","Brassicaceae","Brassicales",0,0,2,11,2,0
"Ptilotus","Amaranthaceae","Caryophyllales",1,0,2,16,3,0.333333333333333
"Ptisana","Marattiaceae","Marattiales",0,0,19,20,19,0
"Ptychococcus","Arecaceae","Arecales",1,0,0,2,1,1
"Ptycholobium","Fabaceae","Fabales",0,0,0,3,0,NA
"Ptychopetalum","Olacaceae","Santalales",2,0,0,4,2,1
"Ptychophyllum","Hymenophyllaceae","Hymenophyllales",0,0,0,1,0,NA
"Ptychopyxis","Euphorbiaceae","Malpighiales",4,0,0,13,4,1
"Ptychosema","Fabaceae","Fabales",0,0,0,2,0,NA
"Ptychosperma","Arecaceae","Arecales",5,0,0,29,5,1
"Ptychotis","Apiaceae","Apiales",0,0,0,1,0,NA
"Ptyssiglottis","Acanthaceae","Lamiales",0,0,0,3,0,NA
"Pubistylus","Rubiaceae","Gentianales",0,0,0,1,0,NA
"Puccinellia","Poaceae","Poales",0,0,12,110,12,0
"Pucciphippsia","Poaceae","Poales",0,0,0,2,0,NA
"Puebloa","Cactaceae","Caryophyllales",0,0,0,1,0,NA
"Puelia","Poaceae","Poales",0,0,2,5,2,0
"Pueraria","Fabaceae","Fabales",0,1,0,20,0,NA
"Pugionium","Brassicaceae","Brassicales",0,0,1,3,1,0
"Pulchranthus","Acanthaceae","Lamiales",0,0,0,4,0,NA
"Pulicaria","Asteraceae","Asterales",0,0,3,68,3,0
"Pulmonaria","Boraginaceae","UnknownOrder-Boraginaceae",0,0,2,15,2,0
"Pulsatilla","Ranunculaceae","Ranunculales",0,0,1,17,1,0
"Pultenaea","Fabaceae","Fabales",15,0,0,104,15,1
"Puna","Cactaceae","Caryophyllales",0,0,0,2,0,NA
"Punctillaria","Aizoaceae","Caryophyllales",0,0,0,1,0,NA
"Punduana","Asteraceae","Asterales",0,0,0,1,0,NA
"Punica","Lythraceae","Myrtales",2,0,0,2,2,1
"Punjuba","Fabaceae","Fabales",0,0,0,1,0,NA
"Pupalia","Amaranthaceae","Caryophyllales",0,0,1,3,1,0
"Pupilla","Acanthaceae","Lamiales",0,0,0,1,0,NA
"Purdiaea","Clethraceae","Ericales",2,0,0,5,2,1
"Purdieanthus","Gentianaceae","Gentianales",0,0,0,1,0,NA
"Purpureostemon","Myrtaceae","Myrtales",1,0,0,1,1,1
"Purshia","Rosaceae","Rosales",3,0,0,8,3,1
"Pusaetha","Fabaceae","Fabales",0,0,0,3,0,NA
"Puschkinia","Asparagaceae","Asparagales",0,0,1,2,1,0
"Putranjiva","Putranjivaceae","Malpighiales",4,0,0,4,4,1
"Putterlickia","Celastraceae","Celastrales",2,0,0,2,2,1
"Puya","Bromeliaceae","Poales",0,0,13,227,13,0
"Pycnandra","Sapotaceae","Ericales",2,0,0,45,2,1
"Pycnanthemum","Lamiaceae","Lamiales",0,0,9,20,9,0
"Pycnanthus","Myristicaceae","Magnoliales",2,0,0,3,2,1
"Pycnarrhena","Menispermaceae","Ranunculales",0,2,0,3,0,NA
"Pycnobotrya","Apocynaceae","Gentianales",0,0,0,1,0,NA
"Pycnocoma","Euphorbiaceae","Malpighiales",2,0,0,18,2,1
"Pycnocomon","Caprifoliaceae","Dipsacales",0,0,0,1,0,NA
"Pycnocycla","Apiaceae","Apiales",0,0,0,1,0,NA
"Pycnodoria","Pteridaceae","Polypodiales",0,0,0,1,0,NA
"Pycnophyllopsis","Caryophyllaceae","Caryophyllales",0,0,0,4,0,NA
"Pycnophyllum","Caryophyllaceae","Caryophyllales",0,0,0,25,0,NA
"Pycnoplinthopsis","Brassicaceae","Brassicales",0,0,0,1,0,NA
"Pycnoplinthus","Brassicaceae","Brassicales",0,0,0,2,0,NA
"Pycnosorus","Asteraceae","Asterales",0,0,3,6,3,0
"Pycnospatha","Araceae","Alismatales",0,0,0,2,0,NA
"Pycnosphaera","Gentianaceae","Gentianales",0,0,0,1,0,NA
"Pycnospora","Fabaceae","Fabales",0,0,0,1,0,NA
"Pycnostachys","Lamiaceae","Lamiales",1,0,1,36,2,0.5
"Pycreus","Cyperaceae","Poales",0,0,26,121,26,0
"Pygmaeocereus","Cactaceae","Caryophyllales",0,0,0,2,0,NA
"Pygmaeorchis","Orchidaceae","Asparagales",0,0,0,2,0,NA
"Pygmaeothamnus","Rubiaceae","Gentianales",1,0,0,2,1,1
"Pyracantha","Rosaceae","Rosales",3,0,0,11,3,1
"Pyragra","Rubiaceae","Gentianales",0,0,0,2,0,NA
"Pyramia","Melastomataceae","Myrtales",0,0,0,1,0,NA
"Pyramidanthe","Annonaceae","Magnoliales",0,0,0,1,0,NA
"Pyranthus","Fabaceae","Fabales",0,0,0,6,0,NA
"Pyrenacantha","Icacinaceae","UnknownOrder-Icacinaceae",7,1,0,23,7,1
"Pyrenaria","Theaceae","Ericales",3,0,0,13,3,1
"Pyrethropsis","Asteraceae","Asterales",0,0,0,1,0,NA
"Pyrethrum","Asteraceae","Asterales",0,0,0,44,0,NA
"Pyrola","Ericaceae","Ericales",0,0,3,36,3,0
"Pyrolirion","Amaryllidaceae","Asparagales",0,0,0,8,0,NA
"Pyrorchis","Orchidaceae","Asparagales",0,0,1,2,1,0
"Pyrostegia","Bignoniaceae","Lamiales",1,0,0,2,1,1
"Pyrostria","Rubiaceae","Gentianales",4,0,0,62,4,1
"Pyrrhanthera","Poaceae","Poales",0,0,1,1,1,0
"Pyrrhocactus","Cactaceae","Caryophyllales",0,0,0,12,0,NA
"Pyrrhopappus","Asteraceae","Asterales",0,0,1,5,1,0
"Pyrrocoma","Asteraceae","Asterales",0,0,0,15,0,NA
"Pyrrorhiza","Haemodoraceae","Commelinales",0,0,0,1,0,NA
"Pyrrosia","Polypodiaceae","Polypodiales",0,0,8,73,8,0
"Pyrularia","Santalaceae","Santalales",0,0,0,2,0,NA
"Pyrus","Rosaceae","Rosales",12,0,0,69,12,1
"Pyxidanthera","Diapensiaceae","Ericales",0,0,1,2,1,0
"Quadrella","Capparaceae","Brassicales",0,0,0,11,0,NA
"Qualea","Vochysiaceae","Myrtales",19,0,0,56,19,1
"Quamoclidion","Nyctaginaceae","Caryophyllales",0,0,0,1,0,NA
"Quamoclit","Convolvulaceae","Solanales",0,0,0,7,0,NA
"Quapoya","Clusiaceae","Malpighiales",0,0,0,5,0,NA
"Quaqua","Apocynaceae","Gentianales",0,0,1,14,1,0
"Quararibea","Malvaceae","Malvales",17,0,0,88,17,1
"Quassia","Simaroubaceae","Sapindales",7,0,0,36,7,1
"Quaternella","Amaranthaceae","Caryophyllales",0,0,0,2,0,NA
"Quechualia","Asteraceae","Asterales",0,0,0,4,0,NA
"Queenslandiella","Cyperaceae","Poales",0,0,1,1,1,0
"Quekettia","Orchidaceae","Asparagales",0,0,0,5,0,NA
"Quelchia","Asteraceae","Asterales",0,0,0,5,0,NA
"Quercus","Fagaceae","Fagales",171,0,0,597,171,1
"Quesnelia","Bromeliaceae","Poales",0,0,3,22,3,0
"Quetzalia","Celastraceae","Celastrales",0,0,0,10,0,NA
"Quezeliantha","Brassicaceae","Brassicales",0,0,0,1,0,NA
"Quiabentia","Cactaceae","Caryophyllales",2,0,0,2,2,1
"Quidproquo","Brassicaceae","Brassicales",0,0,0,1,0,NA
"Quiina","Ochnaceae","Malpighiales",10,0,0,50,10,1
"Quillaja","Quillajaceae","Fabales",2,0,0,2,2,1
"Quinchamalium","Schoepfiaceae","Santalales",0,0,0,20,0,NA
"Quincula","Solanaceae","Solanales",0,0,0,1,0,NA
"Quinetia","Asteraceae","Asterales",0,0,0,1,0,NA
"Quinqueremulus","Asteraceae","Asterales",0,0,1,1,1,0
"Quintinia","Paracryphiaceae","Paracryphiales",10,0,0,27,10,1
"Quisqualis","Combretaceae","Myrtales",3,0,0,12,3,1
"Quisqueya","Orchidaceae","Asparagales",0,0,1,4,1,0
"Quisumbingia","Apocynaceae","Gentianales",0,0,0,1,0,NA
"Quivisianthe","Meliaceae","Sapindales",1,0,0,1,1,1
"Rabiea","Aizoaceae","Caryophyllales",0,0,0,7,0,NA
"Racemobambos","Poaceae","Poales",0,0,0,19,0,NA
"Rachelia","Asteraceae","Asterales",0,0,0,1,0,NA
"Rachicallis","Rubiaceae","Gentianales",0,0,0,1,0,NA
"Racosperma","Fabaceae","Fabales",2,0,0,714,2,1
"Radamaea","Orobanchaceae","Lamiales",0,0,0,5,0,NA
"Radcliffea","Euphorbiaceae","Malpighiales",0,0,0,1,0,NA
"Raddia","Poaceae","Poales",0,0,2,5,2,0
"Raddiella","Poaceae","Poales",0,0,0,7,0,NA
"Radermachera","Bignoniaceae","Lamiales",6,0,0,17,6,1
"Radicula","Brassicaceae","Brassicales",0,0,0,2,0,NA
"Radinosiphon","Iridaceae","Asparagales",0,0,2,2,2,0
"Radiola","Linaceae","Malpighiales",0,0,1,1,1,0
"Radiovittaria","Pteridaceae","Polypodiales",0,0,8,8,8,0
"Radlkofera","Sapindaceae","Sapindales",0,0,0,1,0,NA
"Radlkoferotoma","Asteraceae","Asterales",0,0,0,3,0,NA
"Radyera","Malvaceae","Malvales",1,0,0,2,1,1
"Raffenaldia","Brassicaceae","Brassicales",0,0,0,2,0,NA
"Rafflesia","Rafflesiaceae","Malpighiales",0,0,0,20,0,NA
"Rafinesquia","Asteraceae","Asterales",0,0,0,2,0,NA
"Rafnia","Fabaceae","Fabales",0,1,0,32,0,NA
"Rahowardiana","Solanaceae","Solanales",0,0,0,1,0,NA
"Raillardella","Asteraceae","Asterales",0,0,1,3,1,0
"Railliardia","Asteraceae","Asterales",0,0,0,3,0,NA
"Raimondia","Annonaceae","Magnoliales",1,0,0,1,1,1
"Rainiera","Asteraceae","Asterales",0,0,0,1,0,NA
"Rajania","Dioscoreaceae","Dioscoreales",0,0,1,19,1,0
"Ramirezella","Fabaceae","Fabales",0,0,0,10,0,NA
"Ramisia","Nyctaginaceae","Caryophyllales",1,0,0,1,1,1
"Ramonda","Gesneriaceae","Lamiales",0,0,1,3,1,0
"Ramorinoa","Fabaceae","Fabales",0,0,0,1,0,NA
"Ramosmania","Rubiaceae","Gentianales",0,0,0,2,0,NA
"Ranalisma","Alismataceae","Alismatales",0,0,2,4,2,0
"Randia","Rubiaceae","Gentianales",15,0,0,99,15,1
"Randonia","Resedaceae","Brassicales",0,0,2,3,2,0
"Rangaeris","Orchidaceae","Asparagales",0,0,2,7,2,0
"Ranopisoa","Scrophulariaceae","Lamiales",0,0,0,1,0,NA
"Ranunculus","Ranunculaceae","Ranunculales",0,0,127,413,127,0
"Ranzania","Berberidaceae","Ranunculales",0,0,1,1,1,0
"Raoulia","Asteraceae","Asterales",0,0,4,26,4,0
"Raouliopsis","Asteraceae","Asterales",0,0,0,2,0,NA
"Rapanea","Primulaceae","Ericales",11,0,0,80,11,1
"Rapatea","Rapateaceae","Poales",0,0,1,22,1,0
"Raphanorhyncha","Brassicaceae","Brassicales",0,0,0,1,0,NA
"Raphanus","Brassicaceae","Brassicales",0,0,1,4,1,0
"Raphia","Arecaceae","Arecales",3,0,0,20,3,1
"Raphidiocystis","Cucurbitaceae","Cucurbitales",0,0,1,5,1,0
"Raphiocarpus","Gesneriaceae","Lamiales",0,0,0,10,0,NA
"Raphionacme","Apocynaceae","Gentianales",0,0,1,36,1,0
"Raphistemma","Apocynaceae","Gentianales",0,0,0,2,0,NA
"Rapistrum","Brassicaceae","Brassicales",0,0,1,2,1,0
"Rapona","Convolvulaceae","Solanales",0,1,0,1,0,NA
"Raputia","Rutaceae","Sapindales",0,0,0,10,0,NA
"Raputiarana","Rutaceae","Sapindales",0,0,0,1,0,NA
"Raritebe","Rubiaceae","Gentianales",0,0,0,1,0,NA
"Raspalia","Bruniaceae","Bruniales",3,0,0,4,3,1
"Rastrophyllum","Asteraceae","Asterales",0,0,0,2,0,NA
"Ratibida","Asteraceae","Asterales",0,0,2,7,2,0
"Ratzeburgia","Poaceae","Poales",0,0,0,1,0,NA
"Rauhia","Amaryllidaceae","Asparagales",0,0,1,4,1,0
"Rauhiella","Orchidaceae","Asparagales",0,0,0,3,0,NA
"Rauia","Rutaceae","Sapindales",0,0,0,4,0,NA
"Raukaua","Araliaceae","Apiales",3,0,0,8,3,1
"Raulinoa","Rutaceae","Sapindales",0,0,0,1,0,NA
"Raulinoreitzia","Asteraceae","Asterales",0,0,0,3,0,NA
"Rauvolfia","Apocynaceae","Gentianales",13,0,0,77,13,1
"Ravenala","Strelitziaceae","Zingiberales",1,0,0,1,1,1
"Ravenea","Arecaceae","Arecales",13,0,0,20,13,1
"Ravenia","Rutaceae","Sapindales",0,0,0,7,0,NA
"Raveniopsis","Rutaceae","Sapindales",0,0,0,18,0,NA
"Ravensara","Lauraceae","Laurales",5,0,0,17,5,1
"Rawsonia","Achariaceae","Malpighiales",1,0,0,2,1,1
"Rayjacksonia","Asteraceae","Asterales",0,0,0,3,0,NA
"Rayleya","Malvaceae","Malvales",1,0,0,1,1,1
"Razafimandimbisonia","Rubiaceae","Gentianales",1,0,0,5,1,1
"Razisea","Acanthaceae","Lamiales",1,0,0,5,1,1
"Razoumofskya","Santalaceae","Santalales",1,0,0,7,1,1
"Readea","Rubiaceae","Gentianales",1,0,0,1,1,1
"Reaumuria","Tamaricaceae","Caryophyllales",2,0,0,10,2,1
"Rebutia","Cactaceae","Caryophyllales",0,0,0,22,0,NA
"Recchia","Surianaceae","Fabales",1,0,0,3,1,1
"Rechsteinera","Gesneriaceae","Lamiales",0,0,0,1,0,NA
"Rechsteineria","Gesneriaceae","Lamiales",0,0,0,15,0,NA
"Recordia","Verbenaceae","Lamiales",0,0,0,1,0,NA
"Recordoxylon","Fabaceae","Fabales",2,0,0,4,2,1
"Redfieldia","Poaceae","Poales",0,0,1,1,1,0
"Reederochloa","Poaceae","Poales",0,0,0,1,0,NA
"Reedia","Cyperaceae","Poales",0,0,0,1,0,NA
"Reevesia","Malvaceae","Malvales",4,0,0,15,4,1
"Regelia","Myrtaceae","Myrtales",5,0,0,5,5,1
"Regnellidium","Marsileaceae","Salviniales",0,0,0,1,0,NA
"Rehdera","Verbenaceae","Lamiales",1,0,0,2,1,1
"Rehderodendron","Styracaceae","Ericales",2,0,0,5,2,1
"Rehia","Poaceae","Poales",0,0,0,1,0,NA
"Rehmannia","Plantaginaceae","Lamiales",0,0,1,6,1,0
"Rehsonia","Fabaceae","Fabales",0,0,0,3,0,NA
"Reichardia","Asteraceae","Asterales",0,0,4,11,4,0
"Reicheella","Montiaceae","Caryophyllales",0,0,0,1,0,NA
"Reichenbachia","Nyctaginaceae","Caryophyllales",1,0,0,1,1,1
"Reicheocactus","Cactaceae","Caryophyllales",0,0,0,1,0,NA
"Reimarochloa","Poaceae","Poales",0,0,0,3,0,NA
"Reineckea","Asparagaceae","Asparagales",0,0,1,1,1,0
"Reinhardtia","Arecaceae","Arecales",6,0,0,6,6,1
"Reinwardtia","Linaceae","Malpighiales",1,0,0,1,1,1
"Reinwardtiodendron","Meliaceae","Sapindales",1,0,0,1,1,1
"Reissantia","Celastraceae","Celastrales",1,0,0,4,1,1
"Reissekia","Rhamnaceae","Rosales",1,0,0,1,1,1
"Reitzia","Poaceae","Poales",0,0,0,1,0,NA
"Relchela","Poaceae","Poales",0,0,0,1,0,NA
"Reldia","Gesneriaceae","Lamiales",0,0,1,5,1,0
"Relhania","Asteraceae","Asterales",2,0,0,13,2,1
"Remijia","Rubiaceae","Gentianales",6,0,0,45,6,1
"Remirea","Cyperaceae","Poales",0,0,1,1,1,0
"Remusatia","Araceae","Alismatales",0,0,1,4,1,0
"Remya","Asteraceae","Asterales",0,0,0,3,0,NA
"Renanthera","Orchidaceae","Asparagales",0,0,0,20,0,NA
"Renealmia","Zingiberaceae","Zingiberales",0,0,41,86,41,0
"Renistipula","Rubiaceae","Gentianales",1,0,0,3,1,1
"Rennellia","Rubiaceae","Gentianales",0,0,0,8,0,NA
"Rennera","Asteraceae","Asterales",0,0,0,4,0,NA
"Renschia","Lamiaceae","Lamiales",0,0,0,1,0,NA
"Rensonia","Asteraceae","Asterales",1,0,0,1,1,1
"Reputia","Rutaceae","Sapindales",0,0,0,1,0,NA
"Requienia","Fabaceae","Fabales",0,0,0,3,0,NA
"Reseda","Resedaceae","Brassicales",0,0,24,31,24,0
"Resia","Gesneriaceae","Lamiales",0,0,1,3,1,0
"Resnova","Asparagaceae","Asparagales",0,0,1,5,1,0
"Restio","Restionaceae","Poales",0,0,19,168,19,0
"Restrepia","Orchidaceae","Asparagales",0,0,1,53,1,0
"Restrepiella","Orchidaceae","Asparagales",0,0,1,2,1,0
"Retama","Fabaceae","Fabales",3,0,0,4,3,1
"Retanilla","Rhamnaceae","Rosales",3,0,0,4,3,1
"Retiniphyllum","Rubiaceae","Gentianales",3,0,0,20,3,1
"Retispatha","Arecaceae","Arecales",0,0,0,1,0,NA
"Retrophyllum","Podocarpaceae","Araucariales",4,0,0,5,4,1
"Retzia","Stilbaceae","Lamiales",1,0,0,1,1,1
"Reutealis","Euphorbiaceae","Malpighiales",1,0,0,1,1,1
"Revealia","Asteraceae","Asterales",0,0,0,1,0,NA
"Revwattsia","Dryopteridaceae","Polypodiales",0,0,0,1,0,NA
"Reyemia","Scrophulariaceae","Lamiales",0,0,1,2,1,0
"Reyesia","Solanaceae","Solanales",0,0,0,4,0,NA
"Reynaudia","Poaceae","Poales",0,0,0,1,0,NA
"Reynosia","Rhamnaceae","Rosales",2,0,0,4,2,1
"Reynoutria","Polygonaceae","Caryophyllales",0,0,0,7,0,NA
"Rhabdadenia","Apocynaceae","Gentianales",1,0,0,3,1,1
"Rhabdocaulon","Lamiaceae","Lamiales",0,0,0,7,0,NA
"Rhabdodendron","Rhabdodendraceae","Caryophyllales",2,0,0,3,2,1
"Rhabdophyllum","Ochnaceae","Malpighiales",0,0,0,4,0,NA
"Rhabdothamnopsis","Gesneriaceae","Lamiales",0,0,0,1,0,NA
"Rhabdotosperma","Scrophulariaceae","Lamiales",0,0,0,2,0,NA
"Rhachidosorus","Rhachidosoraceae","Polypodiales",0,0,0,5,0,NA
"Rhacodiscus","Acanthaceae","Lamiales",0,0,0,1,0,NA
"Rhacoma","Celastraceae","Celastrales",0,0,0,11,0,NA
"Rhadinopus","Rubiaceae","Gentianales",0,0,0,2,0,NA
"Rhadinothamnus","Rutaceae","Sapindales",0,0,0,3,0,NA
"Rhaesteria","Orchidaceae","Asparagales",0,0,0,1,0,NA
"Rhagadiolus","Asteraceae","Asterales",0,0,1,2,1,0
"Rhagodia","Amaranthaceae","Caryophyllales",2,0,0,9,2,1
"Rhammatophyllum","Brassicaceae","Brassicales",0,1,0,8,0,NA
"Rhamnella","Rhamnaceae","Rosales",1,0,0,8,1,1
"Rhamnidium","Rhamnaceae","Rosales",1,0,0,5,1,1
"Rhamnoneuron","Thymelaeaceae","Malvales",0,0,0,1,0,NA
"Rhamnus","Rhamnaceae","Rosales",34,0,0,113,34,1
"Rhamphicarpa","Orobanchaceae","Lamiales",0,0,0,5,0,NA
"Rhamphogyne","Asteraceae","Asterales",0,0,0,1,0,NA
"Rhanteriopsis","Asteraceae","Asterales",0,0,0,2,0,NA
"Rhanterium","Asteraceae","Asterales",2,0,0,3,2,1
"Rhaphidophora","Araceae","Alismatales",0,0,2,99,2,0
"Rhaphidura","Rubiaceae","Gentianales",0,0,0,1,0,NA
"Rhaphiodon","Lamiaceae","Lamiales",0,0,0,1,0,NA
"Rhaphiolepis","Rosaceae","Rosales",4,0,0,6,4,1
"Rhaphiostylis","Icacinaceae","UnknownOrder-Icacinaceae",2,0,0,11,2,1
"Rhaphithamnus","Verbenaceae","Lamiales",1,0,0,2,1,1
"Rhapidophyllum","Arecaceae","Arecales",1,0,0,1,1,1
"Rhapis","Arecaceae","Arecales",2,0,0,11,2,1
"Rhaponticoides","Asteraceae","Asterales",0,0,0,3,0,NA
"Rhaponticum","Asteraceae","Asterales",0,0,1,23,1,0
"Rhaptonema","Menispermaceae","Ranunculales",0,0,0,7,0,NA
"Rhaptopetalum","Lecythidaceae","Ericales",4,0,0,7,4,1
"Rhazya","Apocynaceae","Gentianales",1,0,0,2,1,1
"Rheedia","Clusiaceae","Malpighiales",0,0,0,13,0,NA
"Rheochloa","Poaceae","Poales",0,0,0,1,0,NA
"Rheome","Iridaceae","Asparagales",0,0,0,1,0,NA
"Rhetinantha","Orchidaceae","Asparagales",0,0,6,14,6,0
"Rhetinocarpha","Asteraceae","Asterales",0,0,0,1,0,NA
"Rhetinodendron","Asteraceae","Asterales",0,0,0,1,0,NA
"Rhetinolepis","Asteraceae","Asterales",0,0,0,1,0,NA
"Rhetinosperma","Meliaceae","Sapindales",0,0,0,1,0,NA
"Rheum","Polygonaceae","Caryophyllales",0,0,10,44,10,0
"Rhexia","Melastomataceae","Myrtales",0,0,1,16,1,0
"Rhigiocarya","Menispermaceae","Ranunculales",0,1,0,1,0,NA
"Rhigiophyllum","Campanulaceae","Asterales",1,0,0,1,1,1
"Rhigospira","Apocynaceae","Gentianales",1,0,0,1,1,1
"Rhigozum","Bignoniaceae","Lamiales",5,0,0,7,5,1
"Rhinacanthus","Acanthaceae","Lamiales",0,0,0,10,0,NA
"Rhinactina","Asteraceae","Asterales",0,0,0,2,0,NA
"Rhinactinidia","Asteraceae","Asterales",0,0,0,4,0,NA
"Rhinanthus","Orobanchaceae","Lamiales",0,0,2,34,2,0
"Rhinephyllum","Aizoaceae","Caryophyllales",0,0,0,13,0,NA
"Rhinerrhiza","Orchidaceae","Asparagales",0,0,0,1,0,NA
"Rhinerrhizopsis","Orchidaceae","Asparagales",0,0,1,3,1,0
"Rhinotropis","Polygalaceae","Fabales",0,0,0,17,0,NA
"Rhipidantha","Rubiaceae","Gentianales",0,0,0,1,0,NA
"Rhipidocladum","Poaceae","Poales",1,0,0,18,1,1
"Rhipidoglossum","Orchidaceae","Asparagales",0,0,4,35,4,0
"Rhipogonum","Rhipogonaceae","Liliales",3,0,0,6,3,1
"Rhipsalis","Cactaceae","Caryophyllales",1,0,0,52,1,1
"Rhizanthella","Orchidaceae","Asparagales",0,0,1,3,1,0
"Rhizanthera","Orchidaceae","Asparagales",0,0,0,3,0,NA
"Rhizanthes","Rafflesiaceae","Malpighiales",0,0,0,1,0,NA
"Rhizobotrya","Brassicaceae","Brassicales",0,0,0,1,0,NA
"Rhizocephalus","Poaceae","Poales",0,0,0,1,0,NA
"Rhizoglossum","Ophioglossaceae","Ophioglossales",0,0,0,1,0,NA
"Rhizomonanthes","Loranthaceae","Santalales",0,0,0,1,0,NA
"Rhizophora","Rhizophoraceae","Malpighiales",6,0,0,7,6,1
"Rhodamnia","Myrtaceae","Myrtales",12,0,0,35,12,1
"Rhodanthe","Asteraceae","Asterales",0,0,10,46,10,0
"Rhodanthemum","Asteraceae","Asterales",0,0,1,15,1,0
"Rhodiola","Crassulaceae","Saxifragales",0,0,4,62,4,0
"Rhodocactus","Cactaceae","Caryophyllales",0,0,0,1,0,NA
"Rhodochiton","Plantaginaceae","Lamiales",0,0,1,4,1,0
"Rhodocolea","Bignoniaceae","Lamiales",1,0,0,9,1,1
"Rhodocoma","Restionaceae","Poales",0,0,6,8,6,0
"Rhododendron","Ericaceae","Ericales",114,0,0,641,114,1
"Rhododon","Lamiaceae","Lamiales",0,0,0,1,0,NA
"Rhodogeron","Asteraceae","Asterales",0,0,1,1,1,0
"Rhodognaphalon","Malvaceae","Malvales",0,0,0,2,0,NA
"Rhodohypoxis","Hypoxidaceae","Asparagales",0,0,2,6,2,0
"Rhodolaena","Sarcolaenaceae","Malvales",1,0,0,7,1,1
"Rhodoleia","Hamamelidaceae","Saxifragales",2,0,0,6,2,1
"Rhodomyrtus","Myrtaceae","Myrtales",6,0,0,21,6,1
"Rhodopentas","Rubiaceae","Gentianales",2,0,0,2,2,1
"Rhodophiala","Amaryllidaceae","Asparagales",0,0,9,27,9,0
"Rhodopis","Fabaceae","Fabales",1,0,0,2,1,1
"Rhodosciadium","Apiaceae","Apiales",0,0,0,9,0,NA
"Rhodospatha","Araceae","Alismatales",0,0,0,32,0,NA
"Rhodosphaera","Anacardiaceae","Sapindales",1,0,0,1,1,1
"Rhodostemonodaphne","Lauraceae","Laurales",6,0,0,35,6,1
"Rhodothamnus","Ericaceae","Ericales",1,0,0,2,1,1
"Rhodothyrsus","Euphorbiaceae","Malpighiales",1,0,0,2,1,1
"Rhodotypos","Rosaceae","Rosales",1,0,0,1,1,1
"Rhodoxis","Hypoxidaceae","Asparagales",0,0,0,1,0,NA
"Rhoeidium","Anacardiaceae","Sapindales",0,0,0,2,0,NA
"Rhoiacarpos","Santalaceae","Santalales",1,0,0,1,1,1
"Rhoicissus","Vitaceae","Vitales",2,0,0,15,2,1
"Rhoiptelea","Juglandaceae","Fagales",1,0,0,1,1,1
"Rhomboda","Orchidaceae","Asparagales",0,0,0,21,0,NA
"Rhombolytrum","Poaceae","Poales",0,0,0,2,0,NA
"Rhombophyllum","Aizoaceae","Caryophyllales",0,0,0,3,0,NA
"Rhoogeton","Gesneriaceae","Lamiales",0,0,0,2,0,NA
"Rhopalephora","Commelinaceae","Commelinales",0,0,2,4,2,0
"Rhopaloblaste","Arecaceae","Arecales",1,0,0,6,1,1
"Rhopalocarpus","Sphaerosepalaceae","Malvales",3,0,0,17,3,1
"Rhopalocnemis","Balanophoraceae","Santalales",0,0,0,1,0,NA
"Rhopalopilia","Opiliaceae","Santalales",0,0,0,3,0,NA
"Rhopalostylis","Arecaceae","Arecales",2,0,0,2,2,1
"Rhus","Anacardiaceae","Sapindales",32,0,0,131,32,1
"Rhynchanthera","Melastomataceae","Myrtales",1,0,0,19,1,1
"Rhynchanthus","Zingiberaceae","Zingiberales",0,0,0,4,0,NA
"Rhyncharrhena","Apocynaceae","Gentianales",0,0,0,1,0,NA
"Rhynchelytrum","Poaceae","Poales",0,0,0,1,0,NA
"Rhynchocalyx","Penaeaceae","Myrtales",1,0,0,1,1,1
"Rhynchocladium","Cyperaceae","Poales",0,0,0,1,0,NA
"Rhynchocorys","Orobanchaceae","Lamiales",0,0,0,1,0,NA
"Rhynchoglossum","Gesneriaceae","Lamiales",0,0,1,4,1,0
"Rhynchogyna","Orchidaceae","Asparagales",0,0,0,3,0,NA
"Rhyncholacis","Podostemaceae","Malpighiales",0,0,0,19,0,NA
"Rhyncholaelia","Orchidaceae","Asparagales",0,0,2,2,2,0
"Rhynchophora","Malpighiaceae","Malpighiales",1,0,0,2,1,1
"Rhynchopsidium","Asteraceae","Asterales",0,0,0,2,0,NA
"Rhynchoryza","Poaceae","Poales",0,0,0,1,0,NA
"Rhynchosia","Fabaceae","Fabales",1,1,2,257,3,0.333333333333333
"Rhynchosida","Malvaceae","Malvales",0,0,0,2,0,NA
"Rhynchospermum","Asteraceae","Asterales",0,0,0,1,0,NA
"Rhynchospora","Cyperaceae","Poales",0,0,48,354,48,0
"Rhynchostele","Orchidaceae","Asparagales",0,0,2,20,2,0
"Rhynchostylis","Orchidaceae","Asparagales",0,0,1,3,1,0
"Rhynchotechum","Gesneriaceae","Lamiales",0,0,0,8,0,NA
"Rhynchotheca","Vivianiaceae","Geraniales",0,0,0,1,0,NA
"Rhynchotropis","Fabaceae","Fabales",0,0,0,2,0,NA
"Rhysolepis","Asteraceae","Asterales",0,0,0,2,0,NA
"Rhysopterus","Apiaceae","Apiales",0,0,0,1,0,NA
"Rhysotoechia","Sapindaceae","Sapindales",1,0,0,1,1,1
"Rhyssolobium","Apocynaceae","Gentianales",0,0,0,1,0,NA
"Rhyssostelma","Apocynaceae","Gentianales",0,0,0,1,0,NA
"Rhytachne","Poaceae","Poales",0,0,0,13,0,NA
"Rhyticarpus","Apiaceae","Apiales",0,0,0,3,0,NA
"Rhyticaryum","Icacinaceae","UnknownOrder-Icacinaceae",1,0,0,12,1,1
"Rhytidanthera","Ochnaceae","Malpighiales",0,0,0,2,0,NA
"Rhytidocaulon","Apocynaceae","Gentianales",0,0,0,5,0,NA
"Rhytidophyllum","Gesneriaceae","Lamiales",1,0,0,8,1,1
"Rhytidosporum","Pittosporaceae","Apiales",0,0,0,1,0,NA
"Rhytiglossa","Acanthaceae","Lamiales",0,0,0,1,0,NA
"Ribes","Grossulariaceae","Saxifragales",68,0,0,194,68,1
"Richardia","Rubiaceae","Gentianales",0,0,4,16,4,0
"Richardsiella","Poaceae","Poales",0,0,0,1,0,NA
"Richea","Rhizophoraceae","Malpighiales",0,0,0,1,0,NA
"Richella","Annonaceae","Magnoliales",0,0,0,1,0,NA
"Richeria","Phyllanthaceae","Malpighiales",2,0,0,5,2,1
"Richterago","Asteraceae","Asterales",0,0,0,16,0,NA
"Richteria","Asteraceae","Asterales",0,0,0,3,0,NA
"Ricinocarpos","Euphorbiaceae","Malpighiales",4,0,0,28,4,1
"Ricinodendron","Euphorbiaceae","Malpighiales",1,0,0,2,1,1
"Ricinus","Euphorbiaceae","Malpighiales",1,0,0,1,1,1
"Ricotia","Brassicaceae","Brassicales",0,0,0,9,0,NA
"Ridan","Asteraceae","Asterales",0,0,0,1,0,NA
"Ridleyella","Orchidaceae","Asparagales",0,0,1,1,1,0
"Ridolfia","Apiaceae","Apiales",0,0,0,1,0,NA
"Riedelia","Zingiberaceae","Zingiberales",0,0,0,75,0,NA
"Riedeliella","Fabaceae","Fabales",0,0,0,3,0,NA
"Riedlea","Malvaceae","Malvales",0,0,0,2,0,NA
"Riencourtia","Asteraceae","Asterales",0,0,1,5,1,0
"Rigiopappus","Asteraceae","Asterales",0,0,0,1,0,NA
"Rimacola","Orchidaceae","Asparagales",0,0,1,1,1,0
"Rindera","Boraginaceae","UnknownOrder-Boraginaceae",0,0,0,4,0,NA
"Rinorea","Violaceae","Malpighiales",18,0,1,164,19,0.947368421052632
"Rinoreocarpus","Violaceae","Malpighiales",1,0,0,1,1,1
"Rinzia","Myrtaceae","Myrtales",2,0,0,12,2,1
"Riocreuxia","Apocynaceae","Gentianales",0,0,1,11,1,0
"Riodocea","Rubiaceae","Gentianales",0,0,0,1,0,NA
"Riqueuria","Rubiaceae","Gentianales",0,0,0,1,0,NA
"Risleya","Orchidaceae","Asparagales",0,0,0,1,0,NA
"Ristantia","Myrtaceae","Myrtales",2,0,0,3,2,1
"Ritchiea","Capparaceae","Brassicales",2,0,0,21,2,1
"Ritonia","Acanthaceae","Lamiales",0,0,0,4,0,NA
"Rivea","Convolvulaceae","Solanales",0,0,0,1,0,NA
"Rivina","Phytolaccaceae","Caryophyllales",0,0,1,2,1,0
"Robbrechtia","Rubiaceae","Gentianales",0,0,0,2,0,NA
"Robeschia","Brassicaceae","Brassicales",0,0,0,1,0,NA
"Robinia","Fabaceae","Fabales",2,0,0,8,2,1
"Robinsonecio","Asteraceae","Asterales",0,0,0,2,0,NA
"Robinsonella","Malvaceae","Malvales",1,0,0,16,1,1
"Robinsonia","Asteraceae","Asterales",0,0,0,7,0,NA
"Robinsoniodendron","Urticaceae","Rosales",0,0,0,1,0,NA
"Robiquetia","Orchidaceae","Asparagales",0,0,0,45,0,NA
"Robynsia","Rubiaceae","Gentianales",0,0,0,1,0,NA
"Robynsiophyton","Fabaceae","Fabales",0,0,0,1,0,NA
"Rochefortia","Boraginaceae","UnknownOrder-Boraginaceae",2,0,0,4,2,1
"Rochelia","Boraginaceae","UnknownOrder-Boraginaceae",0,0,0,8,0,NA
"Rochonia","Asteraceae","Asterales",0,0,0,2,0,NA
"Rockinghamia","Euphorbiaceae","Malpighiales",2,0,0,2,2,1
"Rodgersia","Saxifragaceae","Saxifragales",0,0,2,2,2,0
"Rodigia","Asteraceae","Asterales",0,0,0,2,0,NA
"Rodriguezia","Orchidaceae","Asparagales",0,0,3,50,3,0
"Roella","Campanulaceae","Asterales",2,0,0,21,2,1
"Roemeria","Papaveraceae","Ranunculales",0,0,0,2,0,NA
"Roepera","Zygophyllaceae","Zygophyllales",0,0,0,1,0,NA
"Roeperocharis","Orchidaceae","Asparagales",0,0,0,5,0,NA
"Rogeria","Pedaliaceae","Lamiales",0,0,0,3,0,NA
"Rogersonanthus","Gentianaceae","Gentianales",0,0,0,3,0,NA
"Rogiera","Rubiaceae","Gentianales",0,0,0,15,0,NA
"Rohdea","Asparagaceae","Asparagales",0,0,1,17,1,0
"Rohria","Asteraceae","Asterales",0,0,0,1,0,NA
"Roigella","Rubiaceae","Gentianales",0,0,0,1,0,NA
"Rojasia","Apocynaceae","Gentianales",0,0,0,1,0,NA
"Rojasianthe","Asteraceae","Asterales",1,0,0,1,1,1
"Rojasimalva","Malvaceae","Malvales",0,0,0,1,0,NA
"Rolandra","Asteraceae","Asterales",0,0,0,1,0,NA
"Roldana","Asteraceae","Asterales",0,0,0,57,0,NA
"Rollinia","Annonaceae","Magnoliales",18,0,0,38,18,1
"Rolliniopsis","Annonaceae","Magnoliales",0,0,0,1,0,NA
"Romanoa","Euphorbiaceae","Malpighiales",0,0,0,1,0,NA
"Romanschulzia","Brassicaceae","Brassicales",0,0,0,14,0,NA
"Romanzoffia","Boraginaceae","UnknownOrder-Boraginaceae",0,0,1,5,1,0
"Romeroa","Bignoniaceae","Lamiales",0,0,0,1,0,NA
"Romnalda","Asparagaceae","Asparagales",0,0,0,4,0,NA
"Romneya","Papaveraceae","Ranunculales",2,0,0,2,2,1
"Romulea","Iridaceae","Asparagales",0,0,53,109,53,0
"Ronabea","Rubiaceae","Gentianales",1,0,0,3,1,1
"Rondeletia","Rubiaceae","Gentianales",6,0,0,160,6,1
"Rondonanthus","Eriocaulaceae","Poales",0,0,0,6,0,NA
"Ronnbergia","Bromeliaceae","Poales",0,0,1,11,1,0
"Roodebergia","Asteraceae","Asterales",0,0,0,1,0,NA
"Ropalon","Nymphaeaceae","Nymphaeales",0,0,0,1,0,NA
"Roraimaea","Gentianaceae","Gentianales",0,0,0,1,0,NA
"Roridula","Roridulaceae","Ericales",2,0,0,2,2,1
"Rorippa","Brassicaceae","Brassicales",0,0,12,91,12,0
"Rosa","Rosaceae","Rosales",66,0,0,366,66,1
"Roscheria","Arecaceae","Arecales",1,0,0,1,1,1
"Roscoea","Zingiberaceae","Zingiberales",0,0,0,22,0,NA
"Rosenbergiodendron","Rubiaceae","Gentianales",2,0,0,4,2,1
"Rosenia","Asteraceae","Asterales",2,0,0,4,2,1
"Rosenstockia","Hymenophyllaceae","Hymenophyllales",0,0,0,1,0,NA
"Roseodendron","Bignoniaceae","Lamiales",2,0,0,2,2,1
"Rosifax","Amaranthaceae","Caryophyllales",0,0,0,1,0,NA
"Rosmarinus","Lamiaceae","Lamiales",1,0,0,5,1,1
"Rossioglossum","Orchidaceae","Asparagales",0,0,0,9,0,NA
"Rostkovia","Juncaceae","Poales",0,0,1,2,1,0
"Rostraria","Poaceae","Poales",0,0,2,13,2,0
"Rostrinucula","Lamiaceae","Lamiales",0,0,0,2,0,NA
"Rosularia","Crassulaceae","Saxifragales",0,0,0,31,0,NA
"Rotala","Lythraceae","Myrtales",0,0,2,30,2,0
"Rotheca","Lamiaceae","Lamiales",2,0,1,33,3,0.666666666666667
"Rothia","Fabaceae","Fabales",0,0,0,2,0,NA
"Rothmaleria","Asteraceae","Asterales",0,0,0,1,0,NA
"Rothmannia","Rubiaceae","Gentianales",9,0,0,42,9,1
"Rottboellia","Poaceae","Poales",0,0,3,6,3,0
"Rotula","Boraginaceae","UnknownOrder-Boraginaceae",0,0,0,1,0,NA
"Roucheria","Linaceae","Malpighiales",2,0,0,5,2,1
"Roupala","Proteaceae","Proteales",7,0,0,39,7,1
"Rourea","Connaraceae","Oxalidales",18,0,0,65,18,1
"Roureopsis","Connaraceae","Oxalidales",0,0,0,6,0,NA
"Rousseauxia","Melastomataceae","Myrtales",0,0,0,13,0,NA
"Rousselia","Urticaceae","Rosales",0,0,0,2,0,NA
"Rouya","Apiaceae","Apiales",0,0,0,1,0,NA
"Rovaeanthus","Rubiaceae","Gentianales",1,0,0,2,1,1
"Roycea","Amaranthaceae","Caryophyllales",0,0,0,3,0,NA
"Roylea","Lamiaceae","Lamiales",0,0,0,1,0,NA
"Roystonea","Arecaceae","Arecales",10,0,0,10,10,1
"Ruagea","Meliaceae","Sapindales",4,0,0,12,4,1
"Rubia","Rubiaceae","Gentianales",2,0,3,82,5,0.4
"Rubiteucris","Lamiaceae","Lamiales",0,0,2,2,2,0
"Rubovietnamia","Rubiaceae","Gentianales",0,0,0,2,0,NA
"Rubus","Rosaceae","Rosales",31,0,2,1494,33,0.939393939393939
"Rudbeckia","Asteraceae","Asterales",0,0,1,25,1,0
"Rudgea","Rubiaceae","Gentianales",8,0,0,133,8,1
"Rudolfiella","Orchidaceae","Asparagales",0,0,1,6,1,0
"Ruellia","Acanthaceae","Lamiales",0,0,4,269,4,0
"Ruelliopsis","Acanthaceae","Lamiales",0,0,0,2,0,NA
"Rufodorsia","Gesneriaceae","Lamiales",1,0,0,4,1,1
"Rugelia","Asteraceae","Asterales",0,0,0,1,0,NA
"Ruilopezia","Asteraceae","Asterales",0,0,0,24,0,NA
"Ruizodendron","Annonaceae","Magnoliales",1,0,0,1,1,1
"Ruizterania","Vochysiaceae","Myrtales",2,0,0,9,2,1
"Rulingia","Malvaceae","Malvales",1,0,0,1,1,1
"Rumex","Polygonaceae","Caryophyllales",1,0,22,152,23,0.0434782608695652
"Rumfordia","Asteraceae","Asterales",1,0,0,7,1,1
"Rumohra","Dryopteridaceae","Polypodiales",0,0,1,5,1,0
"Rungia","Acanthaceae","Lamiales",0,0,0,23,0,NA
"Rupertia","Fabaceae","Fabales",0,0,1,3,1,0
"Ruppia","Ruppiaceae","Alismatales",0,0,4,8,4,0
"Ruprechtia","Polygonaceae","Caryophyllales",6,0,0,39,6,1
"Ruptiliocarpon","Lepidobotryaceae","Celastrales",1,0,0,1,1,1
"Rusbya","Ericaceae","Ericales",0,0,0,1,0,NA
"Ruschia","Aizoaceae","Caryophyllales",2,0,0,345,2,1
"Ruschianthemum","Aizoaceae","Caryophyllales",0,0,0,1,0,NA
"Ruschianthus","Aizoaceae","Caryophyllales",0,0,0,1,0,NA
"Ruscus","Asparagaceae","Asparagales",1,0,2,7,3,0.333333333333333
"Ruspolia","Acanthaceae","Lamiales",0,0,0,5,0,NA
"Russelia","Plantaginaceae","Lamiales",2,0,0,48,2,1
"Russowia","Asteraceae","Asterales",0,0,0,1,0,NA
"Rustia","Rubiaceae","Gentianales",1,0,0,17,1,1
"Ruta","Rutaceae","Sapindales",3,0,0,11,3,1
"Rutaneblina","Rutaceae","Sapindales",0,0,0,1,0,NA
"Ruthalicia","Cucurbitaceae","Cucurbitales",0,1,0,2,0,NA
"Ruthiella","Campanulaceae","Asterales",0,0,0,4,0,NA
"Rutidea","Rubiaceae","Gentianales",2,0,0,21,2,1
"Rutidosis","Asteraceae","Asterales",0,0,2,9,2,0
"Ruttya","Acanthaceae","Lamiales",1,0,0,6,1,1
"Ruyschia","Marcgraviaceae","Ericales",2,1,0,10,2,1
"Ryania","Salicaceae","Malpighiales",7,0,0,8,7,1
"Rydingia","Lamiaceae","Lamiales",0,0,0,4,0,NA
"Ryssopterys","Malpighiaceae","Malpighiales",1,0,0,1,1,1
"Rytidocarpus","Brassicaceae","Brassicales",0,0,0,1,0,NA
"Rytidosperma","Poaceae","Poales",0,0,33,70,33,0
"Rytidostylis","Cucurbitaceae","Cucurbitales",0,0,0,8,0,NA
"Rytigynia","Rubiaceae","Gentianales",7,0,0,82,7,1
"Saba","Apocynaceae","Gentianales",2,0,0,3,2,1
"Sabal","Arecaceae","Arecales",11,0,0,16,11,1
"Sabatia","Gentianaceae","Gentianales",0,0,0,25,0,NA
"Sabazia","Asteraceae","Asterales",0,0,0,16,0,NA
"Sabia","Sabiaceae","UnknownOrder-Sabiaceae",5,0,0,17,5,1
"Sabicea","Rubiaceae","Gentianales",4,1,0,148,4,1
"Sabina","Cupressaceae","Cupressales",1,0,0,2,1,1
"Sabulina","Caryophyllaceae","Caryophyllales",0,0,0,1,0,NA
"Saccharum","Poaceae","Poales",0,0,8,36,8,0
"Saccifolium","Gentianaceae","Gentianales",1,0,0,1,1,1
"Sacciolepis","Poaceae","Poales",0,0,4,25,4,0
"Saccocalyx","Lamiaceae","Lamiales",0,0,0,1,0,NA
"Saccoglossum","Orchidaceae","Asparagales",0,0,0,5,0,NA
"Saccolabiopsis","Orchidaceae","Asparagales",0,0,0,15,0,NA
"Saccolabium","Orchidaceae","Asparagales",0,0,1,5,1,0
"Saccoloma","Saccolomataceae","Polypodiales",0,0,2,14,2,0
"Sachokiella","Campanulaceae","Asterales",0,0,0,1,0,NA
"Sachsia","Asteraceae","Asterales",0,0,1,2,1,0
"Sacleuxia","Apocynaceae","Gentianales",0,0,0,1,0,NA
"Sacoglottis","Humiriaceae","Malpighiales",5,0,0,10,5,1
"Sacoila","Orchidaceae","Asparagales",0,0,0,7,0,NA
"Sacosperma","Rubiaceae","Gentianales",0,0,0,2,0,NA
"Sadiria","Primulaceae","Ericales",0,0,0,3,0,NA
"Sadleria","Blechnaceae","Polypodiales",0,0,0,5,0,NA
"Sadymia","Salicaceae","Malpighiales",0,0,0,1,0,NA
"Sagenia","Tectariaceae","Polypodiales",0,0,0,2,0,NA
"Sageraea","Annonaceae","Magnoliales",2,0,0,4,2,1
"Sageretia","Rhamnaceae","Rosales",1,0,0,25,1,1
"Sagina","Caryophyllaceae","Caryophyllales",0,0,5,21,5,0
"Sagittaria","Alismataceae","Alismatales",0,0,19,40,19,0
"Sagotia","Euphorbiaceae","Malpighiales",1,0,0,2,1,1
"Sagraea","Melastomataceae","Myrtales",0,0,0,15,0,NA
"Saharanthus","Plumbaginaceae","Caryophyllales",1,0,0,1,1,1
"Saintpaulia","Gesneriaceae","Lamiales",0,0,0,7,0,NA
"Saintpauliopsis","Acanthaceae","Lamiales",0,0,0,1,0,NA
"Sairocarpus","Plantaginaceae","Lamiales",0,0,0,12,0,NA
"Sajania","Apiaceae","Apiales",0,0,0,1,0,NA
"Sakoanala","Fabaceae","Fabales",0,0,0,2,0,NA
"Salacca","Arecaceae","Arecales",1,0,0,22,1,1
"Salacia","Celastraceae","Celastrales",16,0,0,132,16,1
"Salacighia","Celastraceae","Celastrales",0,0,0,2,0,NA
"Salcedoa","Asteraceae","Asterales",0,0,0,1,0,NA
"Saldinia","Rubiaceae","Gentianales",2,0,0,22,2,1
"Salicornia","Amaranthaceae","Caryophyllales",0,0,6,26,6,0
"Salix","Salicaceae","Malpighiales",143,0,0,552,143,1
"Salmea","Asteraceae","Asterales",0,0,0,12,0,NA
"Salmeopsis","Asteraceae","Asterales",0,0,0,1,0,NA
"Salomonia","Polygalaceae","Fabales",0,0,2,2,2,0
"Salpianthus","Nyctaginaceae","Caryophyllales",0,0,0,4,0,NA
"Salpichlaena","Blechnaceae","Polypodiales",0,0,0,3,0,NA
"Salpichroa","Solanaceae","Solanales",0,0,0,16,0,NA
"Salpiglossis","Solanaceae","Solanales",0,0,1,2,1,0
"Salpinga","Melastomataceae","Myrtales",0,0,0,9,0,NA
"Salpingostylis","Iridaceae","Asparagales",0,0,1,1,1,0
"Salsola","Amaranthaceae","Caryophyllales",7,0,2,174,9,0.777777777777778
"Salta","Polygonaceae","Caryophyllales",0,0,0,1,0,NA
"Saltera","Penaeaceae","Myrtales",1,0,0,1,1,1
"Saltugilia","Polemoniaceae","Ericales",0,0,3,3,3,0
"Salvadora","Salvadoraceae","Brassicales",1,0,0,3,1,1
"Salvadoropsis","Celastraceae","Celastrales",0,0,0,1,0,NA
"Salvertia","Vochysiaceae","Myrtales",0,0,0,1,0,NA
"Salvia","Lamiaceae","Lamiales",31,3,72,986,103,0.300970873786408
"Salvinia","Salviniaceae","Salviniales",0,0,3,10,3,0
"Salweenia","Fabaceae","Fabales",1,0,0,1,1,1
"Salzmannia","Rubiaceae","Gentianales",0,0,0,1,0,NA
"Samadera","Simaroubaceae","Sapindales",0,0,0,1,0,NA
"Samaipaticereus","Cactaceae","Caryophyllales",0,0,0,2,0,NA
"Samanea","Fabaceae","Fabales",1,0,0,5,1,1
"Samarorchis","Orchidaceae","Asparagales",0,0,0,1,0,NA
"Sambirania","Lindsaeaceae","Polypodiales",0,0,0,1,0,NA
"Sambucus","Adoxaceae","Dipsacales",9,0,1,22,10,0.9
"Sameraria","Brassicaceae","Brassicales",0,0,0,10,0,NA
"Samodia","Primulaceae","Ericales",0,0,0,1,0,NA
"Samolus","Primulaceae","Ericales",0,0,1,10,1,0
"Sampantaea","Euphorbiaceae","Malpighiales",0,0,0,1,0,NA
"Samyda","Salicaceae","Malpighiales",3,0,0,5,3,1
"Sanango","Gesneriaceae","Lamiales",1,0,0,1,1,1
"Sanblasia","Marantaceae","Zingiberales",0,0,0,1,0,NA
"Sanchezia","Acanthaceae","Lamiales",1,0,0,54,1,1
"Sanctambrosia","Caryophyllaceae","Caryophyllales",0,0,0,1,0,NA
"Sandbergia","Brassicaceae","Brassicales",0,0,0,1,0,NA
"Sandemania","Melastomataceae","Myrtales",0,0,0,1,0,NA
"Sanderella","Orchidaceae","Asparagales",0,0,0,2,0,NA
"Sandersonia","Colchicaceae","Liliales",0,0,0,1,0,NA
"Sandoricum","Meliaceae","Sapindales",2,0,0,4,2,1
"Sandwithia","Euphorbiaceae","Malpighiales",1,0,0,2,1,1
"Sanguinaria","Papaveraceae","Ranunculales",0,0,1,1,1,0
"Sanguisorba","Rosaceae","Rosales",0,0,8,26,8,0
"Sanicula","Apiaceae","Apiales",0,0,5,44,5,0
"Saniculiphyllum","Saxifragaceae","Saxifragales",0,0,0,1,0,NA
"Saniella","Hypoxidaceae","Asparagales",0,0,0,2,0,NA
"Sankowskya","Picrodendraceae","Malpighiales",0,0,0,1,0,NA
"Sannantha","Myrtaceae","Myrtales",10,0,0,15,10,1
"Sanrafaelia","Annonaceae","Magnoliales",0,0,0,1,0,NA
"Sansevieria","Asparagaceae","Asparagales",0,0,3,69,3,0
"Santalodes","Connaraceae","Oxalidales",0,0,0,1,0,NA
"Santaloides","Connaraceae","Oxalidales",1,0,0,24,1,1
"Santalum","Santalaceae","Santalales",3,0,0,12,3,1
"Santanderella","Orchidaceae","Asparagales",0,0,0,1,0,NA
"Santiria","Burseraceae","Sapindales",1,0,0,1,1,1
"Santisukia","Bignoniaceae","Lamiales",0,0,0,2,0,NA
"Santolina","Asteraceae","Asterales",1,0,0,20,1,1
"Santomasia","Hypericaceae","Malpighiales",0,0,0,1,0,NA
"Santosia","Asteraceae","Asterales",0,0,0,1,0,NA
"Santotomasia","Orchidaceae","Asparagales",0,0,0,1,0,NA
"Sanvitalia","Asteraceae","Asterales",0,0,0,7,0,NA
"Saphesia","Aizoaceae","Caryophyllales",0,0,1,1,1,0
"Sapindus","Sapindaceae","Sapindales",7,0,0,12,7,1
"Sapium","Euphorbiaceae","Malpighiales",12,0,0,23,12,1
"Saponaria","Caryophyllaceae","Caryophyllales",0,0,1,16,1,0
"Saposhnikovia","Apiaceae","Apiales",0,0,1,1,1,0
"Sapranthus","Annonaceae","Magnoliales",3,0,0,9,3,1
"Sapria","Rafflesiaceae","Malpighiales",0,0,0,1,0,NA
"Saprosma","Rubiaceae","Gentianales",1,0,0,48,1,1
"Saraca","Fabaceae","Fabales",4,0,0,11,4,1
"Saracha","Solanaceae","Solanales",0,0,0,13,0,NA
"Saranthe","Marantaceae","Zingiberales",0,0,0,9,0,NA
"Sararanga","Pandanaceae","Pandanales",0,0,0,2,0,NA
"Sarcandra","Chloranthaceae","Chloranthales",1,0,0,1,1,1
"Sarcanthopsis","Orchidaceae","Asparagales",0,0,0,5,0,NA
"Sarcaulus","Sapotaceae","Ericales",5,0,0,5,5,1
"Sarcobatus","Sarcobataceae","Caryophyllales",1,0,0,2,1,1
"Sarcocaulon","Geraniaceae","Geraniales",1,0,0,15,1,1
"Sarcocephalus","Rubiaceae","Gentianales",2,0,0,2,2,1
"Sarcochilus","Orchidaceae","Asparagales",0,0,4,25,4,0
"Sarcochlamys","Urticaceae","Rosales",0,0,0,1,0,NA
"Sarcococca","Buxaceae","Buxales",2,0,0,6,2,1
"Sarcocornia","Amaranthaceae","Caryophyllales",0,1,3,20,3,0
"Sarcodes","Ericaceae","Ericales",0,0,0,1,0,NA
"Sarcodraba","Brassicaceae","Brassicales",0,0,0,4,0,NA
"Sarcodum","Fabaceae","Fabales",0,0,0,2,0,NA
"Sarcoglottis","Orchidaceae","Asparagales",0,0,1,49,1,0
"Sarcoglyphis","Orchidaceae","Asparagales",0,0,1,12,1,0
"Sarcolaena","Sarcolaenaceae","Malvales",1,0,0,8,1,1
"Sarcolobus","Apocynaceae","Gentianales",0,0,0,6,0,NA
"Sarcolophium","Menispermaceae","Ranunculales",0,0,0,1,0,NA
"Sarcomelicope","Rutaceae","Sapindales",0,0,0,1,0,NA
"Sarcomphalus","Rhamnaceae","Rosales",1,0,0,1,1,1
"Sarcopera","Marcgraviaceae","Ericales",1,2,0,7,1,1
"Sarcophrynium","Marantaceae","Zingiberales",0,0,3,7,3,0
"Sarcophyte","Balanophoraceae","Santalales",0,0,0,1,0,NA
"Sarcophyton","Orchidaceae","Asparagales",0,0,0,3,0,NA
"Sarcopoterium","Rosaceae","Rosales",1,0,0,1,1,1
"Sarcopteryx","Sapindaceae","Sapindales",0,0,0,1,0,NA
"Sarcopygme","Rubiaceae","Gentianales",0,0,0,5,0,NA
"Sarcopyramis","Melastomataceae","Myrtales",0,0,1,2,1,0
"Sarcorhachis","Piperaceae","Piperales",0,0,0,4,0,NA
"Sarcorrhiza","Apocynaceae","Gentianales",0,0,0,1,0,NA
"Sarcosperma","Sapotaceae","Ericales",4,0,0,11,4,1
"Sarcostemma","Apocynaceae","Gentianales",1,0,0,20,1,1
"Sarcostigma","Icacinaceae","UnknownOrder-Icacinaceae",1,0,0,2,1,1
"Sarcostoma","Orchidaceae","Asparagales",0,0,0,5,0,NA
"Sarcotheca","Oxalidaceae","Oxalidales",0,0,0,1,0,NA
"Sarcozona","Aizoaceae","Caryophyllales",0,0,0,2,0,NA
"Sarcozygium","Zygophyllaceae","Zygophyllales",0,0,0,1,0,NA
"Sargentodoxa","Lardizabalaceae","Ranunculales",0,1,0,1,0,NA
"Saribus","Arecaceae","Arecales",0,0,0,8,0,NA
"Sarmienta","Gesneriaceae","Lamiales",1,0,0,1,1,1
"Sarojusticia","Acanthaceae","Lamiales",0,0,0,1,0,NA
"Sarothamnus","Fabaceae","Fabales",0,0,0,2,0,NA
"Sarotheca","Acanthaceae","Lamiales",0,0,0,1,0,NA
"Sarracenia","Sarraceniaceae","Ericales",0,0,2,21,2,0
"Sartidia","Poaceae","Poales",0,0,0,4,0,NA
"Sartoria","Fabaceae","Fabales",0,0,0,1,0,NA
"Sartorina","Asteraceae","Asterales",0,0,0,1,0,NA
"Sartwellia","Asteraceae","Asterales",0,0,0,5,0,NA
"Saruma","Aristolochiaceae","Piperales",0,0,1,1,1,0
"Sasa","Poaceae","Poales",4,0,0,59,4,1
"Sassafras","Lauraceae","Laurales",3,0,0,5,3,1
"Sassia","Oxalidaceae","Oxalidales",0,0,0,1,0,NA
"Satakentia","Arecaceae","Arecales",1,0,0,1,1,1
"Satanocrater","Acanthaceae","Lamiales",0,0,0,2,0,NA
"Satranala","Arecaceae","Arecales",1,0,0,1,1,1
"Satureja","Lamiaceae","Lamiales",3,0,1,53,4,0.75
"Satyria","Ericaceae","Ericales",6,0,0,24,6,1
"Satyrium","Orchidaceae","Asparagales",0,0,59,89,59,0
"Saundersia","Orchidaceae","Asparagales",0,0,0,2,0,NA
"Saurauia","Actinidiaceae","Ericales",12,0,0,100,12,1
"Sauroglossum","Orchidaceae","Asparagales",0,0,0,11,0,NA
"Saurolophorkis","Orchidaceae","Asparagales",0,0,0,2,0,NA
"Sauromatum","Araceae","Alismatales",0,0,0,9,0,NA
"Sauropus","Phyllanthaceae","Malpighiales",5,1,1,81,6,0.833333333333333
"Saururus","Saururaceae","Piperales",0,0,2,2,2,0
"Saussurea","Asteraceae","Asterales",0,0,40,433,40,0
"Saussuria","Asteraceae","Asterales",0,0,0,1,0,NA
"Sauvagesia","Ochnaceae","Malpighiales",1,1,3,40,4,0.25
"Sauvallea","Commelinaceae","Commelinales",0,0,0,1,0,NA
"Sauvetrea","Orchidaceae","Asparagales",0,0,3,11,3,0
"Savannosiphon","Iridaceae","Asparagales",0,0,0,1,0,NA
"Savia","Phyllanthaceae","Malpighiales",2,0,0,2,2,1
"Savignya","Brassicaceae","Brassicales",0,0,0,1,0,NA
"Saxegothaea","Podocarpaceae","Araucariales",1,0,0,1,1,1
"Saxicolella","Podostemaceae","Malpighiales",0,0,0,1,0,NA
"Saxifraga","Saxifragaceae","Saxifragales",0,0,64,450,64,0
"Saxifragella","Saxifragaceae","Saxifragales",0,0,1,1,1,0
"Saxifragodes","Saxifragaceae","Saxifragales",0,0,1,1,1,0
"Saxifragopsis","Saxifragaceae","Saxifragales",0,0,0,1,0,NA
"Saxiglossum","Polypodiaceae","Polypodiales",0,0,0,1,0,NA
"Saxofridericia","Rapateaceae","Poales",0,0,2,8,2,0
"Scabiosa","Caprifoliaceae","Dipsacales",0,0,4,62,4,0
"Scabrethia","Asteraceae","Asterales",0,0,0,1,0,NA
"Scadoxus","Amaryllidaceae","Asparagales",0,0,4,9,4,0
"Scaevola","Goodeniaceae","Asterales",2,0,1,14,3,0.666666666666667
"Scagea","Picrodendraceae","Malpighiales",2,0,0,2,2,1
"Scalesia","Asteraceae","Asterales",4,0,0,10,4,1
"Scaligeria","Apiaceae","Apiales",0,0,0,3,0,NA
"Scambopus","Brassicaceae","Brassicales",0,0,0,1,0,NA
"Scandia","Apiaceae","Apiales",1,0,0,1,1,1
"Scandix","Apiaceae","Apiales",0,0,1,4,1,0
"Scaphiophora","Burmanniaceae","Dioscoreales",0,0,0,2,0,NA
"Scaphispatha","Araceae","Alismatales",0,0,1,2,1,0
"Scaphium","Malvaceae","Malvales",4,0,0,8,4,1
"Scaphochlamys","Zingiberaceae","Zingiberales",0,0,0,33,0,NA
"Scaphopetalum","Malvaceae","Malvales",3,0,0,12,3,1
"Scaphosepalum","Orchidaceae","Asparagales",0,0,1,47,1,0
"Scaphyglottis","Orchidaceae","Asparagales",0,0,6,69,6,0
"Scariola","Asteraceae","Asterales",0,0,0,4,0,NA
"Sceletium","Aizoaceae","Caryophyllales",0,0,0,20,0,NA
"Scelochilus","Orchidaceae","Asparagales",0,0,0,1,0,NA
"Sceptridium","Ophioglossaceae","Ophioglossales",0,0,0,10,0,NA
"Schaefferia","Celastraceae","Celastrales",1,0,0,11,1,1
"Schaffnerella","Poaceae","Poales",0,0,0,1,0,NA
"Schaffneria","Aspleniaceae","Polypodiales",0,0,0,1,0,NA
"Schauera","Lauraceae","Laurales",0,0,0,1,0,NA
"Schaueria","Acanthaceae","Lamiales",0,0,0,8,0,NA
"Schedonnardus","Poaceae","Poales",0,0,1,1,1,0
"Schedonorus","Poaceae","Poales",0,0,0,1,0,NA
"Schefferomitra","Annonaceae","Magnoliales",0,0,0,1,0,NA
"Schefflera","Araliaceae","Apiales",67,0,0,591,67,1
"Schefflerodendron","Fabaceae","Fabales",0,0,0,4,0,NA
"Schelhammera","Colchicaceae","Liliales",0,0,2,2,2,0
"Schellolepis","Polypodiaceae","Polypodiales",0,0,0,5,0,NA
"Schenkia","Gentianaceae","Gentianales",0,0,1,5,1,0
"Scherya","Asteraceae","Asterales",0,0,0,1,0,NA
"Scheuchzeria","Scheuchzeriaceae","Alismatales",0,0,1,1,1,0
"Schickendantziella","Alstroemeriaceae","Liliales",0,0,0,1,0,NA
"Schiedea","Caryophyllaceae","Caryophyllales",4,5,1,19,5,0.8
"Schiedeella","Orchidaceae","Asparagales",0,0,0,25,0,NA
"Schiekia","Haemodoraceae","Commelinales",0,0,0,1,0,NA
"Schima","Theaceae","Ericales",6,0,0,12,6,1
"Schimpera","Brassicaceae","Brassicales",0,0,0,1,0,NA
"Schindleria","Phytolaccaceae","Caryophyllales",0,0,0,3,0,NA
"Schinopsis","Anacardiaceae","Sapindales",5,0,0,9,5,1
"Schinus","Anacardiaceae","Sapindales",7,0,0,31,7,1
"Schinziella","Gentianaceae","Gentianales",0,0,0,1,0,NA
"Schinziophyton","Euphorbiaceae","Malpighiales",1,0,0,1,1,1
"Schippia","Arecaceae","Arecales",1,0,0,1,1,1
"Schisandra","Schisandraceae","Austrobaileyales",11,0,0,25,11,1
"Schischkinia","Asteraceae","Asterales",0,0,0,1,0,NA
"Schismatoclada","Rubiaceae","Gentianales",0,0,0,19,0,NA
"Schismatoglottis","Araceae","Alismatales",0,0,1,104,1,0
"Schismocarpus","Loasaceae","Cornales",0,0,1,2,1,0
"Schismus","Poaceae","Poales",0,0,1,5,1,0
"Schistocarpha","Asteraceae","Asterales",0,0,0,13,0,NA
"Schistogyne","Apocynaceae","Gentianales",0,0,0,8,0,NA
"Schistonema","Apocynaceae","Gentianales",0,0,0,1,0,NA
"Schistophragma","Plantaginaceae","Lamiales",0,0,0,4,0,NA
"Schistostemon","Humiriaceae","Malpighiales",1,0,0,10,1,1
"Schistostephium","Asteraceae","Asterales",1,0,0,13,1,1
"Schistotylus","Orchidaceae","Asparagales",0,0,0,1,0,NA
"Schivereckia","Brassicaceae","Brassicales",0,0,0,3,0,NA
"Schizachne","Poaceae","Poales",0,0,1,1,1,0
"Schizachyrium","Poaceae","Poales",0,0,4,59,4,0
"Schizaea","Schizaeaceae","Schizaeales",0,0,3,15,3,0
"Schizanthus","Solanaceae","Solanales",0,0,1,12,1,0
"Schizenterospermum","Rubiaceae","Gentianales",1,0,0,4,1,1
"Schizobasis","Asparagaceae","Asparagales",0,0,0,4,0,NA
"Schizoboea","Gesneriaceae","Lamiales",0,0,0,1,0,NA
"Schizocaena","Cyatheaceae","Cyatheales",0,0,0,5,0,NA
"Schizocalomyrtus","Myrtaceae","Myrtales",0,0,0,1,0,NA
"Schizocalyx","Rubiaceae","Gentianales",0,0,0,10,0,NA
"Schizocarphus","Asparagaceae","Asparagales",0,0,1,1,1,0
"Schizocarpum","Cucurbitaceae","Cucurbitales",0,0,3,10,3,0
"Schizochilus","Orchidaceae","Asparagales",0,0,0,11,0,NA
"Schizocolea","Rubiaceae","Gentianales",0,0,0,2,0,NA
"Schizoglossum","Apocynaceae","Gentianales",0,0,0,39,0,NA
"Schizogyne","Asteraceae","Asterales",1,0,0,3,1,1
"Schizolaena","Sarcolaenaceae","Malvales",1,0,0,20,1,1
"Schizolegnia","Lindsaeaceae","Polypodiales",0,0,0,3,0,NA
"Schizolepton","Pteridaceae","Polypodiales",0,0,0,1,0,NA
"Schizolobium","Fabaceae","Fabales",2,0,0,2,2,1
"Schizoloma","Lindsaeaceae","Polypodiales",0,0,0,8,0,NA
"Schizomussaenda","Rubiaceae","Gentianales",0,0,0,1,0,NA
"Schizopepon","Cucurbitaceae","Cucurbitales",0,0,1,8,1,0
"Schizopetalon","Brassicaceae","Brassicales",0,0,1,10,1,0
"Schizophragma","Hydrangeaceae","Cornales",1,0,0,9,1,1
"Schizoptera","Asteraceae","Asterales",0,0,0,1,0,NA
"Schizostachyum","Poaceae","Poales",2,0,0,58,2,1
"Schizostege","Pteridaceae","Polypodiales",0,0,1,1,1,0
"Schizostephanus","Apocynaceae","Gentianales",0,0,0,1,0,NA
"Schizotorenia","Linderniaceae","Lamiales",0,0,0,1,0,NA
"Schizotrichia","Asteraceae","Asterales",0,0,0,1,0,NA
"Schizozygia","Apocynaceae","Gentianales",1,0,0,1,1,1
"Schkuhria","Asteraceae","Asterales",0,0,0,7,0,NA
"Schlagintweitia","Asteraceae","Asterales",0,0,0,3,0,NA
"Schlechtendalia","Asteraceae","Asterales",0,0,1,2,1,0
"Schlechteranthus","Aizoaceae","Caryophyllales",0,0,0,2,0,NA
"Schlechterella","Apocynaceae","Gentianales",0,0,0,1,0,NA
"Schlechterina","Passifloraceae","Malpighiales",0,0,0,1,0,NA
"Schlegelia","Schlegeliaceae","Lamiales",4,0,0,23,4,1
"Schleichera","Sapindaceae","Sapindales",2,0,0,2,2,1
"Schleinitzia","Fabaceae","Fabales",1,0,0,5,1,1
"Schlimia","Orchidaceae","Asparagales",0,0,0,7,0,NA
"Schlumbergera","Cactaceae","Caryophyllales",1,0,0,7,1,1
"Schmalhausenia","Asteraceae","Asterales",0,0,1,1,1,0
"Schmaltzia","Anacardiaceae","Sapindales",0,0,0,11,0,NA
"Schmardaea","Meliaceae","Sapindales",1,0,0,1,1,1
"Schmidelia","Sapindaceae","Sapindales",0,0,0,1,0,NA
"Schmidtia","Asteraceae",NA,0,0,0,1,0,NA
"Schmidtia","Poaceae","Poales",0,0,1,2,1,0
"Schmidtottia","Rubiaceae","Gentianales",0,0,0,15,0,NA
"Schnabelia","Lamiaceae","Lamiales",0,0,3,5,3,0
"Schnella","Fabaceae","Fabales",0,0,0,6,0,NA
"Schoenefeldia","Poaceae","Poales",0,0,0,2,0,NA
"Schoenia","Asteraceae","Asterales",0,0,2,5,2,0
"Schoenobiblus","Thymelaeaceae","Malvales",0,0,0,10,0,NA
"Schoenocaulon","Melanthiaceae","Liliales",0,0,2,26,2,0
"Schoenocephalium","Rapateaceae","Poales",0,0,1,4,1,0
"Schoenocrambe","Brassicaceae","Brassicales",0,0,0,1,0,NA
"Schoenolirion","Asparagaceae","Asparagales",0,0,0,3,0,NA
"Schoenoplectiella","Cyperaceae","Poales",0,0,10,30,10,0
"Schoenoplectus","Cyperaceae","Poales",0,0,13,53,13,0
"Schoenorchis","Orchidaceae","Asparagales",0,0,1,24,1,0
"Schoenoxiphium","Cyperaceae","Poales",0,0,2,21,2,0
"Schoenus","Cyperaceae","Poales",0,0,25,109,25,0
"Schoepfia","Schoepfiaceae","Santalales",4,0,0,25,4,1
"Scholleropsis","Pontederiaceae","Commelinales",0,0,0,1,0,NA
"Scholtzia","Myrtaceae","Myrtales",7,0,0,13,7,1
"Schomburgkia","Orchidaceae","Asparagales",0,0,0,2,0,NA
"Schotia","Fabaceae","Fabales",1,0,0,4,1,1
"Schottariella","Araceae","Alismatales",0,0,0,1,0,NA
"Schouwia","Brassicaceae","Brassicales",0,0,0,2,0,NA
"Schradera","Rubiaceae","Gentianales",2,0,0,55,2,1
"Schrankia","Fabaceae","Fabales",0,0,0,3,0,NA
"Schrebera","Oleaceae","Lamiales",4,0,0,8,4,1
"Schreiteria","Portulacaceae","Caryophyllales",0,0,0,1,0,NA
"Schrenkia","Apiaceae","Apiales",0,0,0,1,0,NA
"Schroeterella","Zygophyllaceae","Zygophyllales",0,0,0,1,0,NA
"Schtschurowskia","Apiaceae","Apiales",0,0,0,1,0,NA
"Schubertia","Apocynaceae","Gentianales",0,0,0,4,0,NA
"Schuitemania","Orchidaceae","Asparagales",0,0,0,1,0,NA
"Schultesia","Gentianaceae","Gentianales",0,0,0,14,0,NA
"Schultesianthus","Solanaceae","Solanales",0,0,0,7,0,NA
"Schultesiophytum","Cyclanthaceae","Pandanales",0,0,0,1,0,NA
"Schulzia","Apiaceae","Apiales",0,0,0,4,0,NA
"Schumannianthus","Marantaceae","Zingiberales",0,0,1,2,1,0
"Schumanniophyton","Rubiaceae","Gentianales",1,0,0,3,1,1
"Schumeria","Asteraceae","Asterales",0,0,0,2,0,NA
"Schunkea","Orchidaceae","Asparagales",0,0,0,1,0,NA
"Schuurmansiella","Ochnaceae","Malpighiales",0,0,0,1,0,NA
"Schwackaea","Melastomataceae","Myrtales",0,0,0,1,0,NA
"Schwalbea","Orobanchaceae","Lamiales",0,0,1,2,1,0
"Schwantesia","Aizoaceae","Caryophyllales",0,0,0,10,0,NA
"Schwartzia","Marcgraviaceae","Ericales",3,0,0,18,3,1
"Schweiggeria","Violaceae","Malpighiales",0,0,0,1,0,NA
"Schweinfurthia","Plantaginaceae","Lamiales",1,0,0,2,1,1
"Schwenckia","Solanaceae","Solanales",1,0,0,18,1,1
"Schwendenera","Rubiaceae","Gentianales",0,0,0,1,0,NA
"Sciadocephala","Asteraceae","Asterales",0,0,0,5,0,NA
"Sciadopitys","Sciadopityaceae","Cupressales",0,0,0,1,0,NA
"Sciadotenia","Menispermaceae","Ranunculales",1,2,0,20,1,1
"Sciaphila","Triuridaceae","Pandanales",0,0,2,37,2,0
"Scilla","Asparagaceae","Asparagales",0,0,5,83,5,0
"Scindapsus","Araceae","Alismatales",0,0,0,35,0,NA
"Scirpodendron","Cyperaceae","Poales",0,0,2,2,2,0
"Scirpoides","Cyperaceae","Poales",0,0,2,4,2,0
"Scirpus","Cyperaceae","Poales",0,0,20,58,20,0
"Scleranthopsis","Caryophyllaceae","Caryophyllales",0,0,0,1,0,NA
"Scleranthus","Caryophyllaceae","Caryophyllales",0,0,1,4,1,0
"Scleria","Cyperaceae","Poales",0,0,32,253,32,0
"Scleroblitum","Amaranthaceae","Caryophyllales",0,0,1,1,1,0
"Sclerocactus","Cactaceae","Caryophyllales",0,0,0,16,0,NA
"Sclerocarpus","Asteraceae","Asterales",0,0,0,11,0,NA
"Sclerocarya","Anacardiaceae","Sapindales",1,0,0,2,1,1
"Sclerochiton","Acanthaceae","Lamiales",0,0,0,18,0,NA
"Sclerochlamys","Amaranthaceae","Caryophyllales",0,0,0,1,0,NA
"Sclerochloa","Poaceae","Poales",0,0,1,2,1,0
"Sclerocroton","Euphorbiaceae","Malpighiales",3,0,0,6,3,1
"Sclerodactylon","Poaceae","Poales",0,0,0,1,0,NA
"Scleroglossum","Polypodiaceae","Polypodiales",0,0,0,2,0,NA
"Sclerolaena","Amaranthaceae","Caryophyllales",17,0,9,63,26,0.653846153846154
"Sclerolepis","Asteraceae","Asterales",0,0,0,1,0,NA
"Sclerolinon","Linaceae","Malpighiales",0,0,1,1,1,0
"Sclerolobium","Fabaceae","Fabales",13,0,0,40,13,1
"Scleronema","Malvaceae","Malvales",2,0,0,3,2,1
"Sclerophylax","Solanaceae","Solanales",0,0,0,13,0,NA
"Scleropogon","Poaceae","Poales",0,0,0,1,0,NA
"Scleropyrum","Santalaceae","Santalales",1,0,0,1,1,1
"Sclerorhachis","Asteraceae","Asterales",0,0,0,3,0,NA
"Sclerosciadium","Apiaceae","Apiales",0,0,0,1,0,NA
"Sclerosperma","Arecaceae","Arecales",1,0,0,3,1,1
"Sclerostegia","Amaranthaceae","Caryophyllales",0,0,0,2,0,NA
"Sclerotheca","Campanulaceae","Asterales",0,0,0,6,0,NA
"Sclerotiaria","Apiaceae","Apiales",0,0,0,1,0,NA
"Scoliaxon","Brassicaceae","Brassicales",0,0,0,1,0,NA
"Scoliopus","Liliaceae","Liliales",0,0,0,2,0,NA
"Scoliosorus","Pteridaceae","Polypodiales",0,0,0,2,0,NA
"Scolochloa","Poaceae","Poales",0,0,1,1,1,0
"Scolopendrium","Aspleniaceae","Polypodiales",0,0,0,1,0,NA
"Scolophyllum","Linderniaceae","Lamiales",0,0,0,1,0,NA
"Scolopia","Salicaceae","Malpighiales",7,0,0,28,7,1
"Scolosanthus","Rubiaceae","Gentianales",0,0,0,27,0,NA
"Scolymocephalus","Proteaceae","Proteales",0,0,0,1,0,NA
"Scolymus","Asteraceae","Asterales",0,0,2,4,2,0
"Scoparia","Plantaginaceae","Lamiales",0,0,1,10,1,0
"Scopella","Cucurbitaceae","Cucurbitales",0,0,0,1,0,NA
"Scopellaria","Cucurbitaceae","Cucurbitales",0,0,1,1,1,0
"Scopolia","Solanaceae","Solanales",0,0,0,1,0,NA
"Scopulophila","Caryophyllaceae","Caryophyllales",0,0,0,2,0,NA
"Scorodocarpus","Olacaceae","Santalales",1,0,0,1,1,1
"Scorodophloeus","Fabaceae","Fabales",1,0,0,2,1,1
"Scorpiothyrsus","Melastomataceae","Myrtales",0,0,0,3,0,NA
"Scorpiurus","Fabaceae","Fabales",0,0,0,3,0,NA
"Scorzonera","Asteraceae","Asterales",0,0,10,199,10,0
"Scorzoneroides","Asteraceae","Asterales",0,0,1,25,1,0
"Scottellia","Achariaceae","Malpighiales",1,0,0,3,1,1
"Scribneria","Poaceae","Poales",0,0,0,1,0,NA
"Scrithacola","Apiaceae","Apiales",0,0,0,1,0,NA
"Scrobicaria","Asteraceae","Asterales",0,0,0,3,0,NA
"Scrofella","Plantaginaceae","Lamiales",0,0,0,1,0,NA
"Scrophucephalus","Scrophulariaceae","Lamiales",0,0,0,1,0,NA
"Scrophularia","Scrophulariaceae","Lamiales",1,0,10,86,11,0.0909090909090909
"Scurrula","Loranthaceae","Santalales",0,0,0,10,0,NA
"Scutachne","Poaceae","Poales",0,0,0,2,0,NA
"Scutellaria","Lamiaceae","Lamiales",3,1,22,468,25,0.12
"Scutia","Rhamnaceae","Rosales",2,0,0,5,2,1
"Scuticaria","Orchidaceae","Asparagales",0,0,2,10,2,0
"Scybalium","Balanophoraceae","Santalales",0,0,0,4,0,NA
"Scyphanthus","Loasaceae","Cornales",0,0,1,2,1,0
"Scyphiphora","Rubiaceae","Gentianales",1,0,0,1,1,1
"Scyphocephalium","Myristicaceae","Magnoliales",2,0,0,2,2,1
"Scyphogyne","Ericaceae","Ericales",0,0,0,4,0,NA
"Scyphonychium","Sapindaceae","Sapindales",0,0,0,1,0,NA
"Scyphostachys","Rubiaceae","Gentianales",0,0,0,2,0,NA
"Scyphosyce","Moraceae","Rosales",0,0,0,2,0,NA
"Scyphularia","Davalliaceae","Polypodiales",0,0,0,1,0,NA
"Scytopetalum","Lecythidaceae","Ericales",1,0,0,3,1,1
"Searsia","Anacardiaceae","Sapindales",11,0,0,22,11,1
"Sebaea","Gentianaceae","Gentianales",0,0,0,70,0,NA
"Sebastiania","Euphorbiaceae","Malpighiales",4,0,0,72,4,1
"Secale","Poaceae","Poales",0,0,3,9,3,0
"Secamone","Apocynaceae","Gentianales",9,0,0,100,9,1
"Secamonopsis","Apocynaceae","Gentianales",0,0,0,2,0,NA
"Sechiopsis","Cucurbitaceae","Cucurbitales",0,0,1,5,1,0
"Sechium","Cucurbitaceae","Cucurbitales",0,0,1,11,1,0
"Secondatia","Apocynaceae","Gentianales",1,0,0,5,1,1
"Securidaca","Polygalaceae","Fabales",3,0,0,49,3,1
"Securigera","Fabaceae","Fabales",0,0,1,13,1,0
"Securinega","Phyllanthaceae","Malpighiales",2,0,0,5,2,1
"Sedastrum","Crassulaceae","Saxifragales",0,0,0,1,0,NA
"Seddera","Convolvulaceae","Solanales",2,0,0,8,2,1
"Sedderopsis","Convolvulaceae","Solanales",0,0,0,1,0,NA
"Sedirea","Orchidaceae","Asparagales",0,0,0,2,0,NA
"Sedirisia","Orchidaceae","Asparagales",0,0,0,1,0,NA
"Sedum","Crassulaceae","Saxifragales",2,0,8,392,10,0.2
"Seegeriella","Orchidaceae","Asparagales",0,0,0,2,0,NA
"Seemannaralia","Araliaceae","Apiales",0,0,0,1,0,NA
"Seemannia","Gesneriaceae","Lamiales",0,0,0,4,0,NA
"Seetzenia","Zygophyllaceae","Zygophyllales",0,1,0,1,0,NA
"Seguieria","Phytolaccaceae","Caryophyllales",2,0,0,6,2,1
"Sehima","Poaceae","Poales",0,0,0,5,0,NA
"Seidelia","Euphorbiaceae","Malpighiales",1,0,0,2,1,1
"Seidenfadenia","Orchidaceae","Asparagales",0,0,1,1,1,0
"Seidenfadeniella","Orchidaceae","Asparagales",0,0,0,2,0,NA
"Seidlitzia","Amaranthaceae","Caryophyllales",1,0,0,2,1,1
"Selaginella","Selaginellaceae","Selaginellales",0,0,1,376,1,0
"Selago","Scrophulariaceae","Lamiales",0,0,3,201,3,0
"Selanodesmium","Hymenophyllaceae","Hymenophyllales",0,0,0,1,0,NA
"Selbya","Meliaceae","Sapindales",0,0,0,1,0,NA
"Selenia","Brassicaceae","Brassicales",0,0,1,5,1,0
"Selenicereus","Cactaceae","Caryophyllales",1,0,1,28,2,0.5
"Selenipedium","Orchidaceae","Asparagales",0,0,1,5,1,0
"Selenodesmium","Hymenophyllaceae","Hymenophyllales",0,0,0,3,0,NA
"Selera","Malvaceae","Malvales",0,0,0,1,0,NA
"Selinum","Apiaceae","Apiales",0,0,1,8,1,0
"Selkirkia","Boraginaceae","UnknownOrder-Boraginaceae",0,0,0,1,0,NA
"Selleophytum","Asteraceae","Asterales",0,0,0,1,0,NA
"Selliera","Goodeniaceae","Asterales",0,1,0,1,0,NA
"Selliguea","Polypodiaceae","Polypodiales",0,0,0,32,0,NA
"Selloa","Asteraceae","Asterales",0,0,0,6,0,NA
"Sellocharis","Fabaceae","Fabales",0,0,0,1,0,NA
"Selysia","Cucurbitaceae","Cucurbitales",0,1,0,4,0,NA
"Semecarpus","Anacardiaceae","Sapindales",1,0,0,5,1,1
"Semele","Asparagaceae","Asparagales",0,0,1,3,1,0
"Semenovia","Apiaceae","Apiales",0,0,0,8,0,NA
"Semialarium","Celastraceae","Celastrales",1,0,0,2,1,1
"Semiaquilegia","Ranunculaceae","Ranunculales",0,0,1,1,1,0
"Semiarundinaria","Poaceae","Poales",2,0,0,7,2,1
"Semiliquidambar","Altingiaceae","Saxifragales",2,0,0,3,2,1
"Semiramisia","Ericaceae","Ericales",1,0,0,3,1,1
"Semiria","Asteraceae","Asterales",0,0,0,1,0,NA
"Semnos","Loganiaceae","Gentianales",0,0,0,1,0,NA
"Semnothyrsus","Acanthaceae","Lamiales",0,0,0,1,0,NA
"Sempervivum","Crassulaceae","Saxifragales",0,0,0,33,0,NA
"Senaea","Gentianaceae","Gentianales",0,0,0,2,0,NA
"Senapea","Passifloraceae","Malpighiales",0,0,0,1,0,NA
"Senecillis","Asteraceae","Asterales",0,0,0,3,0,NA
"Senecio","Asteraceae","Asterales",10,0,26,1587,36,0.277777777777778
"Senecioneae","Asteraceae","Asterales",0,0,0,5,0,NA
"Senefeldera","Euphorbiaceae","Malpighiales",0,0,0,3,0,NA
"Senefelderopsis","Euphorbiaceae","Malpighiales",0,0,0,2,0,NA
"Senegalia","Fabaceae","Fabales",0,0,0,66,0,NA
"Senghasiella","Orchidaceae","Asparagales",0,0,0,1,0,NA
"Senna","Fabaceae","Fabales",36,3,3,272,39,0.923076923076923
"Senra","Malvaceae","Malvales",0,0,0,1,0,NA
"Seorsus","Myrtaceae","Myrtales",1,0,0,4,1,1
"Septotheca","Malvaceae","Malvales",1,0,0,1,1,1
"Septulina","Loranthaceae","Santalales",1,0,0,2,1,1
"Sequoia","Cupressaceae","Cupressales",1,0,0,1,1,1
"Sequoiadendron","Cupressaceae","Cupressales",1,0,0,1,1,1
"Serapias","Orchidaceae","Asparagales",0,0,0,36,0,NA
"Serapicamptis","Orchidaceae","Asparagales",0,0,0,24,0,NA
"Serapirhiza","Orchidaceae","Asparagales",0,0,0,1,0,NA
"Serenoa","Arecaceae","Arecales",1,0,0,1,1,1
"Sergia","Campanulaceae","Asterales",0,0,0,2,0,NA
"Serianthes","Fabaceae","Fabales",3,0,0,8,3,1
"Sericanthe","Rubiaceae","Gentianales",1,0,0,17,1,1
"Sericocalyx","Acanthaceae","Lamiales",0,0,0,1,0,NA
"Sericocarpus","Asteraceae","Asterales",0,0,0,6,0,NA
"Sericocoma","Amaranthaceae","Caryophyllales",0,1,0,3,0,NA
"Sericocomopsis","Amaranthaceae","Caryophyllales",0,0,0,2,0,NA
"Sericodes","Zygophyllaceae","Zygophyllales",0,0,0,1,0,NA
"Sericographis","Acanthaceae","Lamiales",0,0,0,1,0,NA
"Sericolea","Elaeocarpaceae","Oxalidales",0,0,0,1,0,NA
"Sericorema","Amaranthaceae","Caryophyllales",0,0,0,2,0,NA
"Sericostachys","Amaranthaceae","Caryophyllales",1,0,0,1,1,1
"Sericostoma","Boraginaceae","UnknownOrder-Boraginaceae",0,0,0,1,0,NA
"Seringia","Malvaceae","Malvales",1,0,0,1,1,1
"Seriola","Asteraceae","Asterales",0,0,0,1,0,NA
"Seriphidium","Asteraceae","Asterales",1,0,1,76,2,0.5
"Seriphium","Asteraceae","Asterales",0,0,0,3,0,NA
"Serissa","Rubiaceae","Gentianales",1,0,0,1,1,1
"Serjania","Sapindaceae","Sapindales",40,0,0,208,40,1
"Serpocaulon","Polypodiaceae","Polypodiales",0,0,0,40,0,NA
"Serratula","Asteraceae","Asterales",0,0,4,40,4,0
"Serruria","Proteaceae","Proteales",14,0,0,85,14,1
"Sersalisia","Sapotaceae","Ericales",1,0,0,2,1,1
"Sertifera","Orchidaceae","Asparagales",0,0,0,7,0,NA
"Sertula","Fabaceae","Fabales",0,0,0,16,0,NA
"Seruneum","Asteraceae","Asterales",0,0,0,1,0,NA
"Sesamoides","Resedaceae","Brassicales",0,0,6,6,6,0
"Sesamothamnus","Pedaliaceae","Lamiales",0,0,0,5,0,NA
"Sesamum","Pedaliaceae","Lamiales",0,0,1,26,1,0
"Sesban","Fabaceae","Fabales",0,0,0,3,0,NA
"Sesbania","Fabaceae","Fabales",3,1,3,56,6,0.5
"Seseli","Apiaceae","Apiales",0,0,2,77,2,0
"Seselopsis","Apiaceae","Apiales",0,0,0,1,0,NA
"Sesleria","Poaceae","Poales",0,0,8,28,8,0
"Sessea","Solanaceae","Solanales",2,0,0,19,2,1
"Sessilanthera","Iridaceae","Asparagales",0,0,1,3,1,0
"Sesuvium","Aizoaceae","Caryophyllales",0,0,1,11,1,0
"Setaria","Poaceae","Poales",0,0,19,104,19,0
"Setariopsis","Poaceae","Poales",0,0,0,2,0,NA
"Setchellanthus","Setchellanthaceae","Brassicales",1,0,0,1,1,1
"Setulocarya","Boraginaceae","UnknownOrder-Boraginaceae",0,0,0,1,0,NA
"Seutera","Apocynaceae","Gentianales",0,0,0,2,0,NA
"Sevada","Amaranthaceae","Caryophyllales",0,0,0,1,0,NA
"Severinia","Rutaceae","Sapindales",0,0,0,1,0,NA
"Sextonia","Lauraceae","Laurales",1,0,0,2,1,1
"Seychellaria","Triuridaceae","Pandanales",0,0,0,4,0,NA
"Seymeria","Orobanchaceae","Lamiales",0,0,1,26,1,0
"Seyrigia","Cucurbitaceae","Cucurbitales",0,1,0,5,0,NA
"Shafera","Asteraceae","Asterales",0,0,0,1,0,NA
"Shaferocharis","Rubiaceae","Gentianales",0,0,0,3,0,NA
"Shangrilaia","Brassicaceae","Brassicales",0,0,1,1,1,0
"Sheareria","Asteraceae","Asterales",0,0,1,1,1,0
"Sheilanthera","Rutaceae","Sapindales",0,0,0,1,0,NA
"Shepherdia","Elaeagnaceae","Rosales",2,0,0,3,2,1
"Sherardia","Rubiaceae","Gentianales",0,0,1,2,1,0
"Sherbournia","Rubiaceae","Gentianales",0,0,0,13,0,NA
"Sherwoodia","Diapensiaceae","Ericales",0,0,0,1,0,NA
"Shibataea","Poaceae","Poales",1,0,0,7,1,1
"Shibateranthis","Ranunculaceae","Ranunculales",0,0,0,1,0,NA
"Shinnersia","Asteraceae","Asterales",0,0,0,1,0,NA
"Shinnersoseris","Asteraceae","Asterales",0,0,0,1,0,NA
"Shirakiopsis","Euphorbiaceae","Malpighiales",2,0,0,6,2,1
"Shiuyinghua","Paulowniaceae","Lamiales",0,0,0,1,0,NA
"Shonia","Euphorbiaceae","Malpighiales",0,0,0,4,0,NA
"Shorea","Dipterocarpaceae","Malvales",6,0,0,9,6,1
"Shortia","Diapensiaceae","Ericales",0,0,0,3,0,NA
"Shoshonea","Apiaceae","Apiales",0,0,0,1,0,NA
"Shuaria","Gesneriaceae","Lamiales",0,0,0,1,0,NA
"Shuteria","Fabaceae","Fabales",0,0,0,5,0,NA
"Siamanthus","Zingiberaceae","Zingiberales",0,0,0,1,0,NA
"Siapaea","Asteraceae","Asterales",0,0,0,1,0,NA
"Sibangea","Putranjivaceae","Malpighiales",1,0,0,3,1,1
"Sibara","Brassicaceae","Brassicales",0,0,0,8,0,NA
"Sibaropsis","Brassicaceae","Brassicales",0,0,0,1,0,NA
"Sibbaldia","Rosaceae","Rosales",0,0,2,15,2,0
"Sibbaldianthe","Rosaceae","Rosales",0,0,0,1,0,NA
"Sibbaldiopsis","Rosaceae","Rosales",0,0,0,2,0,NA
"Sibiraea","Rosaceae","Rosales",1,0,0,4,1,1
"Sibthorpia","Plantaginaceae","Lamiales",0,0,0,5,0,NA
"Sicana","Cucurbitaceae","Cucurbitales",0,0,1,3,1,0
"Siccobaccatus","Cactaceae","Caryophyllales",0,0,0,1,0,NA
"Sichuania","Apocynaceae","Gentianales",0,0,0,1,0,NA
"Sicklera","Solanaceae","Solanales",0,0,0,1,0,NA
"Sicydium","Cucurbitaceae","Cucurbitales",0,0,2,8,2,0
"Sicyocarya","Cucurbitaceae","Cucurbitales",0,0,0,2,0,NA
"Sicyocaulis","Cucurbitaceae","Cucurbitales",0,0,0,1,0,NA
"Sicyos","Cucurbitaceae","Cucurbitales",0,0,2,56,2,0
"Sicyosperma","Cucurbitaceae","Cucurbitales",0,0,1,1,1,0
"Sida","Malvaceae","Malvales",0,1,2,156,2,0
"Sidalcea","Malvaceae","Malvales",0,0,0,29,0,NA
"Sidasodes","Malvaceae","Malvales",0,0,0,1,0,NA
"Sidastrum","Malvaceae","Malvales",0,0,0,7,0,NA
"Sideranthus","Asteraceae","Asterales",0,0,0,1,0,NA
"Siderasis","Commelinaceae","Commelinales",0,0,1,1,1,0
"Sideritis","Lamiaceae","Lamiales",3,0,3,189,6,0.5
"Sideroxylon","Sapotaceae","Ericales",50,0,0,83,50,1
"Sidotheca","Polygonaceae","Caryophyllales",0,0,0,3,0,NA
"Siebera","Asteraceae","Asterales",0,0,0,2,0,NA
"Siemensia","Rubiaceae","Gentianales",0,0,0,1,0,NA
"Siemssenia","Asteraceae","Asterales",0,0,1,1,1,0
"Sievekingia","Orchidaceae","Asparagales",0,0,2,16,2,0
"Sieversandreas","Scrophulariaceae","Lamiales",0,0,0,1,0,NA
"Sieversia","Rosaceae","Rosales",0,0,0,2,0,NA
"Sigesbeckia","Asteraceae","Asterales",0,0,2,19,2,0
"Sigmatanthus","Rutaceae","Sapindales",0,0,0,1,0,NA
"Sigmoidotropis","Fabaceae","Fabales",0,0,0,9,0,NA
"Silaum","Apiaceae","Apiales",0,0,1,1,1,0
"Silene","Caryophyllaceae","Caryophyllales",1,0,25,487,26,0.0384615384615385
"Silentvalleya","Poaceae","Poales",0,0,0,1,0,NA
"Siliquamomum","Zingiberaceae","Zingiberales",0,0,0,2,0,NA
"Siliquastrum","Fabaceae","Fabales",0,0,0,1,0,NA
"Siloxerus","Asteraceae","Asterales",0,0,1,4,1,0
"Silphium","Asteraceae","Asterales",0,0,5,17,5,0
"Silvia","Orobanchaceae","Lamiales",0,0,0,2,0,NA
"Silvianthus","Carlemanniaceae","Lamiales",1,0,0,2,1,1
"Silviella","Orobanchaceae","Lamiales",0,0,0,2,0,NA
"Silvinula","Plantaginaceae","Lamiales",0,0,0,1,0,NA
"Silvorchis","Orchidaceae","Asparagales",0,0,0,1,0,NA
"Silybum","Asteraceae","Asterales",0,0,1,2,1,0
"Simaba","Simaroubaceae","Sapindales",9,0,0,24,9,1
"Simarouba","Simaroubaceae","Sapindales",3,0,0,3,3,1
"Simethis","Xanthorrhoeaceae","Asparagales",0,0,1,1,1,0
"Simicratea","Celastraceae","Celastrales",1,0,0,1,1,1
"Simira","Rubiaceae","Gentianales",8,0,0,43,8,1
"Simirestis","Celastraceae","Celastrales",0,0,0,5,0,NA
"Simmondsia","Simmondsiaceae","Caryophyllales",2,0,0,2,2,1
"Simocheilus","Ericaceae","Ericales",0,0,0,2,0,NA
"Simplicia","Poaceae","Poales",0,0,2,2,2,0
"Simsia","Asteraceae","Asterales",0,0,0,24,0,NA
"Sinacalia","Asteraceae","Asterales",0,0,1,4,1,0
"Sinadoxa","Adoxaceae","Dipsacales",0,0,1,1,1,0
"Sinapidendron","Brassicaceae","Brassicales",0,0,0,4,0,NA
"Sinapis","Brassicaceae","Brassicales",0,0,2,6,2,0
"Sinarundinaria","Poaceae","Poales",0,0,0,2,0,NA
"Sinclairia","Asteraceae","Asterales",3,1,0,28,3,1
"Sindechites","Apocynaceae","Gentianales",0,2,0,2,0,NA
"Sindora","Fabaceae","Fabales",17,0,0,19,17,1
"Sindoropsis","Fabaceae","Fabales",1,0,0,1,1,1
"Singana","Fabaceae","Fabales",0,0,0,1,0,NA
"Singchia","Orchidaceae","Asparagales",0,0,0,1,0,NA
"Sinningia","Gesneriaceae","Lamiales",0,0,4,70,4,0
"Sinoadina","Rubiaceae","Gentianales",1,0,0,1,1,1
"Sinoarundinaria","Poaceae","Poales",0,0,0,1,0,NA
"Sinobaijiania","Cucurbitaceae","Cucurbitales",0,0,0,2,0,NA
"Sinobambusa","Poaceae","Poales",0,0,0,15,0,NA
"Sinocalamus","Poaceae","Poales",0,0,0,6,0,NA
"Sinocarum","Apiaceae","Apiales",0,0,0,9,0,NA
"Sinochasea","Poaceae","Poales",0,0,0,1,0,NA
"Sinocrassula","Crassulaceae","Saxifragales",0,0,0,7,0,NA
"Sinodolichos","Fabaceae","Fabales",0,0,0,2,0,NA
"Sinofranchetia","Lardizabalaceae","Ranunculales",0,0,0,1,0,NA
"Sinojackia","Styracaceae","Ericales",2,0,0,7,2,1
"Sinojohnstonia","Boraginaceae","UnknownOrder-Boraginaceae",0,0,0,3,0,NA
"Sinolimprichtia","Apiaceae","Apiales",0,0,0,1,0,NA
"Sinomarsdenia","Apocynaceae","Gentianales",0,0,0,1,0,NA
"Sinomenium","Menispermaceae","Ranunculales",0,0,0,1,0,NA
"Sinopanax","Araliaceae","Apiales",0,0,0,1,0,NA
"Sinopodophyllum","Berberidaceae","Ranunculales",0,0,1,1,1,0
"Sinopora","Lauraceae","Laurales",0,0,0,1,0,NA
"Sinosassafras","Lauraceae","Laurales",0,0,0,1,0,NA
"Sinosenecio","Asteraceae","Asterales",0,0,2,45,2,0
"Sinosophiopsis","Brassicaceae","Brassicales",0,0,0,2,0,NA
"Sinowilsonia","Hamamelidaceae","Saxifragales",1,0,0,1,1,1
"Siolmatra","Cucurbitaceae","Cucurbitales",1,0,0,2,1,1
"Sipanea","Rubiaceae","Gentianales",0,0,1,19,1,0
"Sipaneopsis","Rubiaceae","Gentianales",0,0,0,7,0,NA
"Sipapoantha","Gentianaceae","Gentianales",0,0,0,1,0,NA
"Siparuna","Siparunaceae","Laurales",17,0,0,60,17,1
"Siphanthera","Melastomataceae","Myrtales",0,0,1,14,1,0
"Siphocampylus","Campanulaceae","Asterales",2,3,0,235,2,1
"Siphocodon","Campanulaceae","Asterales",1,0,0,2,1,1
"Siphocranion","Lamiaceae","Lamiales",0,0,0,2,0,NA
"Siphonandra","Ericaceae","Ericales",1,0,0,3,1,1
"Siphonandrium","Rubiaceae","Gentianales",0,0,0,1,0,NA
"Siphonella","Caprifoliaceae","Dipsacales",0,0,0,1,0,NA
"Siphonema","Solanaceae","Solanales",0,0,0,1,0,NA
"Siphoneugena","Myrtaceae","Myrtales",2,0,0,11,2,1
"Siphonochilus","Zingiberaceae","Zingiberales",0,0,1,11,1,0
"Siphonodon","Celastraceae","Celastrales",0,0,0,1,0,NA
"Siphonoglossa","Acanthaceae","Lamiales",0,0,0,11,0,NA
"Siphonostegia","Orobanchaceae","Lamiales",0,0,2,3,2,0
"Siphonostylis","Iridaceae","Asparagales",0,0,0,1,0,NA
"Sipolisia","Asteraceae","Asterales",0,0,0,1,0,NA
"Siraitia","Cucurbitaceae","Cucurbitales",0,1,0,3,0,NA
"Sirhookera","Orchidaceae","Asparagales",0,0,0,2,0,NA
"Sirindhornia","Orchidaceae","Asparagales",0,0,0,3,0,NA
"Sirochloa","Poaceae","Poales",0,0,0,1,0,NA
"Sison","Apiaceae","Apiales",0,0,0,1,0,NA
"Sisymbrella","Brassicaceae","Brassicales",0,0,0,2,0,NA
"Sisymbriopsis","Brassicaceae","Brassicales",0,0,2,5,2,0
"Sisymbrium","Brassicaceae","Brassicales",0,0,7,51,7,0
"Sisyndite","Zygophyllaceae","Zygophyllales",1,0,0,1,1,1
"Sisyranthus","Apocynaceae","Gentianales",0,0,0,14,0,NA
"Sisyrinchium","Iridaceae","Asparagales",0,0,96,201,96,0
"Sium","Apiaceae","Apiales",0,0,2,9,2,0
"Sixalix","Caprifoliaceae","Dipsacales",0,0,0,1,0,NA
"Skeptrostachys","Orchidaceae","Asparagales",0,0,0,13,0,NA
"Skiatophytum","Aizoaceae","Caryophyllales",0,0,0,1,0,NA
"Skimmia","Rutaceae","Sapindales",1,0,0,6,1,1
"Skoliopteris","Malpighiaceae","Malpighiales",0,0,0,1,0,NA
"Skottsbergiliana","Cucurbitaceae","Cucurbitales",0,0,0,1,0,NA
"Skytanthus","Apocynaceae","Gentianales",1,0,0,3,1,1
"Sladenia","Sladeniaceae","Ericales",1,0,0,2,1,1
"Sleumerodendron","Proteaceae","Proteales",0,0,0,1,0,NA
"Sloanea","Elaeocarpaceae","Oxalidales",38,0,0,113,38,1
"Sloetiopsis","Moraceae","Rosales",0,0,0,1,0,NA
"Smallanthus","Asteraceae","Asterales",1,0,0,20,1,1
"Smeathmannia","Passifloraceae","Malpighiales",0,0,0,2,0,NA
"Smelophyllum","Sapindaceae","Sapindales",1,0,0,1,1,1
"Smelowskia","Brassicaceae","Brassicales",0,0,3,25,3,0
"Smicrostigma","Aizoaceae","Caryophyllales",0,0,0,1,0,NA
"Smilax","Smilacaceae","Liliales",25,0,5,248,30,0.833333333333333
"Smirnowia","Fabaceae","Fabales",0,0,0,1,0,NA
"Smithatris","Zingiberaceae","Zingiberales",0,0,0,2,0,NA
"Smithia","Fabaceae","Fabales",0,0,0,22,0,NA
"Smithiantha","Gesneriaceae","Lamiales",0,0,0,8,0,NA
"Smithicodonia","Gesneriaceae","Lamiales",0,0,0,1,0,NA
"Smithorchis","Orchidaceae","Asparagales",0,0,0,1,0,NA
"Smithsonia","Orchidaceae","Asparagales",0,0,0,3,0,NA
"Smitinandia","Orchidaceae","Asparagales",0,0,2,3,2,0
"Smodingium","Anacardiaceae","Sapindales",1,0,0,1,1,1
"Smyrniopsis","Apiaceae","Apiales",0,0,0,1,0,NA
"Smyrnium","Apiaceae","Apiales",0,0,0,5,0,NA
"Snowdenia","Poaceae","Poales",0,0,0,4,0,NA
"Soaresia","Asteraceae","Asterales",0,0,0,1,0,NA
"Sobennikoffia","Orchidaceae","Asparagales",0,0,1,4,1,0
"Sobolewskia","Brassicaceae","Brassicales",0,0,0,4,0,NA
"Sobralia","Orchidaceae","Asparagales",1,0,0,150,1,1
"Sobreyra","Asteraceae","Asterales",0,0,0,2,0,NA
"Socotria","Lythraceae","Myrtales",0,0,0,1,0,NA
"Socratea","Arecaceae","Arecales",5,0,0,5,5,1
"Socratina","Loranthaceae","Santalales",0,0,0,2,0,NA
"Soderstromia","Poaceae","Poales",0,0,0,1,0,NA
"Soemmeringia","Fabaceae","Fabales",0,0,0,1,0,NA
"Sogerianthe","Loranthaceae","Santalales",0,0,0,1,0,NA
"Sohnreyia","Rutaceae","Sapindales",0,0,0,1,0,NA
"Sohnsia","Poaceae","Poales",0,0,0,1,0,NA
"Solandra","Solanaceae","Solanales",0,0,1,10,1,0
"Solanecio","Asteraceae","Asterales",1,0,0,16,1,1
"Solanopteris","Polypodiaceae","Polypodiales",0,0,0,4,0,NA
"Solanum","Solanaceae","Solanales",76,11,37,1199,113,0.672566371681416
"Solaria","Amaryllidaceae","Asparagales",0,0,2,6,2,0
"Soldanella","Primulaceae","Ericales",0,0,5,10,5,0
"Soleirolia","Urticaceae","Rosales",0,0,0,1,0,NA
"Solena","Cucurbitaceae","Cucurbitales",0,0,1,2,1,0
"Solenangis","Orchidaceae","Asparagales",0,0,3,8,3,0
"Solenanthus","Boraginaceae","UnknownOrder-Boraginaceae",0,0,0,8,0,NA
"Solenidium","Orchidaceae","Asparagales",0,0,0,3,0,NA
"Solenocentrum","Orchidaceae","Asparagales",0,0,0,4,0,NA
"Solenogyne","Asteraceae","Asterales",0,0,1,3,1,0
"Solenomelus","Iridaceae","Asparagales",0,0,2,2,2,0
"Solenophora","Gesneriaceae","Lamiales",0,0,0,14,0,NA
"Solenopsis","Campanulaceae","Asterales",0,0,1,7,1,0
"Solenostemma","Apocynaceae","Gentianales",0,0,0,1,0,NA
"Solenostemon","Lamiaceae","Lamiales",0,0,0,1,0,NA
"Solenotheca","Asteraceae","Asterales",0,0,0,1,0,NA
"Solfia","Arecaceae","Arecales",0,0,0,1,0,NA
"Solidago","Asteraceae","Asterales",0,0,13,117,13,0
"Solidaster","Asteraceae","Asterales",0,0,0,2,0,NA
"Solisia","Cactaceae","Caryophyllales",0,0,0,1,0,NA
"Soliva","Asteraceae","Asterales",0,0,1,7,1,0
"Solms-laubachia","Brassicaceae","Brassicales",0,0,0,24,0,NA
"Solmsia","Thymelaeaceae","Malvales",0,0,0,2,0,NA
"Solulus","Fabaceae","Fabales",0,0,0,3,0,NA
"Sommera","Rubiaceae","Gentianales",1,0,0,10,1,1
"Sommerfeltia","Asteraceae","Asterales",0,0,0,2,0,NA
"Sommieria","Arecaceae","Arecales",0,0,0,1,0,NA
"Sonchella","Asteraceae","Asterales",0,0,0,2,0,NA
"Sonchus","Asteraceae","Asterales",4,1,38,131,42,0.0952380952380952
"Sonderina","Apiaceae","Apiales",0,0,0,3,0,NA
"Sonderothamnus","Penaeaceae","Myrtales",2,0,0,2,2,1
"Sondottia","Asteraceae","Asterales",0,0,1,2,1,0
"Sonerila","Melastomataceae","Myrtales",0,0,0,6,0,NA
"Sonneratia","Lythraceae","Myrtales",4,0,0,6,4,1
"Sophia","Brassicaceae","Brassicales",0,0,0,1,0,NA
"Sophora","Fabaceae","Fabales",17,0,0,61,17,1
"Sophronanthe","Plantaginaceae","Lamiales",0,0,0,1,0,NA
"Sophronitis","Orchidaceae","Asparagales",0,0,0,2,0,NA
"Sopubia","Orobanchaceae","Lamiales",0,0,0,23,0,NA
"Soranthus","Apiaceae","Apiales",0,0,0,1,0,NA
"Sorbaria","Rosaceae","Rosales",2,0,0,5,2,1
"Sorbaronia","Rosaceae","Rosales",0,0,0,6,0,NA
"Sorbocotoneaster","Rosaceae","Rosales",0,0,0,1,0,NA
"Sorbopyrus","Rosaceae","Rosales",0,0,0,1,0,NA
"Sorbus","Rosaceae","Rosales",34,0,0,244,34,1
"Sorghastrum","Poaceae","Poales",0,0,3,20,3,0
"Sorghum","Poaceae","Poales",0,0,23,31,23,0
"Soridium","Triuridaceae","Pandanales",0,0,0,1,0,NA
"Sorindeia","Anacardiaceae","Sapindales",4,0,0,35,4,1
"Sorocea","Moraceae","Rosales",7,0,0,17,7,1
"Sorocephalus","Proteaceae","Proteales",2,0,0,11,2,1
"Sorolepidium","Dryopteridaceae","Polypodiales",0,0,0,2,0,NA
"Soroseris","Asteraceae","Asterales",0,0,0,7,0,NA
"Soroveta","Restionaceae","Poales",0,0,0,1,0,NA
"Soterosanthus","Orchidaceae","Asparagales",0,0,1,1,1,0
"Sotoa","Orchidaceae","Asparagales",0,0,0,1,0,NA
"Souroubea","Marcgraviaceae","Ericales",6,0,0,21,6,1
"Sowerbaea","Asparagaceae","Asparagales",0,0,3,5,3,0
"Soyauxia","Peridiscaceae","Saxifragales",2,0,0,5,2,1
"Soyeria","Asteraceae","Asterales",0,0,0,1,0,NA
"Soymida","Meliaceae","Sapindales",1,0,0,1,1,1
"Spachea","Malpighiaceae","Malpighiales",3,0,0,4,3,1
"Spadonia","Asteraceae","Asterales",0,0,0,1,0,NA
"Spananthe","Apiaceae","Apiales",0,0,1,1,1,0
"Spaniopappus","Asteraceae","Asterales",0,0,0,5,0,NA
"Sparattanthelium","Hernandiaceae","Laurales",5,0,0,14,5,1
"Sparattosperma","Bignoniaceae","Lamiales",1,0,0,2,1,1
"Sparaxis","Iridaceae","Asparagales",0,0,12,15,12,0
"Sparganium","Typhaceae","Poales",0,0,11,27,11,0
"Sparmannia","Malvaceae","Malvales",1,0,0,1,1,1
"Sparrmannia","Malvaceae","Malvales",0,0,0,2,0,NA
"Spartidium","Fabaceae","Fabales",0,0,0,1,0,NA
"Spartina","Poaceae","Poales",0,0,4,18,4,0
"Spartium","Fabaceae","Fabales",1,0,0,1,1,1
"Spartochloa","Poaceae","Poales",0,0,1,1,1,0
"Spartocytisus","Fabaceae","Fabales",1,0,0,1,1,1
"Spartothamnella","Lamiaceae","Lamiales",1,0,0,3,1,1
"Spatalla","Proteaceae","Proteales",3,0,0,20,3,1
"Spathacanthus","Acanthaceae","Lamiales",0,0,0,3,0,NA
"Spathandra","Melastomataceae","Myrtales",0,0,0,1,0,NA
"Spathantheum","Araceae","Alismatales",0,0,1,2,1,0
"Spathanthus","Rapateaceae","Poales",0,0,2,2,2,0
"Spathelia","Rutaceae","Sapindales",1,0,0,3,1,1
"Spathepteris","Anemiaceae","Schizaeales",0,0,0,1,0,NA
"Spathia","Poaceae","Poales",0,0,0,1,0,NA
"Spathicarpa","Araceae","Alismatales",0,0,3,3,3,0
"Spathichlamys","Rubiaceae","Gentianales",0,0,0,1,0,NA
"Spathionema","Fabaceae","Fabales",0,0,0,1,0,NA
"Spathiostemon","Euphorbiaceae","Malpighiales",1,0,0,2,1,1
"Spathiphyllum","Araceae","Alismatales",0,0,3,52,3,0
"Spathodea","Bignoniaceae","Lamiales",1,0,0,1,1,1
"Spathoglottis","Orchidaceae","Asparagales",0,0,2,49,2,0
"Spatholirion","Commelinaceae","Commelinales",0,0,1,6,1,0
"Spatholobus","Fabaceae","Fabales",4,0,0,34,4,1
"Spatularia","Saxifragaceae","Saxifragales",0,0,0,2,0,NA
"Specklinia","Orchidaceae","Asparagales",0,0,0,135,0,NA
"Specularia","Campanulaceae","Asterales",0,0,0,1,0,NA
"Speea","Amaryllidaceae","Asparagales",0,0,0,2,0,NA
"Spegazziniophytum","Euphorbiaceae","Malpighiales",0,0,0,1,0,NA
"Speirantha","Asparagaceae","Asparagales",0,0,1,1,1,0
"Spenceria","Rosaceae","Rosales",0,0,0,1,0,NA
"Speranskia","Euphorbiaceae","Malpighiales",1,0,0,3,1,1
"Spergula","Caryophyllaceae","Caryophyllales",0,0,2,13,2,0
"Spergularia","Caryophyllaceae","Caryophyllales",0,0,2,50,2,0
"Spermacoce","Rubiaceae","Gentianales",0,1,21,284,21,0
"Spermadictyon","Rubiaceae","Gentianales",1,0,0,1,1,1
"Spermolepis","Apiaceae","Apiales",1,0,0,6,1,1
"Spetaea","Asparagaceae","Asparagales",0,0,1,1,1,0
"Sphacanthus","Acanthaceae","Lamiales",0,0,0,2,0,NA
"Sphaenolobium","Apiaceae","Apiales",0,0,0,3,0,NA
"Sphaeradenia","Cyclanthaceae","Pandanales",0,0,0,53,0,NA
"Sphaeralcea","Malvaceae","Malvales",1,1,1,53,2,0.5
"Sphaeranthus","Asteraceae","Asterales",0,0,1,34,1,0
"Sphaerantia","Myrtaceae","Myrtales",1,0,0,2,1,1
"Sphaereupatorium","Asteraceae","Asterales",0,0,0,1,0,NA
"Sphaerobambos","Poaceae","Poales",0,0,0,3,0,NA
"Sphaerocardamum","Brassicaceae","Brassicales",0,0,0,6,0,NA
"Sphaerocaryum","Poaceae","Poales",0,0,1,1,1,0
"Sphaerocionium","Hymenophyllaceae","Hymenophyllales",0,0,0,10,0,NA
"Sphaerocodon","Apocynaceae","Gentianales",0,0,0,4,0,NA
"Sphaerocoma","Caryophyllaceae","Caryophyllales",0,0,0,1,0,NA
"Sphaerocoryne","Annonaceae","Magnoliales",0,0,0,2,0,NA
"Sphaerocyperus","Cyperaceae","Poales",0,0,1,1,1,0
"Sphaerolobium","Fabaceae","Fabales",0,0,0,18,0,NA
"Sphaeromeria","Asteraceae","Asterales",0,0,0,9,0,NA
"Sphaeromorphaea","Asteraceae","Asterales",0,0,0,1,0,NA
"Sphaerophysa","Fabaceae","Fabales",1,0,0,4,1,1
"Sphaeropteris","Cyatheaceae","Cyatheales",1,0,0,13,1,1
"Sphaerorrhiza","Gesneriaceae","Lamiales",0,0,0,2,0,NA
"Sphaerosciadium","Apiaceae","Apiales",0,0,0,1,0,NA
"Sphaerostephanos","Thelypteridaceae","Polypodiales",0,0,0,4,0,NA
"Sphaerostigma","Onagraceae","Myrtales",0,0,0,6,0,NA
"Sphaerostylis","Euphorbiaceae","Malpighiales",0,0,0,2,0,NA
"Sphaerothylax","Podostemaceae","Malpighiales",0,0,0,2,0,NA
"Sphagneticola","Asteraceae","Asterales",0,0,1,5,1,0
"Sphallerocarpus","Apiaceae","Apiales",0,0,0,1,0,NA
"Sphalmanthus","Aizoaceae","Caryophyllales",0,0,0,105,0,NA
"Sphalmium","Proteaceae","Proteales",1,0,0,1,1,1
"Sphedamnocarpus","Malpighiaceae","Malpighiales",3,0,0,10,3,1
"Spheneria","Poaceae","Poales",0,0,0,1,0,NA
"Sphenocentrum","Menispermaceae","Ranunculales",1,0,0,1,1,1
"Sphenoclea","Sphenocleaceae","Solanales",0,0,1,2,1,0
"Sphenodesme","Lamiaceae","Lamiales",0,0,0,15,0,NA
"Sphenomeris","Lindsaeaceae","Polypodiales",0,0,0,8,0,NA
"Sphenopholis","Poaceae","Poales",0,0,4,7,4,0
"Sphenopus","Poaceae","Poales",0,0,0,2,0,NA
"Sphenosciadium","Apiaceae","Apiales",0,0,0,1,0,NA
"Sphenostemon","Paracryphiaceae","Paracryphiales",1,0,0,1,1,1
"Sphenostigma","Iridaceae","Asparagales",0,0,0,1,0,NA
"Sphenostylis","Fabaceae","Fabales",0,0,0,8,0,NA
"Sphinctanthus","Rubiaceae","Gentianales",0,0,0,8,0,NA
"Sphinctospermum","Fabaceae","Fabales",0,0,1,1,1,0
"Sphinga","Fabaceae","Fabales",0,0,0,3,0,NA
"Sphingiphila","Bignoniaceae","Lamiales",0,0,0,1,0,NA
"Sphyranthera","Euphorbiaceae","Malpighiales",0,0,0,2,0,NA
"Sphyrarhynchus","Orchidaceae","Asparagales",0,0,1,1,1,0
"Sphyrospermum","Ericaceae","Ericales",3,0,0,24,3,1
"Spicanta","Blechnaceae","Polypodiales",0,0,0,1,0,NA
"Spiculaea","Orchidaceae","Asparagales",0,0,0,1,0,NA
"Spiesia","Fabaceae","Fabales",0,0,0,162,0,NA
"Spigelia","Loganiaceae","Gentianales",0,0,3,89,3,0
"Spilanthes","Asteraceae","Asterales",0,0,1,34,1,0
"Spiloxene","Hypoxidaceae","Asparagales",0,0,2,19,2,0
"Spinacia","Amaranthaceae","Caryophyllales",0,0,1,2,1,0
"Spinifex","Poaceae","Poales",0,0,2,5,2,0
"Spinulum","Lycopodiaceae","Lycopodiales",0,0,3,3,3,0
"Spiracantha","Asteraceae","Asterales",0,0,0,1,0,NA
"Spiradiclis","Rubiaceae","Gentianales",0,0,0,38,0,NA
"Spiraea","Rosaceae","Rosales",20,0,0,138,20,1
"Spiraeanthus","Rosaceae","Rosales",0,0,0,1,0,NA
"Spiranthera","Rutaceae","Sapindales",0,0,0,3,0,NA
"Spiranthes","Orchidaceae","Asparagales",0,0,3,39,3,0
"Spirodela","Araceae","Alismatales",0,0,2,4,2,0
"Spirolobium","Apocynaceae","Gentianales",1,0,0,1,1,1
"Spiropetalum","Connaraceae","Oxalidales",0,0,0,2,0,NA
"Spirorhynchus","Brassicaceae","Brassicales",0,0,0,1,0,NA
"Spiroseris","Asteraceae","Asterales",0,0,0,1,0,NA
"Spirospermum","Menispermaceae","Ranunculales",0,0,0,1,0,NA
"Spirostachys","Euphorbiaceae","Malpighiales",1,0,0,2,1,1
"Spirostegia","Plantaginaceae","Lamiales",0,0,0,1,0,NA
"Spirostylis","Loranthaceae","Santalales",0,0,0,1,0,NA
"Spirotecoma","Bignoniaceae","Lamiales",0,0,0,4,0,NA
"Spirotheca","Malvaceae","Malvales",0,0,0,5,0,NA
"Spirotropis","Fabaceae","Fabales",0,0,0,2,0,NA
"Spodiopogon","Poaceae","Poales",0,0,3,15,3,0
"Spondianthus","Phyllanthaceae","Malpighiales",1,0,0,1,1,1
"Spondias","Anacardiaceae","Sapindales",8,0,0,12,8,1
"Spongiocarpella","Fabaceae","Fabales",0,0,0,4,0,NA
"Spongiola","Orchidaceae","Asparagales",0,0,0,1,0,NA
"Spongiosperma","Apocynaceae","Gentianales",0,0,0,6,0,NA
"Spongostemma","Caprifoliaceae","Dipsacales",0,0,0,1,0,NA
"Sporadanthus","Restionaceae","Poales",0,0,7,7,7,0
"Sporobolus","Poaceae","Poales",0,0,20,184,20,0
"Sporoxeia","Melastomataceae","Myrtales",0,0,0,3,0,NA
"Spraguea","Portulacaceae","Caryophyllales",0,0,0,1,0,NA
"Spragueanella","Loranthaceae","Santalales",0,0,0,2,0,NA
"Sprekelia","Amaryllidaceae","Asparagales",0,0,1,2,1,0
"Spryginia","Brassicaceae","Brassicales",0,0,0,7,0,NA
"Spyridium","Rhamnaceae","Rosales",2,0,0,6,2,1
"Squamellaria","Rubiaceae","Gentianales",0,0,0,4,0,NA
"Squamopappus","Asteraceae","Asterales",1,0,0,1,1,1
"Staavia","Bruniaceae","Bruniales",8,0,0,12,8,1
"Staberoha","Restionaceae","Poales",0,0,6,9,6,0
"Stachyandra","Picrodendraceae","Malpighiales",0,0,0,4,0,NA
"Stachyanthus","Icacinaceae","UnknownOrder-Icacinaceae",2,0,0,4,2,1
"Stachyarrhena","Rubiaceae","Gentianales",1,0,0,13,1,1
"Stachycephalum","Asteraceae","Asterales",0,0,0,2,0,NA
"Stachydeoma","Lamiaceae","Lamiales",0,0,0,1,0,NA
"Stachyococcus","Rubiaceae","Gentianales",0,0,0,1,0,NA
"Stachyopsis","Lamiaceae","Lamiales",0,0,1,4,1,0
"Stachyothyrsus","Fabaceae","Fabales",1,0,0,3,1,1
"Stachyphrynium","Marantaceae","Zingiberales",0,0,4,9,4,0
"Stachys","Lamiaceae","Lamiales",2,0,41,375,43,0.0465116279069767
"Stachystemon","Picrodendraceae","Malpighiales",1,0,0,9,1,1
"Stachytarpheta","Verbenaceae","Lamiales",0,0,3,130,3,0
"Stachyurus","Stachyuraceae","Crossosomatales",3,0,0,7,3,1
"Stadiochilus","Zingiberaceae","Zingiberales",0,0,0,1,0,NA
"Stadmania","Sapindaceae","Sapindales",0,0,0,6,0,NA
"Staehelina","Asteraceae","Asterales",0,0,0,3,0,NA
"Staelia","Rubiaceae","Gentianales",0,0,0,16,0,NA
"Stahlia","Fabaceae","Fabales",0,0,0,1,0,NA
"Stahlianthus","Zingiberaceae","Zingiberales",0,0,0,7,0,NA
"Stalkya","Orchidaceae","Asparagales",0,0,0,1,0,NA
"Standleya","Rubiaceae","Gentianales",0,0,0,4,0,NA
"Standleyanthus","Asteraceae","Asterales",0,0,0,1,0,NA
"Stanfieldiella","Commelinaceae","Commelinales",0,0,1,4,1,0
"Stangea","Caprifoliaceae","Dipsacales",0,0,0,5,0,NA
"Stangeria","Zamiaceae","Cycadales",1,0,0,1,1,1
"Stanhopea","Orchidaceae","Asparagales",0,0,10,68,10,0
"Stanleya","Brassicaceae","Brassicales",1,0,0,7,1,1
"Stanleyella","Brassicaceae","Brassicales",0,0,0,1,0,NA
"Stanmarkia","Melastomataceae","Myrtales",0,0,0,2,0,NA
"Stapelia","Apocynaceae","Gentianales",0,0,1,56,1,0
"Stapelianthus","Apocynaceae","Gentianales",0,0,0,6,0,NA
"Stapeliopsis","Apocynaceae","Gentianales",0,0,0,6,0,NA
"Stapfiella","Passifloraceae","Malpighiales",0,0,0,4,0,NA
"Staphidiastrum","Melastomataceae","Myrtales",0,0,0,1,0,NA
"Staphidium","Melastomataceae","Myrtales",0,0,0,1,0,NA
"Staphylea","Staphyleaceae","Crossosomatales",4,0,0,11,4,1
"Stathmostelma","Apocynaceae","Gentianales",0,0,0,11,0,NA
"Staudtia","Myristicaceae","Magnoliales",1,0,0,1,1,1
"Stauntonia","Lardizabalaceae","Ranunculales",0,3,0,20,0,NA
"Stauracanthus","Fabaceae","Fabales",0,0,0,1,0,NA
"Stauranthera","Gesneriaceae","Lamiales",0,0,0,3,0,NA
"Stauranthus","Rutaceae","Sapindales",0,0,0,1,0,NA
"Staurochilus","Orchidaceae","Asparagales",0,0,1,14,1,0
"Staurochlamys","Asteraceae","Asterales",0,0,0,1,0,NA
"Staurogyne","Acanthaceae","Lamiales",0,0,0,50,0,NA
"Staurogynopsis","Acanthaceae","Lamiales",0,0,0,1,0,NA
"Stauropsis","Orchidaceae","Asparagales",0,0,0,1,0,NA
"Stawellia","Xanthorrhoeaceae","Asparagales",0,0,1,2,1,0
"Stayneria","Aizoaceae","Caryophyllales",0,0,0,1,0,NA
"Steenisia","Rubiaceae","Gentianales",0,0,0,5,0,NA
"Steenisioblechnum","Blechnaceae","Polypodiales",0,0,0,1,0,NA
"Stefanoffia","Apiaceae","Apiales",0,0,0,1,0,NA
"Steganotaenia","Apiaceae","Apiales",1,0,0,3,1,1
"Stegnogramma","Thelypteridaceae","Polypodiales",0,0,0,9,0,NA
"Stegnosperma","Stegnospermataceae","Caryophyllales",2,0,0,5,2,1
"Stegolepis","Rapateaceae","Poales",4,0,0,33,4,1
"Steinbachiella","Fabaceae","Fabales",0,0,0,1,0,NA
"Steinchisma","Poaceae","Poales",0,0,2,7,2,0
"Steirachne","Poaceae","Poales",0,0,0,2,0,NA
"Steiractinia","Asteraceae","Asterales",1,0,0,15,1,1
"Steiranisia","Saxifragaceae","Saxifragales",0,0,0,1,0,NA
"Steirodiscus","Asteraceae","Asterales",0,0,0,6,0,NA
"Steironema","Primulaceae","Ericales",0,0,1,5,1,0
"Steiropteris","Thelypteridaceae","Polypodiales",0,0,0,7,0,NA
"Stelechocarpus","Annonaceae","Magnoliales",2,0,0,2,2,1
"Stelestylis","Cyclanthaceae","Pandanales",0,0,0,4,0,NA
"Stelis","Orchidaceae","Asparagales",0,0,6,887,6,0
"Stellaria","Caryophyllaceae","Caryophyllales",0,0,9,121,9,0
"Stellera","Thymelaeaceae","Malvales",0,0,1,1,1,0
"Stelligera","Amaranthaceae","Caryophyllales",0,0,0,1,0,NA
"Stemmacantha","Asteraceae","Asterales",0,0,0,11,0,NA
"Stemmatella","Asteraceae","Asterales",0,0,0,2,0,NA
"Stemmodontia","Asteraceae","Asterales",0,0,0,1,0,NA
"Stemodia","Plantaginaceae","Lamiales",0,0,1,36,1,0
"Stemodiopsis","Scrophulariaceae","Lamiales",0,0,0,5,0,NA
"Stemona","Stemonaceae","Pandanales",0,0,3,24,3,0
"Stemonocoleus","Fabaceae","Fabales",1,0,0,1,1,1
"Stemonurus","Stemonuraceae","Aquifoliales",5,0,0,13,5,1
"Stemotria","Calceolariaceae","Lamiales",0,0,0,1,0,NA
"Stenachaenium","Asteraceae","Asterales",0,0,1,6,1,0
"Stenactis","Asteraceae","Asterales",0,0,0,2,0,NA
"Stenandriopsis","Acanthaceae","Lamiales",0,0,0,1,0,NA
"Stenandrium","Acanthaceae","Lamiales",0,0,1,49,1,0
"Stenanona","Annonaceae","Magnoliales",2,0,0,14,2,1
"Stenanthium","Melanthiaceae","Liliales",0,0,2,3,2,0
"Stenaria","Rubiaceae","Gentianales",0,0,0,6,0,NA
"Stenia","Orchidaceae","Asparagales",0,0,6,22,6,0
"Stenocactus","Cactaceae","Caryophyllales",0,0,0,18,0,NA
"Stenocarpha","Asteraceae","Asterales",0,0,0,2,0,NA
"Stenocarpus","Proteaceae","Proteales",2,0,0,3,2,1
"Stenocephalum","Asteraceae","Asterales",0,0,0,6,0,NA
"Stenocereus","Cactaceae","Caryophyllales",0,0,0,24,0,NA
"Stenochlaena","Blechnaceae","Polypodiales",0,0,0,7,0,NA
"Stenocline","Asteraceae","Asterales",0,0,0,2,0,NA
"Stenocoelium","Apiaceae","Apiales",0,0,0,3,0,NA
"Stenocoryne","Orchidaceae","Asparagales",0,0,0,1,0,NA
"Stenodon","Melastomataceae","Myrtales",0,0,0,2,0,NA
"Stenodrepanum","Fabaceae","Fabales",0,0,0,1,0,NA
"Stenofilix","Polypodiaceae","Polypodiales",0,0,0,1,0,NA
"Stenoglottis","Orchidaceae","Asparagales",0,0,2,7,2,0
"Stenogonum","Polygonaceae","Caryophyllales",0,0,0,2,0,NA
"Stenogrammitis","Polypodiaceae","Polypodiales",0,0,0,24,0,NA
"Stenogyne","Lamiaceae","Lamiales",1,0,2,28,3,0.333333333333333
"Stenolepia","Dryopteridaceae","Polypodiales",0,0,0,1,0,NA
"Stenolobus","Davalliaceae","Polypodiales",0,0,0,1,0,NA
"Stenoloma","Lindsaeaceae","Polypodiales",0,0,0,1,0,NA
"Stenomeria","Apocynaceae","Gentianales",0,0,0,3,0,NA
"Stenomeris","Dioscoreaceae","Dioscoreales",0,0,1,2,1,0
"Stenomesson","Amaryllidaceae","Asparagales",0,0,1,17,1,0
"Stenopadus","Asteraceae","Asterales",0,0,0,16,0,NA
"Stenopetalum","Brassicaceae","Brassicales",0,0,2,10,2,0
"Stenophalium","Asteraceae","Asterales",0,0,0,4,0,NA
"Stenophyllus","Cyperaceae","Poales",0,0,0,1,0,NA
"Stenops","Asteraceae","Asterales",0,0,0,2,0,NA
"Stenoptera","Orchidaceae","Asparagales",0,0,0,7,0,NA
"Stenorrhynchos","Orchidaceae","Asparagales",0,0,1,7,1,0
"Stenosemia","Tectariaceae","Polypodiales",0,0,0,2,0,NA
"Stenosemis","Apiaceae","Apiales",0,0,0,2,0,NA
"Stenosepala","Rubiaceae","Gentianales",0,0,0,1,0,NA
"Stenoseris","Asteraceae","Asterales",0,0,0,5,0,NA
"Stenosiphon","Onagraceae","Myrtales",0,0,0,1,0,NA
"Stenosolenium","Boraginaceae","UnknownOrder-Boraginaceae",0,0,0,1,0,NA
"Stenospermation","Araceae","Alismatales",0,0,0,54,0,NA
"Stenostegia","Myrtaceae","Myrtales",0,0,0,1,0,NA
"Stenostelma","Apocynaceae","Gentianales",0,0,0,3,0,NA
"Stenostephanus","Acanthaceae","Lamiales",0,0,0,40,0,NA
"Stenostomum","Rubiaceae","Gentianales",3,0,0,49,3,1
"Stenotaenia","Apiaceae","Apiales",0,0,0,1,0,NA
"Stenotalis","Restionaceae","Poales",0,0,0,1,0,NA
"Stenotaphrum","Poaceae","Poales",0,0,2,8,2,0
"Stenotis","Rubiaceae","Gentianales",0,0,0,9,0,NA
"Stenotus","Asteraceae","Asterales",0,0,0,4,0,NA
"Stenotyla","Orchidaceae","Asparagales",0,0,3,9,3,0
"Stephanachne","Poaceae","Poales",0,0,0,2,0,NA
"Stephanandra","Rosaceae","Rosales",3,0,0,4,3,1
"Stephanbeckia","Asteraceae","Asterales",0,0,0,1,0,NA
"Stephania","Menispermaceae","Ranunculales",0,0,3,43,3,0
"Stephanocereus","Cactaceae","Caryophyllales",0,0,0,2,0,NA
"Stephanochilus","Asteraceae","Asterales",0,0,0,1,0,NA
"Stephanococcus","Rubiaceae","Gentianales",0,0,0,1,0,NA
"Stephanodaphne","Thymelaeaceae","Malvales",1,0,0,9,1,1
"Stephanodoria","Asteraceae","Asterales",0,0,0,1,0,NA
"Stephanomeria","Asteraceae","Asterales",0,0,1,18,1,0
"Stephanopholis","Asteraceae","Asterales",0,0,0,1,0,NA
"Stephanopodium","Dichapetalaceae","Malpighiales",6,0,0,14,6,1
"Stephanostegia","Apocynaceae","Gentianales",1,0,0,2,1,1
"Stephanostema","Apocynaceae","Gentianales",1,0,0,1,1,1
"Stephanothelys","Orchidaceae","Asparagales",0,0,0,5,0,NA
"Stephanotis","Apocynaceae","Gentianales",0,0,0,6,0,NA
"Steptorhamphus","Asteraceae","Asterales",0,0,0,1,0,NA
"Sterculia","Malvaceae","Malvales",27,0,0,91,27,1
"Stereocaryum","Myrtaceae","Myrtales",0,0,0,3,0,NA
"Stereochilus","Orchidaceae","Asparagales",0,0,0,7,0,NA
"Stereochlaena","Poaceae","Poales",0,0,0,4,0,NA
"Stereosandra","Orchidaceae","Asparagales",0,0,0,1,0,NA
"Stereospermum","Bignoniaceae","Lamiales",13,0,0,23,13,1
"Sterigmapetalum","Rhizophoraceae","Malpighiales",2,0,0,8,2,1
"Sterigmostemum","Brassicaceae","Brassicales",0,0,1,6,1,0
"Steriphoma","Capparaceae","Brassicales",0,0,0,6,0,NA
"Sternbergia","Amaryllidaceae","Asparagales",0,0,3,8,3,0
"Stetsonia","Cactaceae","Caryophyllales",0,0,0,1,0,NA
"Steudnera","Araceae","Alismatales",0,0,0,9,0,NA
"Stevenia","Brassicaceae","Brassicales",0,0,0,5,0,NA
"Steveniella","Orchidaceae","Asparagales",0,0,0,1,0,NA
"Stevensia","Rubiaceae","Gentianales",0,0,0,11,0,NA
"Stevia","Asteraceae","Asterales",0,0,1,261,1,0
"Steviopsis","Asteraceae","Asterales",0,0,0,10,0,NA
"Stewartia","Theaceae","Ericales",8,0,0,19,8,1
"Stewartiella","Apiaceae","Apiales",0,0,0,1,0,NA
"Steyerbromelia","Bromeliaceae","Poales",0,0,0,6,0,NA
"Steyermarkia","Rubiaceae","Gentianales",0,0,0,1,0,NA
"Steyermarkina","Asteraceae","Asterales",0,0,0,4,0,NA
"Steyermarkochloa","Poaceae","Poales",0,0,0,1,0,NA
"Sticherus","Gleicheniaceae","Gleicheniales",0,0,0,74,0,NA
"Stichianthus","Rubiaceae","Gentianales",0,0,0,1,0,NA
"Stichoneuron","Stemonaceae","Pandanales",0,0,1,5,1,0
"Stichorkis","Orchidaceae","Asparagales",0,0,1,8,1,0
"Stictocardia","Convolvulaceae","Solanales",0,2,0,7,0,NA
"Stifftia","Asteraceae","Asterales",2,0,0,6,2,1
"Stigmaphyllon","Malpighiaceae","Malpighiales",9,3,0,93,9,1
"Stigmatocarpum","Aizoaceae","Caryophyllales",0,0,0,1,0,NA
"Stigmatodactylus","Orchidaceae","Asparagales",0,0,1,10,1,0
"Stigmatopteris","Dryopteridaceae","Polypodiales",0,0,0,25,0,NA
"Stigmatorhynchus","Apocynaceae","Gentianales",0,0,0,2,0,NA
"Stilbanthus","Amaranthaceae","Caryophyllales",0,0,0,1,0,NA
"Stilbe","Stilbaceae","Lamiales",3,0,0,7,3,1
"Stilbocarpa","Araliaceae","Apiales",0,0,1,3,1,0
"Stillingia","Euphorbiaceae","Malpighiales",3,0,0,29,3,1
"Stilpnogyne","Asteraceae","Asterales",0,0,0,1,0,NA
"Stilpnolepis","Asteraceae","Asterales",0,0,0,2,0,NA
"Stilpnopappus","Asteraceae","Asterales",0,0,0,19,0,NA
"Stilpnophyllum","Rubiaceae","Gentianales",2,0,0,4,2,1
"Stimpsonia","Primulaceae","Ericales",0,0,1,1,1,0
"Stipa","Poaceae","Poales",0,0,67,329,67,0
"Stipagrostis","Poaceae","Poales",0,0,1,56,1,0
"Stipecoma","Apocynaceae","Gentianales",0,0,1,1,1,0
"Stiporyzopsis","Poaceae","Poales",0,0,0,1,0,NA
"Stipularia","Rubiaceae","Gentianales",0,0,0,2,0,NA
"Stipulicida","Caryophyllaceae","Caryophyllales",0,0,0,1,0,NA
"Stirtonanthus","Fabaceae","Fabales",3,0,0,3,3,1
"Stisseria","Sapotaceae","Ericales",0,0,0,61,0,NA
"Stixis","Capparaceae","Brassicales",0,0,0,4,0,NA
"Stizolobium","Fabaceae","Fabales",0,0,0,15,0,NA
"Stizolophus","Asteraceae","Asterales",0,0,1,3,1,0
"Stizophyllum","Bignoniaceae","Lamiales",3,0,0,3,3,1
"Stobaea","Asteraceae","Asterales",0,0,0,3,0,NA
"Stocksia","Sapindaceae","Sapindales",0,0,0,1,0,NA
"Stockwellia","Myrtaceae","Myrtales",1,0,0,1,1,1
"Stoebe","Asteraceae","Asterales",0,0,0,20,0,NA
"Stoeberia","Aizoaceae","Caryophyllales",0,0,0,6,0,NA
"Stoibrax","Apiaceae","Apiales",0,0,1,1,1,0
"Stokesia","Asteraceae","Asterales",0,0,1,1,1,0
"Stolzia","Orchidaceae","Asparagales",0,0,0,15,0,NA
"Stomatanthes","Asteraceae","Asterales",0,0,0,17,0,NA
"Stomatium","Aizoaceae","Caryophyllales",0,0,0,40,0,NA
"Stomatochaeta","Asteraceae","Asterales",0,0,0,6,0,NA
"Stomatostemma","Apocynaceae","Gentianales",0,0,0,2,0,NA
"Stonesia","Podostemaceae","Malpighiales",0,0,0,2,0,NA
"Stonesiella","Fabaceae","Fabales",0,0,0,1,0,NA
"Storckiella","Fabaceae","Fabales",1,0,0,2,1,1
"Stormesia","Apleniaceae","Polypodiales",0,0,0,1,0,NA
"Stracheya","Fabaceae","Fabales",0,0,0,1,0,NA
"Stramentopappus","Asteraceae","Asterales",0,0,0,1,0,NA
"Strasburgeria","Strasburgeriaceae","Crossosomatales",1,0,0,1,1,1
"Stratiotes","Hydrocharitaceae","Alismatales",0,0,1,1,1,0
"Straussiella","Brassicaceae","Brassicales",0,0,0,1,0,NA
"Streblacanthus","Acanthaceae","Lamiales",0,0,0,5,0,NA
"Streblochaete","Poaceae","Poales",0,0,1,2,1,0
"Streblorrhiza","Fabaceae","Fabales",0,0,0,1,0,NA
"Streblosa","Rubiaceae","Gentianales",0,0,0,25,0,NA
"Streblosiopsis","Rubiaceae","Gentianales",0,0,0,1,0,NA
"Streblus","Moraceae","Rosales",7,0,0,11,7,1
"Strelitzia","Strelitziaceae","Zingiberales",1,0,1,5,2,0.5
"Strempeliopsis","Apocynaceae","Gentianales",0,0,0,2,0,NA
"Strephonema","Combretaceae","Myrtales",1,0,0,2,1,1
"Streptanthella","Brassicaceae","Brassicales",0,0,0,1,0,NA
"Streptanthus","Brassicaceae","Brassicales",0,0,1,37,1,0
"Streptocarpus","Gesneriaceae","Lamiales",0,0,9,134,9,0
"Streptocaulon","Apocynaceae","Gentianales",0,0,0,6,0,NA
"Streptochaeta","Poaceae","Poales",0,0,3,3,3,0
"Streptoglossa","Asteraceae","Asterales",0,0,2,8,2,0
"Streptogyna","Poaceae","Poales",0,0,2,2,2,0
"Streptolirion","Commelinaceae","Commelinales",0,0,0,1,0,NA
"Streptoloma","Brassicaceae","Brassicales",0,0,0,2,0,NA
"Streptolophus","Poaceae","Poales",0,0,0,1,0,NA
"Streptopetalum","Passifloraceae","Malpighiales",0,0,0,3,0,NA
"Streptopus","Liliaceae","Liliales",0,0,1,11,1,0
"Streptosiphon","Acanthaceae","Lamiales",0,0,0,1,0,NA
"Streptosolen","Solanaceae","Solanales",0,0,0,1,0,NA
"Streptostachys","Poaceae","Poales",0,0,3,7,3,0
"Striga","Orobanchaceae","Lamiales",0,0,4,26,4,0
"Strigosella","Brassicaceae","Brassicales",0,0,0,8,0,NA
"Strobilanthes","Acanthaceae","Lamiales",0,0,0,167,0,NA
"Strobilanthopsis","Acanthaceae","Lamiales",0,0,0,1,0,NA
"Strobocalyx","Asteraceae","Asterales",0,0,0,9,0,NA
"Stroganowia","Brassicaceae","Brassicales",0,0,0,1,0,NA
"Stromanthe","Marantaceae","Zingiberales",0,0,4,20,4,0
"Strombocactus","Cactaceae","Caryophyllales",0,0,0,1,0,NA
"Strombosia","Olacaceae","Santalales",6,0,0,9,6,1
"Strombosiopsis","Olacaceae","Santalales",1,0,0,3,1,1
"Strongylodon","Fabaceae","Fabales",0,1,0,14,0,NA
"Strophanthus","Apocynaceae","Gentianales",10,0,0,39,10,1
"Strophioblachia","Euphorbiaceae","Malpighiales",1,0,0,1,1,1
"Strophocaulos","Convolvulaceae","Solanales",0,0,0,1,0,NA
"Strophopappus","Asteraceae","Asterales",0,0,0,1,0,NA
"Strophostyles","Fabaceae","Fabales",0,0,2,4,2,0
"Strotheria","Asteraceae","Asterales",0,0,0,1,0,NA
"Struchium","Asteraceae","Asterales",0,0,1,3,1,0
"Strumaria","Amaryllidaceae","Asparagales",0,0,1,27,1,0
"Strumpfia","Rubiaceae","Gentianales",1,0,0,1,1,1
"Struthanthus","Loranthaceae","Santalales",1,0,0,88,1,1
"Struthiola","Thymelaeaceae","Malvales",2,0,0,35,2,1
"Struthiopteris","Blechnaceae","Polypodiales",0,0,0,5,0,NA
"Strychnopsis","Menispermaceae","Ranunculales",1,0,0,1,1,1
"Strychnos","Loganiaceae","Gentianales",37,0,0,168,37,1
"Stryphnodendron","Fabaceae","Fabales",9,0,0,30,9,1
"Stuartina","Asteraceae","Asterales",0,0,1,2,1,0
"Stubendorffia","Brassicaceae","Brassicales",0,0,0,8,0,NA
"Stuckenia","Potamogetonaceae","Alismatales",0,0,3,10,3,0
"Stuckertiella","Asteraceae","Asterales",0,0,0,2,0,NA
"Stuessya","Asteraceae","Asterales",0,0,0,2,0,NA
"Stuhlmannia","Fabaceae","Fabales",0,0,0,1,0,NA
"Stussenia","Melastomataceae","Myrtales",0,0,0,1,0,NA
"Stutzia","Amaranthaceae","Caryophyllales",0,0,0,1,0,NA
"Stylapterus","Penaeaceae","Myrtales",5,0,0,8,5,1
"Stylidium","Stylidiaceae","Asterales",0,0,3,19,3,0
"Stylisma","Convolvulaceae","Solanales",0,0,1,8,1,0
"Styloceras","Buxaceae","Buxales",2,0,0,6,2,1
"Stylochaeton","Araceae","Alismatales",0,0,1,19,1,0
"Stylochiton","Araceae","Alismatales",0,0,0,3,0,NA
"Stylocline","Asteraceae","Asterales",0,0,0,7,0,NA
"Stylogyne","Primulaceae","Ericales",0,0,0,33,0,NA
"Stylophorum","Papaveraceae","Ranunculales",0,0,1,3,1,0
"Stylophyllum","Crassulaceae","Saxifragales",0,0,0,8,0,NA
"Stylosanthes","Fabaceae","Fabales",0,0,0,46,0,NA
"Stylosiphonia","Rubiaceae","Gentianales",0,0,0,1,0,NA
"Stylotrichium","Asteraceae","Asterales",0,0,0,5,0,NA
"Stypandra","Xanthorrhoeaceae","Asparagales",0,0,1,2,1,0
"Styphelia","Ericaceae","Ericales",1,0,0,3,1,1
"Styphnolobium","Fabaceae","Fabales",2,0,0,8,2,1
"Styppeiochloa","Poaceae","Poales",0,0,1,3,1,0
"Styrax","Styracaceae","Ericales",29,0,0,101,29,1
"Styrophyton","Melastomataceae","Myrtales",0,0,0,1,0,NA
"Suaeda","Amaranthaceae","Caryophyllales",11,0,6,73,17,0.647058823529412
"Suarezia","Orchidaceae","Asparagales",0,0,0,1,0,NA
"Suberanthus","Rubiaceae","Gentianales",0,0,0,9,0,NA
"Subularia","Brassicaceae","Brassicales",0,0,1,2,1,0
"Succisa","Caprifoliaceae","Dipsacales",0,0,1,4,1,0
"Succisella","Caprifoliaceae","Dipsacales",0,0,1,4,1,0
"Succowia","Brassicaceae","Brassicales",0,0,0,1,0,NA
"Suckleya","Amaranthaceae","Caryophyllales",0,0,0,1,0,NA
"Sucrea","Poaceae","Poales",0,0,1,3,1,0
"Sudacaste","Orchidaceae","Asparagales",0,0,0,1,0,NA
"Sudamerlycaste","Orchidaceae","Asparagales",0,0,0,45,0,NA
"Suddia","Poaceae","Poales",0,0,0,1,0,NA
"Suessenguthia","Acanthaceae","Lamiales",0,0,0,7,0,NA
"Suessenguthiella","Molluginaceae","Caryophyllales",0,0,1,1,1,0
"Suksdorfia","Saxifragaceae","Saxifragales",0,0,2,2,2,0
"Sulcorebutia","Cactaceae","Caryophyllales",0,0,0,36,0,NA
"Sullivantia","Saxifragaceae","Saxifragales",0,0,2,3,2,0
"Sumatroscirpus","Cyperaceae","Poales",0,0,0,1,0,NA
"Sumbaviopsis","Euphorbiaceae","Malpighiales",1,0,0,1,1,1
"Summerhayesia","Orchidaceae","Asparagales",0,0,0,2,0,NA
"Sundacarpus","Podocarpaceae","Araucariales",1,0,0,1,1,1
"Sunipia","Orchidaceae","Asparagales",0,0,0,24,0,NA
"Suregada","Euphorbiaceae","Malpighiales",5,0,0,31,5,1
"Suriana","Surianaceae","Fabales",1,0,0,1,1,1
"Sutera","Scrophulariaceae","Lamiales",0,0,3,79,3,0
"Sutherlandia","Fabaceae","Fabales",1,0,0,6,1,1
"Sutrina","Orchidaceae","Asparagales",0,0,0,2,0,NA
"Suttonia","Primulaceae","Ericales",0,0,0,4,0,NA
"Suzukia","Lamiaceae","Lamiales",0,0,0,2,0,NA
"Svenkoeltzia","Orchidaceae","Asparagales",0,0,0,3,0,NA
"Svitramia","Melastomataceae","Myrtales",0,0,0,1,0,NA
"Swainsona","Fabaceae","Fabales",0,0,4,55,4,0
"Swallenia","Poaceae","Poales",0,0,0,1,0,NA
"Swartsia","Solanaceae","Solanales",0,0,0,1,0,NA
"Swartzia","Fabaceae","Fabales",57,0,0,181,57,1
"Swartzia","Solanaceae",NA,0,0,0,1,0,NA
"Sweetia","Fabaceae","Fabales",1,0,0,2,1,1
"Swertia","Gentianaceae","Gentianales",0,0,1,105,1,0
"Swida","Cornaceae","Cornales",0,0,0,1,0,NA
"Swietenia","Meliaceae","Sapindales",4,0,0,6,4,1
"Swinglea","Rutaceae","Sapindales",0,0,0,1,0,NA
"Syagrus","Arecaceae","Arecales",22,0,0,59,22,1
"Sycopsis","Hamamelidaceae","Saxifragales",1,0,0,2,1,1
"Sylvichadsia","Fabaceae","Fabales",0,0,0,5,0,NA
"Symbolanthus","Gentianaceae","Gentianales",0,0,0,22,0,NA
"Symmeria","Polygonaceae","Caryophyllales",1,0,0,1,1,1
"Symonanthus","Solanaceae","Solanales",1,0,0,1,1,1
"Sympegma","Amaranthaceae","Caryophyllales",1,0,0,1,1,1
"Sympetalandra","Fabaceae","Fabales",2,0,0,5,2,1
"Sympetaleia","Loasaceae","Cornales",0,0,0,3,0,NA
"Symphipappus","Asteraceae","Asterales",0,0,0,1,0,NA
"Symphonia","Clusiaceae","Malpighiales",5,0,0,15,5,1
"Symphorema","Lamiaceae","Lamiales",0,0,0,3,0,NA
"Symphoria","Caprifoliaceae","Dipsacales",0,0,0,1,0,NA
"Symphoricarpos","Caprifoliaceae","Dipsacales",6,0,0,16,6,1
"Symphostemon","Lamiaceae","Lamiales",0,0,0,2,0,NA
"Symphyllocarpus","Asteraceae","Asterales",0,0,0,1,0,NA
"Symphyllophyton","Gentianaceae","Gentianales",0,0,0,1,0,NA
"Symphyobasis","Goodeniaceae","Asterales",0,0,0,1,0,NA
"Symphyopappus","Asteraceae","Asterales",1,0,0,13,1,1
"Symphyotrichum","Asteraceae","Asterales",1,0,5,108,6,0.166666666666667
"Symphysia","Ericaceae","Ericales",0,0,0,1,0,NA
"Symphytum","Boraginaceae","UnknownOrder-Boraginaceae",0,0,0,21,0,NA
"Sympieza","Ericaceae","Ericales",0,0,0,1,0,NA
"Symplectochilus","Acanthaceae","Lamiales",0,0,0,2,0,NA
"Symplectrodia","Poaceae","Poales",0,0,0,2,0,NA
"Symplocarpus","Araceae","Alismatales",0,0,2,5,2,0
"Symplococarpon","Pentaphylacaceae","Ericales",0,0,0,3,0,NA
"Symplocos","Symplocaceae","Ericales",81,0,0,208,81,1
"Synadenium","Euphorbiaceae","Malpighiales",0,0,0,1,0,NA
"Synammia","Polypodiaceae","Polypodiales",0,0,0,1,0,NA
"Synandra","Lamiaceae","Lamiales",0,0,1,1,1,0
"Synandrodaphne","Thymelaeaceae","Malvales",1,0,0,1,1,1
"Synandrospadix","Araceae","Alismatales",0,0,1,1,1,0
"Synaphlebium","Lindsaeaceae","Polypodiales",0,0,0,1,0,NA
"Synapsis","Schlegeliaceae","Lamiales",1,0,0,1,1,1
"Synaptantha","Rubiaceae","Gentianales",0,0,2,2,2,0
"Synaptolepis","Thymelaeaceae","Malvales",1,0,0,5,1,1
"Synaptophyllum","Aizoaceae","Caryophyllales",0,0,0,1,0,NA
"Syncalathium","Asteraceae","Asterales",0,0,0,6,0,NA
"Syncarpha","Asteraceae","Asterales",0,0,2,29,2,0
"Syncarpia","Myrtaceae","Myrtales",3,0,0,3,3,1
"Syncephalum","Asteraceae","Asterales",0,0,0,1,0,NA
"Synclisia","Menispermaceae","Ranunculales",0,0,0,1,0,NA
"Syncolostemon","Lamiaceae","Lamiales",1,0,1,45,2,0.5
"Syncretocarpus","Asteraceae","Asterales",0,0,0,1,0,NA
"Syndesmanthus","Ericaceae","Ericales",0,0,0,2,0,NA
"Syndiclis","Lauraceae","Laurales",0,0,0,8,0,NA
"Syndyophyllum","Euphorbiaceae","Malpighiales",1,0,0,2,1,1
"Synechanthus","Arecaceae","Arecales",2,0,0,2,2,1
"Synedrella","Asteraceae","Asterales",0,0,1,1,1,0
"Synedrellopsis","Asteraceae","Asterales",0,0,0,1,0,NA
"Syneilesis","Asteraceae","Asterales",0,0,2,6,2,0
"Synelcosciadium","Apiaceae","Apiales",0,0,0,1,0,NA
"Syngonanthus","Eriocaulaceae","Poales",0,0,2,138,2,0
"Syngonium","Araceae","Alismatales",0,0,2,35,2,0
"Syngramma","Pteridaceae","Polypodiales",0,0,0,1,0,NA
"Syngrammatopsis","Pteridaceae","Polypodiales",0,0,0,3,0,NA
"Synima","Sapindaceae","Sapindales",1,0,0,1,1,1
"Synnema","Acanthaceae","Lamiales",0,0,0,1,0,NA
"Synnotia","Iridaceae","Asparagales",0,0,0,1,0,NA
"Synotis","Asteraceae","Asterales",0,0,2,51,2,0
"Synoum","Meliaceae","Sapindales",1,0,0,1,1,1
"Synsepalum","Sapotaceae","Ericales",12,0,0,29,12,1
"Synstemon","Brassicaceae","Brassicales",0,0,0,2,0,NA
"Synthlipsis","Brassicaceae","Brassicales",0,0,0,2,0,NA
"Synthyris","Plantaginaceae","Lamiales",0,0,0,12,0,NA
"Syntriandrium","Menispermaceae","Ranunculales",0,0,0,1,0,NA
"Syntrichopappus","Asteraceae","Asterales",0,0,0,2,0,NA
"Synurus","Asteraceae","Asterales",0,0,1,3,1,0
"Syreitschikovia","Asteraceae","Asterales",0,0,0,3,0,NA
"Syrenia","Brassicaceae","Brassicales",0,0,0,3,0,NA
"Syringa","Oleaceae","Lamiales",9,0,0,13,9,1
"Syringantha","Rubiaceae","Gentianales",0,0,0,1,0,NA
"Syringodea","Iridaceae","Asparagales",0,0,8,8,8,0
"Syringodium","Cymodoceaceae","Alismatales",0,0,2,2,2,0
"Syrmatium","Fabaceae","Fabales",2,0,0,16,2,1
"Syrrheonema","Menispermaceae","Ranunculales",0,0,0,1,0,NA
"Syrrhonema","Menispermaceae","Ranunculales",0,0,0,1,0,NA
"Systellantha","Primulaceae","Ericales",0,0,0,1,0,NA
"Systeloglossum","Orchidaceae","Asparagales",0,0,1,5,1,0
"Systemonodaphne","Lauraceae","Laurales",0,0,0,1,0,NA
"Systenotheca","Polygonaceae","Caryophyllales",0,0,0,1,0,NA
"Syzygium","Myrtaceae","Myrtales",254,0,0,1139,254,1
"Tabebuia","Bignoniaceae","Lamiales",15,0,0,74,15,1
"Tabernaemontana","Apocynaceae","Gentianales",23,0,0,118,23,1
"Tabernanthe","Apocynaceae","Gentianales",1,0,0,2,1,1
"Tacarcuna","Phyllanthaceae","Malpighiales",0,0,0,3,0,NA
"Tacazzea","Apocynaceae","Gentianales",1,0,0,6,1,1
"Tacca","Dioscoreaceae","Dioscoreales",0,0,7,17,7,0
"Taccarum","Araceae","Alismatales",0,0,3,6,3,0
"Tachia","Gentianaceae","Gentianales",0,0,0,11,0,NA
"Tachiadenus","Gentianaceae","Gentianales",0,0,0,12,0,NA
"Tachigali","Fabaceae","Fabales",19,0,0,74,19,1
"Tacinga","Cactaceae","Caryophyllales",0,0,0,4,0,NA
"Tacitus","Crassulaceae","Saxifragales",0,0,0,1,0,NA
"Tacsonia","Passifloraceae","Malpighiales",0,0,0,1,0,NA
"Tadehagi","Fabaceae","Fabales",0,0,0,4,0,NA
"Taeniandra","Acanthaceae","Lamiales",0,0,0,1,0,NA
"Taeniatherum","Poaceae","Poales",0,0,1,1,1,0
"Taenidia","Apiaceae","Apiales",0,0,0,2,0,NA
"Taeniochlaena","Connaraceae","Oxalidales",0,0,0,1,0,NA
"Taeniophyllum","Orchidaceae","Asparagales",0,0,1,185,1,0
"Taeniopsis","Pteridaceae","Polypodiales",0,0,0,1,0,NA
"Taeniorhachis","Poaceae","Poales",0,0,0,1,0,NA
"Taeniorrhiza","Orchidaceae","Asparagales",0,0,0,1,0,NA
"Taenitis","Pteridaceae","Polypodiales",0,0,0,5,0,NA
"Tafalla","Asteraceae","Asterales",0,0,0,1,0,NA
"Tagetes","Asteraceae","Asterales",0,0,3,53,3,0
"Tahina","Arecaceae","Arecales",0,0,0,1,0,NA
"Tainia","Orchidaceae","Asparagales",0,0,2,32,2,0
"Taiwania","Cupressaceae","Cupressales",1,0,0,1,1,1
"Takhtajania","Winteraceae","Canellales",1,0,0,1,1,1
"Takhtajaniantha","Asteraceae","Asterales",0,0,0,1,0,NA
"Talamancalia","Asteraceae","Asterales",0,0,0,4,0,NA
"Talassia","Apiaceae","Apiales",0,0,0,1,0,NA
"Talauma","Magnoliaceae","Magnoliales",0,0,0,1,0,NA
"Talbotiella","Fabaceae","Fabales",0,0,0,3,0,NA
"Talinella","Talinaceae","Caryophyllales",1,0,0,12,1,1
"Talinopsis","Anacampserotaceae","Caryophyllales",0,0,0,1,0,NA
"Talinum","Talinaceae","Caryophyllales",0,0,5,16,5,0
"Talipariti","Malvaceae","Malvales",3,0,0,18,3,1
"Talisia","Sapindaceae","Sapindales",16,0,0,52,16,1
"Tamamschjanella","Apiaceae","Apiales",0,0,0,1,0,NA
"Tamania","Asteraceae","Asterales",0,0,0,1,0,NA
"Tamarindus","Fabaceae","Fabales",1,0,0,1,1,1
"Tamarix","Tamaricaceae","Caryophyllales",22,0,0,57,22,1
"Tamaulipa","Asteraceae","Asterales",0,0,0,1,0,NA
"Tambourissa","Monimiaceae","Laurales",10,0,0,43,10,1
"Tamijia","Zingiberaceae","Zingiberales",0,0,0,1,0,NA
"Tamilnadia","Rubiaceae","Gentianales",1,0,0,1,1,1
"Tammsia","Rubiaceae","Gentianales",0,0,0,1,0,NA
"Tamonea","Verbenaceae","Lamiales",0,0,0,11,0,NA
"Tampoa","Celastraceae","Celastrales",0,0,0,1,0,NA
"Tamridaea","Rubiaceae","Gentianales",1,0,0,1,1,1
"Tana","Apiaceae","Apiales",0,0,0,1,0,NA
"Tanacetopsis","Asteraceae","Asterales",0,0,0,21,0,NA
"Tanacetum","Asteraceae","Asterales",0,0,2,167,2,0
"Tanaecium","Bignoniaceae","Lamiales",7,0,0,16,7,1
"Tanakaea","Saxifragaceae","Saxifragales",0,0,1,1,1,0
"Tannodia","Euphorbiaceae","Malpighiales",3,0,0,9,3,1
"Tanquana","Aizoaceae","Caryophyllales",0,0,0,1,0,NA
"Taonabo","Pentaphylacaceae","Ericales",0,0,0,1,0,NA
"Tapeinia","Iridaceae","Asparagales",0,0,0,1,0,NA
"Tapeinidium","Lindsaeaceae","Polypodiales",0,0,0,11,0,NA
"Tapeinochilos","Costaceae","Zingiberales",0,0,2,16,2,0
"Tapeinosperma","Primulaceae","Ericales",1,0,0,4,1,1
"Tapeinostemon","Gentianaceae","Gentianales",0,0,0,8,0,NA
"Tapheocarpa","Commelinaceae","Commelinales",0,0,0,1,0,NA
"Tapinanthus","Loranthaceae","Santalales",2,0,0,39,2,1
"Tapirira","Anacardiaceae","Sapindales",3,0,0,8,3,1
"Tapiscia","Tapisciaceae","Huerteales",1,0,0,2,1,1
"Taplinia","Asteraceae","Asterales",0,0,0,1,0,NA
"Tapoides","Euphorbiaceae","Malpighiales",0,0,0,1,0,NA
"Tapura","Dichapetalaceae","Malpighiales",10,0,0,32,10,1
"Tarachia","Aspleniaceae","Polypodiales",0,0,0,8,0,NA
"Taralea","Fabaceae","Fabales",1,0,0,5,1,1
"Tarasa","Malvaceae","Malvales",0,0,0,27,0,NA
"Taravalia","Rutaceae","Sapindales",0,0,0,3,0,NA
"Taraxacum","Asteraceae","Asterales",0,0,7,2332,7,0
"Taraxia","Onagraceae","Myrtales",0,0,0,1,0,NA
"Taraxis","Restionaceae","Poales",0,0,1,1,1,0
"Tarchonanthus","Asteraceae","Asterales",1,0,0,6,1,1
"Tarenna","Rubiaceae","Gentianales",10,0,0,192,10,1
"Tarennoidea","Rubiaceae","Gentianales",1,0,0,2,1,1
"Tarigidia","Poaceae","Poales",0,0,0,2,0,NA
"Tarlmounia","Asteraceae","Asterales",0,0,0,1,0,NA
"Tarrietia","Malvaceae","Malvales",1,0,0,1,1,1
"Tasmannia","Winteraceae","Canellales",4,0,0,14,4,1
"Tassadia","Apocynaceae","Gentianales",0,0,0,25,0,NA
"Tateanthus","Melastomataceae","Myrtales",0,0,0,1,0,NA
"Tatianyx","Poaceae","Poales",0,0,1,1,1,0
"Tauscheria","Brassicaceae","Brassicales",0,0,0,1,0,NA
"Tauschia","Apiaceae","Apiales",0,0,0,26,0,NA
"Tavaresia","Apocynaceae","Gentianales",0,0,0,4,0,NA
"Taverniera","Fabaceae","Fabales",0,0,0,16,0,NA
"Taxandria","Myrtaceae","Myrtales",8,0,0,11,8,1
"Taxillus","Loranthaceae","Santalales",0,0,0,20,0,NA
"Taxodium","Cupressaceae","Cupressales",2,0,0,2,2,1
"Taxotrophis","Moraceae","Rosales",0,0,0,1,0,NA
"Taxus","Taxaceae","Cupressales",7,0,0,9,7,1
"Tchihatchewia","Brassicaceae","Brassicales",0,0,0,1,0,NA
"Teagueia","Orchidaceae","Asparagales",0,0,0,13,0,NA
"Teclea","Rutaceae","Sapindales",2,0,0,11,2,1
"Tecoma","Bignoniaceae","Lamiales",3,0,0,10,3,1
"Tecomanthe","Bignoniaceae","Lamiales",1,0,0,5,1,1
"Tecomella","Bignoniaceae","Lamiales",1,0,0,1,1,1
"Tecophilaea","Tecophilaeaceae","Asparagales",0,0,2,2,2,0
"Tectaria","Tectariaceae","Polypodiales",0,0,5,195,5,0
"Tecticornia","Amaranthaceae","Caryophyllales",0,1,0,2,0,NA
"Tectiphiala","Arecaceae","Arecales",1,0,0,1,1,1
"Tectona","Lamiaceae","Lamiales",2,0,0,3,2,1
"Tecunumania","Cucurbitaceae","Cucurbitales",0,0,1,1,1,0
"Teedia","Scrophulariaceae","Lamiales",0,0,1,2,1,0
"Teesdalia","Brassicaceae","Brassicales",0,0,1,2,1,0
"Teesdaliopsis","Brassicaceae","Brassicales",0,0,0,1,0,NA
"Tehuana","Asteraceae","Asterales",0,0,0,1,0,NA
"Teijsmanniodendron","Lamiaceae","Lamiales",6,0,0,23,6,1
"Teixeiranthus","Asteraceae","Asterales",0,0,0,2,0,NA
"Telanthera","Amaranthaceae","Caryophyllales",0,0,0,1,0,NA
"Telanthophora","Asteraceae","Asterales",0,0,0,4,0,NA
"Telekia","Asteraceae","Asterales",0,0,1,2,1,0
"Telephium","Caryophyllaceae","Caryophyllales",1,0,0,3,1,1
"Telesonix","Saxifragaceae","Saxifragales",0,0,1,2,1,0
"Telfairia","Cucurbitaceae","Cucurbitales",0,2,0,3,0,NA
"Teline","Fabaceae","Fabales",1,0,0,1,1,1
"Teliostachya","Acanthaceae","Lamiales",0,0,0,3,0,NA
"Telipogon","Orchidaceae","Asparagales",0,0,17,206,17,0
"Telis","Fabaceae","Fabales",0,0,0,8,0,NA
"Telitoxicum","Menispermaceae","Ranunculales",2,0,0,8,2,1
"Tellima","Saxifragaceae","Saxifragales",0,0,1,10,1,0
"Telmatophila","Asteraceae","Asterales",0,0,0,1,0,NA
"Telminostelma","Apocynaceae","Gentianales",0,0,0,2,0,NA
"Telopea","Proteaceae","Proteales",1,0,0,1,1,1
"Telosma","Apocynaceae","Gentianales",0,0,0,10,0,NA
"Temburongia","Poaceae","Poales",0,0,0,1,0,NA
"Temnadenia","Apocynaceae","Gentianales",0,2,0,4,0,NA
"Temnocalyx","Rubiaceae","Gentianales",0,0,0,1,0,NA
"Temnopteryx","Rubiaceae","Gentianales",0,0,0,1,0,NA
"Temochloa","Poaceae","Poales",0,0,0,1,0,NA
"Templetonia","Fabaceae","Fabales",1,0,0,12,1,1
"Tenaris","Apocynaceae","Gentianales",0,0,0,4,0,NA
"Tenaxia","Poaceae","Poales",0,0,0,8,0,NA
"Tennantia","Rubiaceae","Gentianales",1,0,0,1,1,1
"Tenrhynea","Asteraceae","Asterales",0,0,0,1,0,NA
"Tephrocactus","Cactaceae","Caryophyllales",0,0,0,15,0,NA
"Tephroseris","Asteraceae","Asterales",0,0,1,41,1,0
"Tephrosia","Fabaceae","Fabales",1,0,2,362,3,0.333333333333333
"Tepualia","Myrtaceae","Myrtales",1,0,0,1,1,1
"Tepuia","Ericaceae","Ericales",2,0,0,7,2,1
"Tepuianthus","Thymelaeaceae","Malvales",0,0,0,6,0,NA
"Teramnus","Fabaceae","Fabales",0,0,1,10,1,0
"Teratophyllum","Dryopteridaceae","Polypodiales",0,0,0,9,0,NA
"Terebinthus","Burseraceae","Sapindales",0,0,0,1,0,NA
"Terminalia","Combretaceae","Myrtales",43,0,0,109,43,1
"Terminthia","Anacardiaceae","Sapindales",0,0,0,1,0,NA
"Ternatea","Fabaceae","Fabales",0,0,0,4,0,NA
"Terniopsis","Podostemaceae","Malpighiales",0,0,0,1,0,NA
"Ternstroemia","Pentaphylacaceae","Ericales",14,0,0,88,14,1
"Ternstroemiopsis","Pentaphylacaceae","Ericales",0,0,0,1,0,NA
"Terpsichore","Polypodiaceae","Polypodiales",0,0,0,47,0,NA
"Terua","Fabaceae","Fabales",0,0,0,1,0,NA
"Tessaria","Asteraceae","Asterales",1,0,0,3,1,1
"Tessiera","Rubiaceae","Gentianales",0,0,0,2,0,NA
"Tessmannia","Fabaceae","Fabales",2,0,0,12,2,1
"Tessmanniacanthus","Acanthaceae","Lamiales",0,0,0,1,0,NA
"Tessmannianthus","Melastomataceae","Myrtales",1,0,0,6,1,1
"Testulea","Ochnaceae","Malpighiales",1,0,0,1,1,1
"Tetilla","Saxifragaceae","Saxifragales",0,0,0,1,0,NA
"Tetraberlinia","Fabaceae","Fabales",2,0,0,7,2,1
"Tetracarpum","Asteraceae","Asterales",0,0,0,2,0,NA
"Tetracentron","Trochodendraceae","Trochodendrales",1,0,0,1,1,1
"Tetracera","Dilleniaceae","Dilleniales",4,0,0,52,4,1
"Tetrachaete","Poaceae","Poales",0,0,0,1,0,NA
"Tetrachne","Poaceae","Poales",0,0,1,1,1,0
"Tetrachondra","Tetrachondraceae","Lamiales",0,0,2,2,2,0
"Tetrachyron","Asteraceae","Asterales",1,0,0,7,1,1
"Tetraclinis","Cupressaceae","Cupressales",1,0,0,1,1,1
"Tetracme","Brassicaceae","Brassicales",0,0,2,10,2,0
"Tetracoccus","Picrodendraceae","Malpighiales",2,0,0,4,2,1
"Tetradenia","Lamiaceae","Lamiales",1,0,0,22,1,1
"Tetradia","Malvaceae","Malvales",0,0,0,1,0,NA
"Tetradiclis","Nitrariaceae","Sapindales",0,0,1,1,1,0
"Tetradium","Rutaceae","Sapindales",3,0,0,8,3,1
"Tetradymia","Asteraceae","Asterales",8,0,0,10,8,1
"Tetraena","Zygophyllaceae","Zygophyllales",1,0,0,11,1,1
"Tetragastris","Burseraceae","Sapindales",3,0,0,8,3,1
"Tetraglochidium","Acanthaceae","Lamiales",0,0,0,1,0,NA
"Tetraglochin","Rosaceae","Rosales",0,0,0,8,0,NA
"Tetragonanthus","Gentianaceae","Gentianales",0,0,0,1,0,NA
"Tetragonia","Aizoaceae","Caryophyllales",1,0,1,49,2,0.5
"Tetragonolobus","Fabaceae","Fabales",0,0,0,1,0,NA
"Tetragonotheca","Asteraceae","Asterales",0,0,1,4,1,0
"Tetralocularia","Convolvulaceae","Solanales",0,1,0,1,0,NA
"Tetrameles","Tetramelaceae","Cucurbitales",1,0,0,1,1,1
"Tetrameranthus","Annonaceae","Magnoliales",1,0,0,5,1,1
"Tetramerium","Acanthaceae","Lamiales",0,0,0,32,0,NA
"Tetramicra","Orchidaceae","Asparagales",0,0,1,14,1,0
"Tetramolopium","Asteraceae","Asterales",1,0,0,37,1,1
"Tetranema","Plantaginaceae","Lamiales",1,0,0,7,1,1
"Tetraneuris","Asteraceae","Asterales",0,0,0,9,0,NA
"Tetranthera","Lauraceae","Laurales",1,0,0,10,1,1
"Tetranthus","Asteraceae","Asterales",0,0,1,4,1,0
"Tetrapanax","Araliaceae","Apiales",1,0,0,1,1,1
"Tetrapathaea","Passifloraceae","Malpighiales",0,0,0,1,0,NA
"Tetraperone","Asteraceae","Asterales",0,0,0,1,0,NA
"Tetraphyle","Crassulaceae","Saxifragales",0,0,0,1,0,NA
"Tetraphysa","Apocynaceae","Gentianales",0,0,0,2,0,NA
"Tetrapleura","Fabaceae","Fabales",1,0,0,2,1,1
"Tetrapogon","Poaceae","Poales",0,0,0,5,0,NA
"Tetrapollinia","Gentianaceae","Gentianales",0,0,0,1,0,NA
"Tetrapterocarpon","Fabaceae","Fabales",1,0,0,2,1,1
"Tetrapteron","Onagraceae","Myrtales",0,0,0,2,0,NA
"Tetrapterys","Malpighiaceae","Malpighiales",12,1,0,65,12,1
"Tetrardisia","Primulaceae","Ericales",0,0,0,4,0,NA
"Tetraria","Cyperaceae","Poales",0,0,8,54,8,0
"Tetraselago","Scrophulariaceae","Lamiales",0,0,1,4,1,0
"Tetrasida","Malvaceae","Malvales",0,0,0,4,0,NA
"Tetraspidium","Orobanchaceae","Lamiales",0,0,0,1,0,NA
"Tetrastemma","Annonaceae","Magnoliales",0,0,0,1,0,NA
"Tetrastigma","Vitaceae","Vitales",1,1,0,68,1,1
"Tetrastylidium","Olacaceae","Santalales",2,0,0,2,2,1
"Tetrastylis","Passifloraceae","Malpighiales",0,0,0,1,0,NA
"Tetrataxis","Lythraceae","Myrtales",0,0,0,1,0,NA
"Tetratheca","Elaeocarpaceae","Oxalidales",1,0,0,4,1,1
"Tetrathylacium","Salicaceae","Malpighiales",2,0,0,2,2,1
"Tetraulacium","Plantaginaceae","Lamiales",0,0,0,1,0,NA
"Tetrazygia","Melastomataceae","Myrtales",2,0,0,12,2,1
"Tetrazygiopsis","Melastomataceae","Myrtales",0,0,0,13,0,NA
"Tetroncium","Juncaginaceae","Alismatales",0,0,1,1,1,0
"Tetrorchidium","Euphorbiaceae","Malpighiales",5,0,0,23,5,1
"Teucridium","Lamiaceae","Lamiales",1,0,0,1,1,1
"Teucrium","Lamiaceae","Lamiales",9,0,12,287,21,0.428571428571429
"Teuscheria","Orchidaceae","Asparagales",0,0,0,7,0,NA
"Teyleria","Fabaceae","Fabales",0,0,0,3,0,NA
"Thaia","Orchidaceae","Asparagales",0,0,0,1,0,NA
"Thailentadopsis","Fabaceae","Fabales",0,0,0,2,0,NA
"Thalassia","Hydrocharitaceae","Alismatales",0,0,2,2,2,0
"Thalassodendron","Cymodoceaceae","Alismatales",0,0,1,2,1,0
"Thaleropia","Myrtaceae","Myrtales",1,0,0,3,1,1
"Thalia","Marantaceae","Zingiberales",0,0,2,6,2,0
"Thalictrum","Ranunculaceae","Ranunculales",0,0,13,157,13,0
"Thaminophyllum","Asteraceae","Asterales",0,0,0,3,0,NA
"Thamnea","Bruniaceae","Bruniales",1,0,0,9,1,1
"Thamnocalamus","Poaceae","Poales",0,0,0,4,0,NA
"Thamnocharis","Gesneriaceae","Lamiales",0,0,0,1,0,NA
"Thamnochortus","Restionaceae","Poales",0,0,30,35,30,0
"Thamnoldenlandia","Rubiaceae","Gentianales",0,0,0,1,0,NA
"Thamnopteris","Aspleniaceae","Polypodiales",0,0,0,1,0,NA
"Thamnosciadium","Apiaceae","Apiales",0,0,0,1,0,NA
"Thamnoseris","Asteraceae","Asterales",0,0,0,1,0,NA
"Thamnosma","Rutaceae","Sapindales",0,0,0,7,0,NA
"Thapsia","Apiaceae","Apiales",0,0,2,3,2,0
"Thaspium","Apiaceae","Apiales",2,0,0,5,2,1
"Thaumasianthes","Loranthaceae","Santalales",0,0,0,1,0,NA
"Thaumastochloa","Poaceae","Poales",0,0,0,9,0,NA
"Thaumatocaryon","Boraginaceae","UnknownOrder-Boraginaceae",0,0,0,3,0,NA
"Thaumatococcus","Marantaceae","Zingiberales",0,0,1,1,1,0
"Thecacoris","Phyllanthaceae","Malpighiales",2,0,0,17,2,1
"Thecanthes","Thymelaeaceae","Malvales",0,0,1,5,1,0
"Thecopus","Orchidaceae","Asparagales",0,0,0,2,0,NA
"Thecostele","Orchidaceae","Asparagales",0,0,1,1,1,0
"Thedachloa","Poaceae","Poales",0,0,0,1,0,NA
"Theilera","Campanulaceae","Asterales",0,0,0,2,0,NA
"Thelaia","Ericaceae","Ericales",0,0,0,1,0,NA
"Thelasis","Orchidaceae","Asparagales",0,0,1,26,1,0
"Thelepaepale","Acanthaceae","Lamiales",0,0,0,1,0,NA
"Thelepogon","Poaceae","Poales",0,0,0,2,0,NA
"Thelesperma","Asteraceae","Asterales",0,0,1,13,1,0
"Thelethylax","Podostemaceae","Malpighiales",0,0,0,2,0,NA
"Theligonum","Rubiaceae","Gentianales",0,0,1,4,1,0
"Thelionema","Xanthorrhoeaceae","Asparagales",0,0,3,3,3,0
"Thelocactus","Cactaceae","Caryophyllales",0,0,0,13,0,NA
"Thelymitra","Orchidaceae","Asparagales",0,0,3,115,3,0
"Thelypodiopsis","Brassicaceae","Brassicales",0,0,0,15,0,NA
"Thelypodium","Brassicaceae","Brassicales",0,0,1,19,1,0
"Thelypteris","Thelypteridaceae","Polypodiales",0,0,0,433,0,NA
"Thelyschista","Orchidaceae","Asparagales",0,0,0,1,0,NA
"Themeda","Poaceae","Poales",0,0,5,27,5,0
"Themelium","Polypodiaceae","Polypodiales",0,0,0,1,0,NA
"Themistoclesia","Ericaceae","Ericales",1,0,0,27,1,1
"Thenardia","Apocynaceae","Gentianales",0,0,0,3,0,NA
"Theobroma","Malvaceae","Malvales",8,0,0,22,8,1
"Theodora","Fabaceae","Fabales",0,0,0,1,0,NA
"Theodorovia","Campanulaceae","Asterales",0,0,0,1,0,NA
"Theophrasta","Primulaceae","Ericales",0,0,0,2,0,NA
"Theopsis","Theaceae","Ericales",0,0,0,1,0,NA
"Thereianthus","Iridaceae","Asparagales",0,0,7,8,7,0
"Theriophonum","Araceae","Alismatales",0,0,0,7,0,NA
"Thermopsis","Fabaceae","Fabales",0,0,4,30,4,0
"Therofon","Saxifragaceae","Saxifragales",0,0,0,3,0,NA
"Theropogon","Asparagaceae","Asparagales",0,0,0,1,0,NA
"Therorhodion","Ericaceae","Ericales",0,0,0,1,0,NA
"Thesidium","Santalaceae","Santalales",0,0,1,6,1,0
"Thesium","Santalaceae","Santalales",0,0,4,305,4,0
"Thesmophora","Stilbaceae","Lamiales",0,0,0,1,0,NA
"Thespesia","Malvaceae","Malvales",2,0,0,11,2,1
"Thespidium","Asteraceae","Asterales",0,0,0,1,0,NA
"Thespis","Asteraceae","Asterales",0,0,0,4,0,NA
"Thevenotia","Asteraceae","Asterales",0,0,1,2,1,0
"Thevetia","Apocynaceae","Gentianales",1,0,0,4,1,1
"Thibaudia","Ericaceae","Ericales",8,0,0,62,8,1
"Thilachium","Capparaceae","Brassicales",1,0,0,15,1,1
"Thiloa","Combretaceae","Myrtales",1,0,0,2,1,1
"Thinouia","Sapindaceae","Sapindales",4,0,0,9,4,1
"Thiollierea","Rubiaceae","Gentianales",0,0,0,12,0,NA
"Thiseltonia","Asteraceae","Asterales",0,0,0,1,0,NA
"Thismia","Burmanniaceae","Dioscoreales",0,0,2,45,2,0
"Thladiantha","Cucurbitaceae","Cucurbitales",0,0,3,26,3,0
"Thlasidia","Caprifoliaceae","Dipsacales",0,0,0,1,0,NA
"Thlaspi","Brassicaceae","Brassicales",0,0,4,79,4,0
"Thogsennia","Rubiaceae","Gentianales",0,0,0,1,0,NA
"Thomandersia","Schlegeliaceae","Lamiales",3,0,0,6,3,1
"Thomandersia","Thomandersiaceae",NA,1,0,0,1,1,1
"Thomasia","Malvaceae","Malvales",0,0,0,1,0,NA
"Thompsonella","Crassulaceae","Saxifragales",0,0,0,7,0,NA
"Thonningia","Balanophoraceae","Santalales",0,0,0,1,0,NA
"Thoracocarpus","Cyclanthaceae","Pandanales",1,0,0,1,1,1
"Thoracosperma","Ericaceae","Ericales",0,0,0,1,0,NA
"Thoreauea","Apocynaceae","Gentianales",0,0,0,3,0,NA
"Thorella","Apiaceae","Apiales",0,0,0,1,0,NA
"Thornbera","Fabaceae","Fabales",0,0,0,1,0,NA
"Thorncroftia","Lamiaceae","Lamiales",0,0,0,6,0,NA
"Thornea","Hypericaceae","Malpighiales",1,0,0,2,1,1
"Thottea","Aristolochiaceae","Piperales",2,0,0,3,2,1
"Thouinia","Sapindaceae","Sapindales",5,0,0,10,5,1
"Thouinidium","Sapindaceae","Sapindales",2,0,0,3,2,1
"Thrasya","Poaceae","Poales",0,0,1,22,1,0
"Thrasyopsis","Poaceae","Poales",0,0,0,2,0,NA
"Thraulococcus","Sapindaceae","Sapindales",0,0,0,1,0,NA
"Threlkeldia","Amaranthaceae","Caryophyllales",0,0,0,2,0,NA
"Thrinax","Arecaceae","Arecales",3,0,0,3,3,1
"Thrincia","Asteraceae","Asterales",0,0,0,7,0,NA
"Thrixanthocereus","Cactaceae","Caryophyllales",0,0,0,1,0,NA
"Thrixspermum","Orchidaceae","Asparagales",0,0,1,161,1,0
"Thryallis","Malpighiaceae","Malpighiales",1,0,0,4,1,1
"Thryptomene","Myrtaceae","Myrtales",7,0,0,32,7,1
"Thuarea","Poaceae","Poales",0,0,1,2,1,0
"Thuja","Cupressaceae","Cupressales",4,0,0,5,4,1
"Thujopsis","Cupressaceae","Cupressales",1,0,0,1,1,1
"Thulinia","Orchidaceae","Asparagales",0,0,0,1,0,NA
"Thunbergia","Acanthaceae","Lamiales",1,0,2,102,3,0.333333333333333
"Thunbergianthus","Orobanchaceae","Lamiales",0,0,0,1,0,NA
"Thunbergiella","Apiaceae","Apiales",0,0,0,1,0,NA
"Thunia","Orchidaceae","Asparagales",0,0,1,5,1,0
"Thurnia","Thurniaceae","Poales",0,0,1,3,1,0
"Thurovia","Asteraceae","Asterales",0,0,0,1,0,NA
"Thuspeinanta","Lamiaceae","Lamiales",0,0,0,2,0,NA
"Thyana","Sapindaceae","Sapindales",0,0,0,2,0,NA
"Thyella","Convolvulaceae","Solanales",0,0,0,8,0,NA
"Thylacanthus","Fabaceae","Fabales",0,0,0,1,0,NA
"Thylacopteris","Polypodiaceae","Polypodiales",0,0,0,1,0,NA
"Thylacospermum","Caryophyllaceae","Caryophyllales",0,0,0,1,0,NA
"Thymbra","Lamiaceae","Lamiales",1,0,0,4,1,1
"Thymelaea","Thymelaeaceae","Malvales",1,0,0,34,1,1
"Thymophylla","Asteraceae","Asterales",0,1,0,13,0,NA
"Thymopsis","Asteraceae","Asterales",0,0,0,2,0,NA
"Thymus","Lamiaceae","Lamiales",6,0,0,315,6,1
"Thyrasperma","Aizoaceae","Caryophyllales",0,0,0,1,0,NA
"Thyridachne","Poaceae","Poales",0,0,0,1,0,NA
"Thyridolepis","Poaceae","Poales",0,0,1,3,1,0
"Thyrocarpus","Boraginaceae","UnknownOrder-Boraginaceae",0,0,1,2,1,0
"Thyrsacanthus","Acanthaceae","Lamiales",0,0,0,2,0,NA
"Thyrsanthella","Apocynaceae","Gentianales",0,1,0,1,0,NA
"Thyrsanthemum","Commelinaceae","Commelinales",0,0,0,3,0,NA
"Thyrsanthera","Euphorbiaceae","Malpighiales",0,1,0,1,0,NA
"Thyrsodium","Anacardiaceae","Sapindales",2,0,0,7,2,1
"Thyrsopteris","Thyrsopteridaceae","Cyatheales",0,0,0,1,0,NA
"Thyrsosalacia","Celastraceae","Celastrales",0,0,0,2,0,NA
"Thyrsostachys","Poaceae","Poales",0,0,0,2,0,NA
"Thysanobotrya","Cyatheaceae","Cyatheales",0,0,0,1,0,NA
"Thysanocarpus","Brassicaceae","Brassicales",0,0,0,5,0,NA
"Thysanoglossa","Orchidaceae","Asparagales",0,0,0,3,0,NA
"Thysanolaena","Poaceae","Poales",1,0,0,1,1,1
"Thysanosoria","Lomariopsidaceae","Polypodiales",0,0,0,1,0,NA
"Thysanostemon","Clusiaceae","Malpighiales",0,0,0,2,0,NA
"Thysanotus","Asparagaceae","Asparagales",0,0,13,50,13,0
"Tiarella","Saxifragaceae","Saxifragales",0,0,4,8,4,0
"Tiarocarpus","Asteraceae","Asterales",0,0,0,3,0,NA
"Tibetia","Fabaceae","Fabales",0,0,0,6,0,NA
"Tibetoseris","Asteraceae","Asterales",0,0,0,1,0,NA
"Tibouchina","Melastomataceae","Myrtales",5,0,1,234,6,0.833333333333333
"Tibouchinopsis","Melastomataceae","Myrtales",0,0,0,2,0,NA
"Ticodendron","Ticodendraceae","Fagales",1,0,0,1,1,1
"Ticorea","Rutaceae","Sapindales",0,0,0,5,0,NA
"Tidestromia","Amaranthaceae","Caryophyllales",0,0,1,6,1,0
"Tiedemannia","Apiaceae","Apiales",0,0,0,1,0,NA
"Tieghemella","Sapotaceae","Ericales",2,0,0,2,2,1
"Tietkensia","Asteraceae","Asterales",0,0,0,1,0,NA
"Tigridia","Iridaceae","Asparagales",0,0,32,53,32,0
"Tigridiopalma","Melastomataceae","Myrtales",0,0,0,1,0,NA
"Tilesia","Asteraceae","Asterales",0,0,0,3,0,NA
"Tilia","Malvaceae","Malvales",15,0,0,46,15,1
"Tiliacora","Menispermaceae","Ranunculales",2,0,0,24,2,1
"Tilingia","Apiaceae","Apiales",0,0,1,2,1,0
"Tillaea","Crassulaceae","Saxifragales",0,0,0,3,0,NA
"Tillandsia","Bromeliaceae","Poales",0,0,66,693,66,0
"Timonius","Rubiaceae","Gentianales",6,0,0,182,6,1
"Tina","Sapindaceae","Sapindales",1,0,0,20,1,1
"Tinadendron","Rubiaceae","Gentianales",0,0,0,2,0,NA
"Tinantia","Commelinaceae","Commelinales",0,0,2,13,2,0
"Tinguarra","Apiaceae","Apiales",0,0,0,1,0,NA
"Tingulonga","Burseraceae","Sapindales",0,0,0,2,0,NA
"Tinnea","Lamiaceae","Lamiales",1,0,0,19,1,1
"Tinomiscium","Menispermaceae","Ranunculales",0,0,0,1,0,NA
"Tinospora","Menispermaceae","Ranunculales",0,3,0,13,0,NA
"Tintinabulum","Polemoniaceae","Ericales",0,0,0,1,0,NA
"Tintinnabularia","Apocynaceae","Gentianales",0,2,0,3,0,NA
"Tipuana","Fabaceae","Fabales",1,0,0,1,1,1
"Tipularia","Orchidaceae","Asparagales",0,0,1,7,1,0
"Tiputinia","Burmanniaceae","Dioscoreales",0,0,0,1,0,NA
"Tiquilia","Boraginaceae","UnknownOrder-Boraginaceae",4,5,1,28,5,0.8
"Tirpitzia","Linaceae","Malpighiales",0,0,0,2,0,NA
"Tisonia","Salicaceae","Malpighiales",0,0,0,12,0,NA
"Tissa","Caryophyllaceae","Caryophyllales",0,0,0,2,0,NA
"Titanopsis","Aizoaceae","Caryophyllales",0,0,0,6,0,NA
"Titanotrichum","Gesneriaceae","Lamiales",0,0,1,1,1,0
"Tithonia","Asteraceae","Asterales",0,0,1,21,1,0
"Tittmannia","Bruniaceae","Bruniales",1,0,0,1,1,1
"Tium","Fabaceae","Fabales",0,0,0,1,0,NA
"Tmesipteris","Psilotaceae","Psilotales",0,0,1,1,1,0
"Tobagoa","Rubiaceae","Gentianales",0,0,0,1,0,NA
"Tocantinia","Amaryllidaceae","Asparagales",0,0,0,1,0,NA
"Tococa","Melastomataceae","Myrtales",4,0,0,48,4,1
"Tocoyena","Rubiaceae","Gentianales",3,0,0,19,3,1
"Todaroa","Apiaceae","Apiales",0,0,0,1,0,NA
"Toddalia","Rutaceae","Sapindales",1,0,0,1,1,1
"Toddaliopsis","Rutaceae","Sapindales",0,0,0,1,0,NA
"Todea","Osmundaceae","Osmundales",0,0,1,1,1,0
"Toechima","Sapindaceae","Sapindales",1,0,0,1,1,1
"Tofieldia","Tofieldiaceae","Alismatales",0,0,7,13,7,0
"Toiyabea","Asteraceae","Asterales",0,0,0,1,0,NA
"Tolbonia","Asteraceae","Asterales",0,0,0,1,0,NA
"Toliara","Poaceae","Poales",0,0,0,1,0,NA
"Tolmachevia","Crassulaceae","Saxifragales",0,0,0,1,0,NA
"Tolmiea","Saxifragaceae","Saxifragales",0,0,1,1,1,0
"Tolpis","Asteraceae","Asterales",0,0,7,23,7,0
"Tolumnia","Orchidaceae","Asparagales",0,0,4,31,4,0
"Tolypanthus","Loranthaceae","Santalales",0,0,0,2,0,NA
"Tomentaurum","Asteraceae","Asterales",0,0,0,2,0,NA
"Tomophyllum","Polypodiaceae","Polypodiales",0,0,0,23,0,NA
"Tomzanonia","Orchidaceae","Asparagales",0,0,0,1,0,NA
"Tonduzia","Apocynaceae","Gentianales",1,0,0,2,1,1
"Tonella","Plantaginaceae","Lamiales",0,0,0,2,0,NA
"Tonestus","Asteraceae","Asterales",0,0,0,4,0,NA
"Tongoloa","Apiaceae","Apiales",0,0,1,16,1,0
"Tonina","Eriocaulaceae","Poales",0,0,1,1,1,0
"Tontelea","Celastraceae","Celastrales",1,0,0,25,1,1
"Toona","Meliaceae","Sapindales",4,0,0,5,4,1
"Topobea","Melastomataceae","Myrtales",1,0,0,49,1,1
"Toppingia","Thelypteridaceae","Polypodiales",0,0,0,1,0,NA
"Tordyliopsis","Apiaceae","Apiales",0,0,0,1,0,NA
"Tordylium","Apiaceae","Apiales",0,0,1,6,1,0
"Torenia","Linderniaceae","Lamiales",0,0,5,14,5,0
"Toricellia","Cornaceae","Cornales",0,0,0,2,0,NA
"Torilis","Apiaceae","Apiales",0,0,3,8,3,0
"Toronia","Proteaceae","Proteales",1,0,0,1,1,1
"Torralbasia","Celastraceae","Celastrales",0,0,0,1,0,NA
"Torreya","Taxaceae","Cupressales",2,0,0,6,2,1
"Torreycactus","Cactaceae","Caryophyllales",0,0,0,1,0,NA
"Torreyochloa","Poaceae","Poales",0,0,0,5,0,NA
"Torrubia","Nyctaginaceae","Caryophyllales",0,0,0,4,0,NA
"Tortuella","Rubiaceae","Gentianales",0,0,0,1,0,NA
"Torularia","Brassicaceae","Brassicales",0,0,0,2,0,NA
"Tostimontia","Asteraceae","Asterales",0,0,0,1,0,NA
"Toubaouate","Fabaceae","Fabales",0,0,0,1,0,NA
"Touchardia","Urticaceae","Rosales",0,0,0,1,0,NA
"Toulicia","Sapindaceae","Sapindales",5,0,0,14,5,1
"Tounatea","Fabaceae","Fabales",0,0,0,4,0,NA
"Tournaya","Fabaceae","Fabales",0,0,0,1,0,NA
"Tournefortia","Boraginaceae","UnknownOrder-Boraginaceae",8,0,4,96,12,0.666666666666667
"Tourneuxia","Asteraceae","Asterales",0,0,0,1,0,NA
"Tournonia","Basellaceae","Caryophyllales",0,0,0,1,0,NA
"Touroulia","Ochnaceae","Malpighiales",1,0,0,2,1,1
"Tourrettia","Bignoniaceae","Lamiales",0,0,0,1,0,NA
"Toussaintia","Annonaceae","Magnoliales",1,0,0,4,1,1
"Touterea","Loasaceae","Cornales",0,0,0,1,0,NA
"Tovaria","Tovariaceae","Brassicales",0,0,1,2,1,0
"Tovarochloa","Poaceae","Poales",0,0,0,1,0,NA
"Tovomita","Clusiaceae","Malpighiales",10,0,0,56,10,1
"Tovomitidium","Clusiaceae","Malpighiales",0,0,0,1,0,NA
"Tovomitopsis","Clusiaceae","Malpighiales",2,0,0,6,2,1
"Townsendia","Asteraceae","Asterales",0,0,0,26,0,NA
"Townsonia","Orchidaceae","Asparagales",0,0,0,2,0,NA
"Toxicodendron","Anacardiaceae","Sapindales",9,1,0,30,9,1
"Toxicoscordion","Melanthiaceae","Liliales",0,0,3,8,3,0
"Toxocarpus","Apocynaceae","Gentianales",1,0,0,11,1,1
"Toxosiphon","Rutaceae","Sapindales",1,0,0,4,1,1
"Toxylon","Moraceae","Rosales",0,0,0,1,0,NA
"Tozzia","Orobanchaceae","Lamiales",0,0,0,1,0,NA
"Trachelium","Campanulaceae","Asterales",1,0,0,3,1,1
"Trachelospermum","Apocynaceae","Gentianales",1,2,0,11,1,1
"Trachodes","Asteraceae","Asterales",0,0,0,1,0,NA
"Trachyandra","Xanthorrhoeaceae","Asparagales",0,0,9,57,9,0
"Trachycarpus","Arecaceae","Arecales",1,0,0,9,1,1
"Trachydium","Apiaceae","Apiales",0,0,0,7,0,NA
"Trachymene","Araliaceae","Apiales",0,0,1,3,1,0
"Trachyphrynium","Marantaceae","Zingiberales",0,0,1,1,1,0
"Trachypogon","Poaceae","Poales",0,0,1,5,1,0
"Trachypteris","Pteridaceae","Polypodiales",0,0,0,4,0,NA
"Trachys","Poaceae","Poales",0,0,0,2,0,NA
"Trachysciadium","Apiaceae","Apiales",0,0,0,1,0,NA
"Trachysperma","Gentianaceae","Gentianales",0,0,0,3,0,NA
"Trachyspermum","Apiaceae","Apiales",0,0,0,5,0,NA
"Trachystemon","Boraginaceae","UnknownOrder-Boraginaceae",0,0,0,1,0,NA
"Trachystigma","Gesneriaceae","Lamiales",0,0,0,1,0,NA
"Trachystoma","Brassicaceae","Brassicales",0,0,0,3,0,NA
"Trachystylis","Cyperaceae","Poales",0,0,1,1,1,0
"Tracyina","Asteraceae","Asterales",0,0,0,1,0,NA
"Tradescantia","Commelinaceae","Commelinales",0,0,15,75,15,0
"Tragacantha","Fabaceae","Fabales",0,0,0,96,0,NA
"Traganopsis","Amaranthaceae","Caryophyllales",0,0,0,1,0,NA
"Traganum","Amaranthaceae","Caryophyllales",1,0,0,2,1,1
"Tragia","Euphorbiaceae","Malpighiales",0,0,3,152,3,0
"Tragiella","Euphorbiaceae","Malpighiales",0,1,0,4,0,NA
"Tragopogon","Asteraceae","Asterales",0,0,4,141,4,0
"Tragus","Poaceae","Poales",0,0,3,8,3,0
"Trailliaedoxa","Rubiaceae","Gentianales",0,0,0,1,0,NA
"Trapa","Lythraceae","Myrtales",0,0,0,6,0,NA
"Trapella","Pedaliaceae","Lamiales",0,0,0,1,0,NA
"Trattinnickia","Burseraceae","Sapindales",9,0,0,12,9,1
"Traubia","Amaryllidaceae","Asparagales",0,0,1,1,1,0
"Traunsteinera","Orchidaceae","Asparagales",0,0,0,2,0,NA
"Trautvetteria","Ranunculaceae","Ranunculales",0,0,0,2,0,NA
"Traversia","Asteraceae","Asterales",0,0,0,1,0,NA
"Traxilisa","Dilleniaceae","Dilleniales",0,0,0,1,0,NA
"Treculia","Moraceae","Rosales",1,0,0,8,1,1
"Treichelia","Campanulaceae","Asterales",0,0,0,1,0,NA
"Trema","Cannabaceae","Rosales",9,0,0,13,9,1
"Tremacron","Gesneriaceae","Lamiales",0,0,0,3,0,NA
"Trematolobelia","Campanulaceae","Asterales",2,0,0,8,2,1
"Trembleya","Melastomataceae","Myrtales",0,0,0,9,0,NA
"Tremulina","Restionaceae","Poales",0,0,1,2,1,0
"Trepadonia","Asteraceae","Asterales",0,0,0,2,0,NA
"Trepocarpus","Apiaceae","Apiales",0,0,0,1,0,NA
"Treubella","Loranthaceae","Santalales",0,0,0,1,0,NA
"Trevesia","Araliaceae","Apiales",5,0,0,11,5,1
"Trevia","Euphorbiaceae","Malpighiales",0,0,0,1,0,NA
"Trevirana","Gesneriaceae","Lamiales",0,0,0,1,0,NA
"Trevoa","Rhamnaceae","Rosales",1,0,0,5,1,1
"Trevoria","Orchidaceae","Asparagales",0,0,1,5,1,0
"Triacis","Passifloraceae","Malpighiales",0,0,0,1,0,NA
"Triadenum","Hypericaceae","Malpighiales",1,0,0,8,1,1
"Triadica","Euphorbiaceae","Malpighiales",3,0,0,3,3,1
"Triaenophora","Plantaginaceae","Lamiales",0,0,0,2,0,NA
"Triainolepis","Rubiaceae","Gentianales",3,0,0,13,3,1
"Trianaea","Solanaceae","Solanales",0,0,0,5,0,NA
"Trianaeopiper","Piperaceae","Piperales",0,0,0,11,0,NA
"Trianoptiles","Cyperaceae","Poales",0,0,0,3,0,NA
"Triantha","Tofieldiaceae","Alismatales",0,0,4,4,4,0
"Trianthema","Aizoaceae","Caryophyllales",0,0,1,19,1,0
"Trias","Orchidaceae","Asparagales",0,0,0,14,0,NA
"Triaspis","Malpighiaceae","Malpighiales",4,0,0,15,4,1
"Tribeles","Escalloniaceae","Escalloniales",1,0,0,1,1,1
"Tribolium","Poaceae","Poales",0,0,2,15,2,0
"Tribonanthes","Haemodoraceae","Commelinales",0,0,4,6,4,0
"Tribulocarpus","Aizoaceae","Caryophyllales",0,0,0,1,0,NA
"Tribulus","Zygophyllaceae","Zygophyllales",0,0,2,12,2,0
"Tricalysia","Rubiaceae","Gentianales",9,0,0,79,9,1
"Tricardia","Boraginaceae","UnknownOrder-Boraginaceae",0,0,0,1,0,NA
"Tricarpelema","Commelinaceae","Commelinales",0,0,0,8,0,NA
"Triceratella","Commelinaceae","Commelinales",0,0,0,1,0,NA
"Triceratorhynchus","Orchidaceae","Asparagales",0,0,0,1,0,NA
"Tricerma","Celastraceae","Celastrales",0,0,0,6,0,NA
"Trichantha","Gesneriaceae","Lamiales",0,0,0,3,0,NA
"Trichanthemis","Asteraceae","Asterales",0,0,0,9,0,NA
"Trichanthera","Acanthaceae","Lamiales",1,0,0,2,1,1
"Trichanthodium","Asteraceae","Asterales",0,0,2,4,2,0
"Trichaulax","Acanthaceae","Lamiales",0,0,0,1,0,NA
"Trichilia","Meliaceae","Sapindales",72,0,0,98,72,1
"Trichiogramme","Pteridaceae","Polypodiales",0,0,0,8,0,NA
"Trichipteris","Cyatheaceae","Cyatheales",0,0,0,27,0,NA
"Trichlora","Amaryllidaceae","Asparagales",0,0,0,4,0,NA
"Trichloris","Poaceae","Poales",0,0,1,2,1,0
"Trichocaulon","Apocynaceae","Gentianales",0,0,0,28,0,NA
"Trichocentrum","Orchidaceae","Asparagales",0,0,5,65,5,0
"Trichocephalus","Rhamnaceae","Rosales",1,0,0,1,1,1
"Trichocereus","Cactaceae","Caryophyllales",0,0,0,9,0,NA
"Trichoceros","Orchidaceae","Asparagales",0,0,2,10,2,0
"Trichocladus","Hamamelidaceae","Saxifragales",2,0,0,4,2,1
"Trichocline","Asteraceae","Asterales",0,0,0,24,0,NA
"Trichocoronis","Asteraceae","Asterales",0,0,0,2,0,NA
"Trichocoryne","Asteraceae","Asterales",0,0,1,1,1,0
"Trichocyclus","Dryopteridaceae","Polypodiales",0,0,0,1,0,NA
"Trichodesma","Boraginaceae","UnknownOrder-Boraginaceae",0,0,2,17,2,0
"Trichodiadema","Aizoaceae","Caryophyllales",0,0,1,36,1,0
"Trichoglottis","Orchidaceae","Asparagales",0,0,2,69,2,0
"Trichogonia","Asteraceae","Asterales",0,0,0,33,0,NA
"Trichogoniopsis","Asteraceae","Asterales",0,0,0,4,0,NA
"Trichogyne","Asteraceae","Asterales",0,0,1,7,1,0
"Tricholaena","Poaceae","Poales",0,0,0,5,0,NA
"Tricholepidium","Polypodiaceae","Polypodiales",0,0,0,9,0,NA
"Tricholepis","Asteraceae","Asterales",0,0,0,17,0,NA
"Trichomanes","Hymenophyllaceae","Hymenophyllales",0,0,7,117,7,0
"Trichoneura","Poaceae","Poales",0,0,1,8,1,0
"Trichopetalum","Asparagaceae","Asparagales",0,0,1,2,1,0
"Trichophorum","Cyperaceae","Poales",0,0,6,12,6,0
"Trichopilia","Orchidaceae","Asparagales",0,0,2,45,2,0
"Trichopodium","Fabaceae","Fabales",0,0,0,1,0,NA
"Trichopteryx","Poaceae","Poales",0,0,0,5,0,NA
"Trichoptilium","Asteraceae","Asterales",0,0,0,1,0,NA
"Trichopus","Dioscoreaceae","Dioscoreales",0,0,1,1,1,0
"Trichosacme","Apocynaceae","Gentianales",0,0,0,1,0,NA
"Trichosalpinx","Orchidaceae","Asparagales",0,0,3,112,3,0
"Trichosanchezia","Acanthaceae","Lamiales",0,0,0,1,0,NA
"Trichosanthes","Cucurbitaceae","Cucurbitales",0,0,3,38,3,0
"Trichoschoenus","Cyperaceae","Poales",0,0,0,1,0,NA
"Trichoscypha","Anacardiaceae","Sapindales",8,0,0,23,8,1
"Trichospermum","Malvaceae","Malvales",3,0,0,4,3,1
"Trichospira","Asteraceae","Asterales",0,0,0,1,0,NA
"Trichostachys","Rubiaceae","Gentianales",0,0,0,14,0,NA
"Trichostema","Lamiaceae","Lamiales",4,0,10,18,14,0.285714285714286
"Trichostephanus","Salicaceae","Malpighiales",0,0,0,1,0,NA
"Trichostigma","Phytolaccaceae","Caryophyllales",1,0,0,3,1,1
"Trichotolinum","Brassicaceae","Brassicales",0,0,0,1,0,NA
"Trichotosia","Orchidaceae","Asparagales",0,0,1,78,1,0
"Trichouratea","Ochnaceae","Malpighiales",0,0,0,2,0,NA
"Trichuriella","Amaranthaceae","Caryophyllales",0,0,0,1,0,NA
"Tricliceras","Passifloraceae","Malpighiales",0,0,0,11,0,NA
"Triclisia","Menispermaceae","Ranunculales",1,1,0,17,1,1
"Triclisperma","Polygalaceae","Fabales",0,0,0,1,0,NA
"Tricomaria","Malpighiaceae","Malpighiales",1,0,0,1,1,1
"Tricoryne","Xanthorrhoeaceae","Asparagales",0,0,3,8,3,0
"Tricostularia","Cyperaceae","Poales",0,0,2,5,2,0
"Tricyclandra","Cucurbitaceae","Cucurbitales",0,1,0,1,0,NA
"Tricyrtis","Liliaceae","Liliales",0,0,6,23,6,0
"Tridactyle","Orchidaceae","Asparagales",0,0,6,47,6,0
"Tridactylina","Asteraceae","Asterales",0,0,0,1,0,NA
"Tridax","Asteraceae","Asterales",0,0,3,29,3,0
"Tridens","Poaceae","Poales",0,0,1,17,1,0
"Tridentea","Apocynaceae","Gentianales",0,0,0,16,0,NA
"Tridesmostemon","Sapotaceae","Ericales",0,0,0,2,0,NA
"Tridimeris","Annonaceae","Magnoliales",0,0,0,2,0,NA
"Tridynamia","Convolvulaceae","Solanales",0,1,0,2,0,NA
"Trieenea","Scrophulariaceae","Lamiales",0,0,1,3,1,0
"Trientalis","Primulaceae","Ericales",0,0,1,3,1,0
"Trifidacanthus","Fabaceae","Fabales",0,0,0,1,0,NA
"Triflorensia","Rubiaceae","Gentianales",0,0,0,3,0,NA
"Trifolium","Fabaceae","Fabales",0,0,33,244,33,0
"Triglochin","Juncaginaceae","Alismatales",0,0,10,25,10,0
"Trigonella","Fabaceae","Fabales",0,0,13,95,13,0
"Trigonia","Trigoniaceae","Malpighiales",4,0,0,30,4,1
"Trigonidium","Orchidaceae","Asparagales",0,0,6,13,6,0
"Trigoniodendron","Trigoniaceae","Malpighiales",0,0,0,1,0,NA
"Trigonobalanus","Fagaceae","Fagales",1,0,0,3,1,1
"Trigonocapnos","Papaveraceae","Ranunculales",0,0,0,2,0,NA
"Trigonophyllum","Hymenophyllaceae","Hymenophyllales",0,0,0,2,0,NA
"Trigonopleura","Peraceae","Malpighiales",1,0,0,3,1,1
"Trigonopterum","Asteraceae","Asterales",0,0,0,1,0,NA
"Trigonopyren","Rubiaceae","Gentianales",0,0,0,9,0,NA
"Trigonosciadium","Apiaceae","Apiales",0,0,0,2,0,NA
"Trigonospermum","Asteraceae","Asterales",0,0,1,6,1,0
"Trigonospora","Thelypteridaceae","Polypodiales",0,0,0,2,0,NA
"Trigonostemon","Euphorbiaceae","Malpighiales",1,0,0,84,1,1
"Trigonotis","Boraginaceae","UnknownOrder-Boraginaceae",0,0,1,46,1,0
"Triguera","Solanaceae","Solanales",0,0,0,3,0,NA
"Trigynaea","Annonaceae","Magnoliales",3,0,0,8,3,1
"Trihesperus","Asparagaceae","Asparagales",0,0,0,2,0,NA
"Trilepidea","Loranthaceae","Santalales",1,0,0,1,1,1
"Trilepis","Cyperaceae","Poales",0,0,1,5,1,0
"Trilepisium","Moraceae","Rosales",1,0,0,1,1,1
"Trilisa","Asteraceae","Asterales",0,0,1,2,1,0
"Trillesanthus","Dipterocarpaceae","Malvales",0,0,0,1,0,NA
"Trillium","Melanthiaceae","Liliales",0,0,40,50,40,0
"Trilobachne","Poaceae","Poales",0,0,0,1,0,NA
"Trimeria","Salicaceae","Malpighiales",0,0,0,2,0,NA
"Trimerocalyx","Plantaginaceae","Lamiales",0,0,0,1,0,NA
"Trimezia","Iridaceae","Asparagales",0,0,15,27,15,0
"Trinia","Apiaceae","Apiales",0,0,1,10,1,0
"Triniochloa","Poaceae","Poales",0,0,0,6,0,NA
"Triniteurybia","Asteraceae","Asterales",0,0,0,1,0,NA
"Triodanis","Campanulaceae","Asterales",0,0,1,6,1,0
"Triodia","Poaceae","Poales",0,0,5,68,5,0
"Triodoglossum","Apocynaceae","Gentianales",0,0,0,1,0,NA
"Triolena","Melastomataceae","Myrtales",0,1,0,20,0,NA
"Trioncinia","Asteraceae","Asterales",0,0,0,1,0,NA
"Triopterys","Malpighiaceae","Malpighiales",0,0,0,1,0,NA
"Triosteum","Caprifoliaceae","Dipsacales",1,0,1,5,2,0.5
"Triphasia","Rutaceae","Sapindales",0,0,0,1,0,NA
"Triphlebia","Aspleniaceae","Polypodiales",0,0,0,1,0,NA
"Triphora","Orchidaceae","Asparagales",0,0,1,18,1,0
"Triphyophyllum","Dioncophyllaceae","Caryophyllales",0,0,0,1,0,NA
"Triphysaria","Orobanchaceae","Lamiales",0,0,1,6,1,0
"Triplachne","Poaceae","Poales",0,0,0,1,0,NA
"Tripladenia","Colchicaceae","Liliales",0,0,1,1,1,0
"Triplarina","Myrtaceae","Myrtales",4,0,0,7,4,1
"Triplaris","Polygonaceae","Caryophyllales",8,0,0,19,8,1
"Triplasis","Poaceae","Poales",0,0,1,2,1,0
"Tripleurospermum","Asteraceae","Asterales",0,0,2,38,2,0
"Triplisomeris","Fabaceae","Fabales",0,0,0,4,0,NA
"Triplocephalum","Asteraceae","Asterales",0,0,0,1,0,NA
"Triplochiton","Malvaceae","Malvales",2,0,0,2,2,1
"Triplophyllum","Tectariaceae","Polypodiales",0,0,3,18,3,0
"Triplopogon","Poaceae","Poales",0,0,0,1,0,NA
"Triplosperma","Apocynaceae","Gentianales",0,0,0,1,0,NA
"Triplostegia","Caprifoliaceae","Dipsacales",0,0,2,2,2,0
"Triplotaxis","Asteraceae","Asterales",0,0,0,1,0,NA
"Tripodanthus","Loranthaceae","Santalales",0,0,0,2,0,NA
"Tripodion","Fabaceae","Fabales",0,0,1,1,1,0
"Tripogandra","Commelinaceae","Commelinales",0,0,1,22,1,0
"Tripogon","Poaceae","Poales",0,0,1,46,1,0
"Tripolium","Asteraceae","Asterales",0,0,0,2,0,NA
"Tripora","Lamiaceae","Lamiales",0,0,0,1,0,NA
"Tripsacum","Poaceae","Poales",0,0,1,14,1,0
"Tripteris","Asteraceae","Asterales",0,0,0,20,0,NA
"Tripterocalyx","Nyctaginaceae","Caryophyllales",0,0,0,1,0,NA
"Tripterodendron","Sapindaceae","Sapindales",0,0,0,1,0,NA
"Tripterospermum","Gentianaceae","Gentianales",0,0,0,21,0,NA
"Tripterygium","Celastraceae","Celastrales",0,0,0,1,0,NA
"Triptilion","Asteraceae","Asterales",0,0,0,7,0,NA
"Triptilium","Asteraceae","Asterales",0,0,0,1,0,NA
"Triptilodiscus","Asteraceae","Asterales",0,0,1,1,1,0
"Triraphis","Poaceae","Poales",0,0,1,8,1,0
"Triscenia","Poaceae","Poales",0,0,0,1,0,NA
"Trischidium","Fabaceae","Fabales",0,0,0,5,0,NA
"Trisepalum","Gesneriaceae","Lamiales",0,0,0,2,0,NA
"Trisetaria","Poaceae","Poales",0,0,0,17,0,NA
"Trisetella","Orchidaceae","Asparagales",0,0,1,23,1,0
"Trisetokoeleria","Poaceae","Poales",0,0,0,3,0,NA
"Trisetum","Poaceae","Poales",0,0,12,87,12,0
"Tristachya","Poaceae","Poales",0,0,2,20,2,0
"Tristagma","Amaryllidaceae","Asparagales",0,0,1,31,1,0
"Tristania","Myrtaceae","Myrtales",1,0,0,1,1,1
"Tristaniopsis","Myrtaceae","Myrtales",23,0,0,40,23,1
"Tristellateia","Malpighiaceae","Malpighiales",4,0,0,21,4,1
"Tristemma","Melastomataceae","Myrtales",0,1,0,11,0,NA
"Tristemonanthus","Celastraceae","Celastrales",0,0,0,2,0,NA
"Tristerix","Loranthaceae","Santalales",2,0,0,11,2,1
"Tristicha","Podostemaceae","Malpighiales",0,0,1,2,1,0
"Triteleia","Asparagaceae","Asparagales",0,0,10,16,10,0
"Triteleiopsis","Asparagaceae","Asparagales",0,0,0,1,0,NA
"Trithrinax","Arecaceae","Arecales",4,0,0,4,4,1
"Trithuria","Hydatellaceae","Nymphaeales",0,0,2,12,2,0
"Triticale","Poaceae","Poales",0,0,0,1,0,NA
"Triticosecale","Poaceae","Poales",0,0,0,4,0,NA
"Triticum","Poaceae","Poales",0,0,1,28,1,0
"Trititrigia","Poaceae","Poales",0,0,0,1,0,NA
"Tritonia","Iridaceae","Asparagales",0,0,5,26,5,0
"Tritoniopsis","Iridaceae","Asparagales",0,0,5,23,5,0
"Triumfetta","Malvaceae","Malvales",3,0,1,102,4,0.75
"Triunia","Proteaceae","Proteales",0,0,0,1,0,NA
"Triuridopsis","Triuridaceae","Pandanales",0,0,0,2,0,NA
"Triuris","Triuridaceae","Pandanales",0,0,0,4,0,NA
"Trivalvaria","Annonaceae","Magnoliales",1,0,0,4,1,1
"Trixis","Asteraceae","Asterales",1,0,0,42,1,1
"Trizeuxis","Orchidaceae","Asparagales",0,0,0,1,0,NA
"Trochetia","Malvaceae","Malvales",0,0,0,1,0,NA
"Trochetiopsis","Malvaceae","Malvales",1,0,0,2,1,1
"Trochiscanthes","Apiaceae","Apiales",0,0,0,1,0,NA
"Trochocarpa","Ericaceae","Ericales",1,0,0,1,1,1
"Trochodendron","Trochodendraceae","Trochodendrales",1,0,0,1,1,1
"Trochomeria","Cucurbitaceae","Cucurbitales",0,1,0,8,0,NA
"Trochomeriopsis","Cucurbitaceae","Cucurbitales",0,1,0,1,0,NA
"Troglophyton","Asteraceae","Asterales",0,0,0,6,0,NA
"Trogostolon","Davalliaceae","Polypodiales",0,0,0,2,0,NA
"Trollius","Ranunculaceae","Ranunculales",0,0,7,29,7,0
"Tromotriche","Apocynaceae","Gentianales",0,0,0,10,0,NA
"Tropaeolum","Tropaeolaceae","Brassicales",0,0,15,88,15,0
"Trophaeum","Tropaeolaceae","Brassicales",0,0,0,1,0,NA
"Trophis","Moraceae","Rosales",4,0,0,9,4,1
"Tropidia","Orchidaceae","Asparagales",0,0,1,32,1,0
"Tropidocarpum","Brassicaceae","Brassicales",0,0,0,4,0,NA
"Tropidococcus","Malvaceae","Malvales",0,0,0,1,0,NA
"Troximon","Asteraceae","Asterales",0,0,0,6,0,NA
"Trungboa","Plantaginaceae","Lamiales",0,0,0,1,0,NA
"Trymalium","Rhamnaceae","Rosales",0,0,0,5,0,NA
"Trymatococcus","Moraceae","Rosales",2,0,0,2,2,1
"Tryssophyton","Melastomataceae","Myrtales",0,0,0,1,0,NA
"Tsebona","Sapotaceae","Ericales",0,0,0,1,0,NA
"Tsingya","Sapindaceae","Sapindales",0,0,0,1,0,NA
"Tsoala","Solanaceae","Solanales",0,0,0,1,0,NA
"Tsuga","Pinaceae","Pinales",6,0,0,10,6,1
"Tuberaria","Cistaceae","Malvales",0,0,1,12,1,0
"Tuberculocarpus","Asteraceae","Asterales",0,0,0,1,0,NA
"Tuberolabium","Orchidaceae","Asparagales",0,0,0,18,0,NA
"Tuberostylis","Asteraceae","Asterales",0,0,0,2,0,NA
"Tubocapsicum","Solanaceae","Solanales",0,0,0,2,0,NA
"Tuchiroa","Fabaceae","Fabales",0,0,0,2,0,NA
"Tuctoria","Poaceae","Poales",0,0,1,3,1,0
"Tugarinovia","Asteraceae","Asterales",0,0,0,1,0,NA
"Tulasneantha","Podostemaceae","Malpighiales",0,0,0,1,0,NA
"Tulbaghia","Amaryllidaceae","Asparagales",0,0,5,26,5,0
"Tulipa","Liliaceae","Liliales",0,0,24,113,24,0
"Tumamoca","Cucurbitaceae","Cucurbitales",0,0,1,2,1,0
"Tunatea","Fabaceae","Fabales",0,0,0,13,0,NA
"Tunilla","Cactaceae","Caryophyllales",0,0,0,2,0,NA
"Tupeia","Loranthaceae","Santalales",1,0,0,1,1,1
"Tupistra","Asparagaceae","Asparagales",0,0,1,20,1,0
"Turaniphytum","Asteraceae","Asterales",0,0,0,2,0,NA
"Turbina","Convolvulaceae","Solanales",1,0,2,13,3,0.333333333333333
"Turbinicarpus","Cactaceae","Caryophyllales",0,0,0,22,0,NA
"Turczaninowia","Asteraceae","Asterales",0,0,0,1,0,NA
"Turgenia","Apiaceae","Apiales",0,0,0,1,0,NA
"Turnera","Passifloraceae","Malpighiales",2,0,2,126,4,0.5
"Turpinia","Staphyleaceae","Crossosomatales",5,0,0,17,5,1
"Turraea","Meliaceae","Sapindales",10,0,0,48,10,1
"Turraeanthus","Meliaceae","Sapindales",1,0,0,3,1,1
"Turricula","Boraginaceae","UnknownOrder-Boraginaceae",1,0,0,1,1,1
"Turrillia","Proteaceae","Proteales",0,0,0,2,0,NA
"Turrita","Brassicaceae","Brassicales",0,0,0,1,0,NA
"Turritis","Brassicaceae","Brassicales",0,0,2,4,2,0
"Tussilago","Asteraceae","Asterales",0,0,1,1,1,0
"Tuxtla","Asteraceae","Asterales",1,0,0,1,1,1
"Tweedia","Apocynaceae","Gentianales",0,0,0,7,0,NA
"Tylecodon","Crassulaceae","Saxifragales",0,0,0,6,0,NA
"Tyleria","Ochnaceae","Malpighiales",0,0,0,14,0,NA
"Tyleropappus","Asteraceae","Asterales",0,0,0,1,0,NA
"Tylophora","Apocynaceae","Gentianales",0,1,0,88,0,NA
"Tylophoropsis","Apocynaceae","Gentianales",0,0,0,2,0,NA
"Tylopsacas","Gesneriaceae","Lamiales",0,0,0,1,0,NA
"Tylosema","Fabaceae","Fabales",0,1,0,4,0,NA
"Tylostigma","Orchidaceae","Asparagales",0,0,0,8,0,NA
"Tynanthus","Bignoniaceae","Lamiales",5,0,0,15,5,1
"Typha","Typhaceae","Poales",0,0,10,38,10,0
"Typhalea","Malvaceae","Malvales",0,0,0,1,0,NA
"Typhonium","Araceae","Alismatales",0,0,2,68,2,0
"Typhonodorum","Araceae","Alismatales",0,0,0,1,0,NA
"Tyrbastes","Restionaceae","Poales",0,0,1,1,1,0
"Tyrimnus","Asteraceae","Asterales",0,0,1,1,1,0
"Tysonia","Boraginaceae","UnknownOrder-Boraginaceae",0,0,0,2,0,NA
"Tytthostemma","Caryophyllaceae","Caryophyllales",0,0,0,1,0,NA
"Tzeltalia","Solanaceae","Solanales",0,0,0,3,0,NA
"Tzvelevopyrethrum","Asteraceae","Asterales",0,0,0,1,0,NA
"Uapaca","Phyllanthaceae","Malpighiales",13,0,0,46,13,1
"Uebelinia","Caryophyllaceae","Caryophyllales",0,0,0,6,0,NA
"Uebelmannia","Cactaceae","Caryophyllales",0,0,0,3,0,NA
"Uechtritzia","Asteraceae","Asterales",0,0,0,3,0,NA
"Ugamia","Asteraceae","Asterales",0,0,0,1,0,NA
"Ugni","Myrtaceae","Myrtales",2,0,0,4,2,1
"Uittienia","Fabaceae","Fabales",1,0,0,1,1,1
"Uladendron","Malvaceae","Malvales",1,0,0,1,1,1
"Uleanthus","Fabaceae","Fabales",0,0,0,1,0,NA
"Ulearum","Araceae","Alismatales",0,0,0,2,0,NA
"Uleiorchis","Orchidaceae","Asparagales",0,0,0,2,0,NA
"Ulex","Fabaceae","Fabales",3,0,0,13,3,1
"Ullucus","Basellaceae","Caryophyllales",0,1,0,1,0,NA
"Ulmus","Ulmaceae","Rosales",24,0,0,40,24,1
"Umbellularia","Lauraceae","Laurales",1,0,0,1,1,1
"Umbilicus","Crassulaceae","Saxifragales",0,0,1,10,1,0
"Umtiza","Fabaceae","Fabales",0,0,0,1,0,NA
"Uncaria","Rubiaceae","Gentianales",4,1,0,40,4,1
"Uncarina","Pedaliaceae","Lamiales",2,0,0,11,2,1
"Uncifera","Orchidaceae","Asparagales",0,0,0,6,0,NA
"Uncinia","Cyperaceae","Poales",0,0,29,70,29,0
"Ungernia","Amaryllidaceae","Asparagales",0,0,2,10,2,0
"Ungnadia","Sapindaceae","Sapindales",1,0,0,1,1,1
"Ungulipetalum","Menispermaceae","Ranunculales",0,0,0,1,0,NA
"Unigenes","Campanulaceae","Asterales",0,0,0,1,0,NA
"Uniola","Poaceae","Poales",0,0,1,5,1,0
"Unona","Annonaceae","Magnoliales",0,0,0,1,0,NA
"Unonopsis","Annonaceae","Magnoliales",17,0,0,48,17,1
"Unxia","Asteraceae","Asterales",0,0,0,2,0,NA
"Urananthus","Gentianaceae","Gentianales",0,0,0,1,0,NA
"Uranthoecium","Poaceae","Poales",0,0,0,1,0,NA
"Uraria","Fabaceae","Fabales",0,0,1,25,1,0
"Urariopsis","Fabaceae","Fabales",0,0,0,2,0,NA
"Uraspermum","Apiaceae","Apiales",0,0,0,1,0,NA
"Urbananthus","Asteraceae","Asterales",0,0,0,2,0,NA
"Urbanisol","Asteraceae","Asterales",0,0,0,1,0,NA
"Urbanodendron","Lauraceae","Laurales",1,0,0,3,1,1
"Urbinella","Asteraceae","Asterales",0,0,0,1,0,NA
"Urceocharis","Amaryllidaceae","Asparagales",0,0,0,1,0,NA
"Urceola","Apocynaceae","Gentianales",0,4,0,17,0,NA
"Urceolina","Amaryllidaceae","Asparagales",0,0,0,7,0,NA
"Urelytrum","Poaceae","Poales",0,0,0,7,0,NA
"Urena","Malvaceae","Malvales",1,0,0,10,1,1
"Urera","Urticaceae","Rosales",5,0,0,43,5,1
"Urginea","Asparagaceae","Asparagales",0,0,0,4,0,NA
"Uribea","Fabaceae","Fabales",1,0,0,1,1,1
"Urmenetea","Asteraceae","Asterales",0,0,0,1,0,NA
"Urobotrya","Opiliaceae","Santalales",0,0,0,7,0,NA
"Urocarpidium","Malvaceae","Malvales",0,0,0,6,0,NA
"Urochlaena","Poaceae","Poales",0,0,0,1,0,NA
"Urochloa","Poaceae","Poales",0,0,2,17,2,0
"Urochondra","Poaceae","Poales",0,0,0,1,0,NA
"Urodon","Fabaceae","Fabales",0,0,0,2,0,NA
"Urogentias","Gentianaceae","Gentianales",0,0,0,1,0,NA
"Urolepis","Asteraceae","Asterales",0,0,0,1,0,NA
"Uromyrtus","Myrtaceae","Myrtales",2,0,0,23,2,1
"Uropappus","Asteraceae","Asterales",0,0,1,3,1,0
"Urophyllum","Rubiaceae","Gentianales",5,0,0,119,5,1
"Urophysa","Ranunculaceae","Ranunculales",0,0,0,2,0,NA
"Uroskinnera","Plantaginaceae","Lamiales",0,0,0,4,0,NA
"Urospatha","Araceae","Alismatales",0,0,0,11,0,NA
"Urospermum","Asteraceae","Asterales",0,0,2,2,2,0
"Urostachys","Lycopodiaceae","Lycopodiales",0,0,27,30,27,0
"Ursinia","Asteraceae","Asterales",0,0,1,42,1,0
"Urtica","Urticaceae","Rosales",0,0,4,53,4,0
"Urticastrum","Urticaceae","Rosales",0,0,0,5,0,NA
"Urvillea","Sapindaceae","Sapindales",2,0,0,13,2,1
"Usteria","Loganiaceae","Gentianales",1,0,0,1,1,1
"Utania","Loganiaceae","Gentianales",0,0,0,1,0,NA
"Utleya","Ericaceae","Ericales",0,0,0,1,0,NA
"Utricularia","Lentibulariaceae","Lamiales",0,0,13,218,13,0
"Utsetela","Moraceae","Rosales",0,0,0,2,0,NA
"Uva-ursi","Ericaceae","Ericales",0,0,0,2,0,NA
"Uvaria","Annonaceae","Magnoliales",16,0,0,113,16,1
"Uvariastrum","Annonaceae","Magnoliales",2,0,0,8,2,1
"Uvariodendron","Annonaceae","Magnoliales",1,0,0,14,1,1
"Uvariopsis","Annonaceae","Magnoliales",1,0,0,16,1,1
"Uvularia","Colchicaceae","Liliales",0,0,5,5,5,0
"Vaccaria","Caryophyllaceae","Caryophyllales",0,0,1,1,1,0
"Vaccinium","Ericaceae","Ericales",57,0,0,223,57,1
"Vachellia","Fabaceae","Fabales",1,0,0,32,1,1
"Vagaria","Amaryllidaceae","Asparagales",0,0,2,2,2,0
"Vaginopteris","Pteridaceae","Polypodiales",0,0,0,1,0,NA
"Vaginularia","Pteridaceae","Polypodiales",0,0,0,1,0,NA
"Vahadenia","Apocynaceae","Gentianales",0,1,0,2,0,NA
"Vahlia","Vahliaceae","UnknownOrder-Vahliaceae",0,0,1,5,1,0
"Valantia","Rubiaceae","Gentianales",0,0,2,7,2,0
"Valdivia","Escalloniaceae","Escalloniales",1,0,0,1,1,1
"Valeriana","Caprifoliaceae","Dipsacales",3,0,22,289,25,0.12
"Valerianella","Caprifoliaceae","Dipsacales",0,0,1,45,1,0
"Valiha","Poaceae","Poales",0,0,0,2,0,NA
"Vallariopsis","Apocynaceae","Gentianales",0,0,0,1,0,NA
"Vallaris","Apocynaceae","Gentianales",1,0,0,3,1,1
"Vallea","Elaeocarpaceae","Oxalidales",1,0,0,2,1,1
"Vallesia","Apocynaceae","Gentianales",2,0,0,12,2,1
"Vallisneria","Hydrocharitaceae","Alismatales",0,0,4,14,4,0
"Van-royena","Sapotaceae","Ericales",1,0,0,1,1,1
"Vanasushava","Apiaceae","Apiales",0,0,0,1,0,NA
"Vancouveria","Berberidaceae","Ranunculales",0,0,2,3,2,0
"Vanda","Orchidaceae","Asparagales",0,0,2,60,2,0
"Vandasina","Fabaceae","Fabales",0,0,0,1,0,NA
"Vandellia","Linderniaceae","Lamiales",0,0,0,1,0,NA
"Vandenboschia","Hymenophyllaceae","Hymenophyllales",0,0,0,6,0,NA
"Vandopsis","Orchidaceae","Asparagales",0,0,1,4,1,0
"Vangueria","Rubiaceae","Gentianales",11,0,0,55,11,1
"Vangueriella","Rubiaceae","Gentianales",1,0,0,18,1,1
"Vangueriopsis","Rubiaceae","Gentianales",1,0,0,5,1,1
"Vanheerdea","Aizoaceae","Caryophyllales",0,0,0,1,0,NA
"Vanhouttea","Gesneriaceae","Lamiales",1,0,0,9,1,1
"Vania","Brassicaceae","Brassicales",0,0,0,1,0,NA
"Vanieria","Moraceae","Rosales",0,0,0,1,0,NA
"Vanilla","Orchidaceae","Asparagales",0,0,6,106,6,0
"Vanoverberghia","Zingiberaceae","Zingiberales",0,0,0,2,0,NA
"Vanroyenella","Podostemaceae","Malpighiales",0,0,1,1,1,0
"Vantanea","Humiriaceae","Malpighiales",9,0,0,20,9,1
"Vanwykia","Loranthaceae","Santalales",0,0,0,2,0,NA
"Vanzijlia","Aizoaceae","Caryophyllales",0,0,0,1,0,NA
"Vargasiella","Orchidaceae","Asparagales",0,0,0,2,0,NA
"Varilla","Asteraceae","Asterales",1,0,0,2,1,1
"Varronia","Boraginaceae","UnknownOrder-Boraginaceae",0,0,0,14,0,NA
"Varthemia","Asteraceae","Asterales",0,0,0,3,0,NA
"Vasconcellea","Caricaceae","Brassicales",1,0,0,8,1,1
"Vaseyanthus","Cucurbitaceae","Cucurbitales",0,0,0,1,0,NA
"Vaseyochloa","Poaceae","Poales",0,0,1,1,1,0
"Vasivaea","Malvaceae","Malvales",0,0,0,2,0,NA
"Vasquezia","Asteraceae","Asterales",0,0,0,1,0,NA
"Vasqueziella","Orchidaceae","Asparagales",0,0,1,1,1,0
"Vassobia","Solanaceae","Solanales",1,0,0,3,1,1
"Vatairea","Fabaceae","Fabales",7,0,0,8,7,1
"Vataireopsis","Fabaceae","Fabales",3,0,0,4,3,1
"Vateria","Dipterocarpaceae","Malvales",1,0,0,1,1,1
"Vateriopsis","Dipterocarpaceae","Malvales",1,0,0,1,1,1
"Vatica","Dipterocarpaceae","Malvales",2,0,0,5,2,1
"Vatovaea","Fabaceae","Fabales",0,0,0,1,0,NA
"Vaughania","Fabaceae","Fabales",0,0,0,11,0,NA
"Vaupelia","Boraginaceae","UnknownOrder-Boraginaceae",0,0,0,1,0,NA
"Vaupesia","Euphorbiaceae","Malpighiales",0,0,0,1,0,NA
"Vauquelinia","Rosaceae","Rosales",2,0,0,2,2,1
"Vavara","Acanthaceae","Lamiales",0,0,0,1,0,NA
"Vavilovia","Fabaceae","Fabales",0,0,0,1,0,NA
"Veeresia","Malvaceae","Malvales",0,0,0,1,0,NA
"Veitchia","Arecaceae","Arecales",2,0,0,8,2,1
"Velezia","Caryophyllaceae","Caryophyllales",0,0,0,2,0,NA
"Vella","Brassicaceae","Brassicales",0,0,0,7,0,NA
"Vellereophyton","Asteraceae","Asterales",0,0,1,7,1,0
"Vellosiella","Orobanchaceae","Lamiales",0,0,0,2,0,NA
"Vellozia","Velloziaceae","Pandanales",0,0,0,127,0,NA
"Veltheimia","Asparagaceae","Asparagales",0,0,2,2,2,0
"Venegasia","Asteraceae","Asterales",0,0,0,1,0,NA
"Venidium","Asteraceae","Asterales",0,0,0,1,0,NA
"Ventenata","Poaceae","Poales",0,0,1,8,1,0
"Ventilago","Rhamnaceae","Rosales",0,0,0,9,0,NA
"Ventricularia","Orchidaceae","Asparagales",0,0,1,2,1,0
"Vepris","Rutaceae","Sapindales",8,0,0,83,8,1
"Veratrilla","Gentianaceae","Gentianales",0,0,0,2,0,NA
"Veratrum","Melanthiaceae","Liliales",0,0,9,27,9,0
"Verbascum","Scrophulariaceae","Lamiales",0,0,5,116,5,0
"Verbena","Verbenaceae","Lamiales",0,0,13,101,13,0
"Verbenoxylum","Verbenaceae","Lamiales",0,0,0,1,0,NA
"Verbesina","Asteraceae","Asterales",3,0,4,303,7,0.428571428571429
"Verhuellia","Piperaceae","Piperales",0,0,0,3,0,NA
"Vernicia","Euphorbiaceae","Malpighiales",1,0,0,3,1,1
"Vernonanthura","Asteraceae","Asterales",0,0,0,63,0,NA
"Vernonella","Asteraceae","Asterales",0,0,0,12,0,NA
"Vernonia","Asteraceae","Asterales",4,0,4,671,8,0.5
"Vernoniastrum","Asteraceae","Asterales",0,0,0,12,0,NA
"Vernonieae","Asteraceae","Asterales",0,0,0,32,0,NA
"Vernoniopsis","Asteraceae","Asterales",0,0,0,2,0,NA
"Veronica","Plantaginaceae","Lamiales",2,0,19,198,21,0.0952380952380952
"Veronicastrum","Plantaginaceae","Lamiales",0,0,2,15,2,0
"Verreauxia","Goodeniaceae","Asterales",0,0,0,1,0,NA
"Verrucifera","Aizoaceae","Caryophyllales",0,0,0,1,0,NA
"Verrucularia","Malpighiaceae","Malpighiales",1,0,0,2,1,1
"Verrucularina","Malpighiaceae","Malpighiales",0,0,0,2,0,NA
"Verschaffeltia","Arecaceae","Arecales",0,0,0,1,0,NA
"Verticordia","Myrtaceae","Myrtales",29,0,0,102,29,1
"Verzinum","Fabaceae","Fabales",0,0,0,1,0,NA
"Vesalea","Caprifoliaceae","Dipsacales",0,0,0,1,0,NA
"Veselskya","Brassicaceae","Brassicales",0,0,0,1,0,NA
"Vesselowskya","Cunoniaceae","Oxalidales",1,0,0,1,1,1
"Vestia","Solanaceae","Solanales",1,0,0,1,1,1
"Vexatorella","Proteaceae","Proteales",1,0,0,1,1,1
"Vexibia","Fabaceae","Fabales",0,0,0,3,0,NA
"Veyretella","Orchidaceae","Asparagales",0,0,0,2,0,NA
"Veyretia","Orchidaceae","Asparagales",0,0,0,11,0,NA
"Viburnum","Adoxaceae","Dipsacales",40,0,0,166,40,1
"Vicatia","Apiaceae","Apiales",0,0,0,4,0,NA
"Vicia","Fabaceae","Fabales",0,0,15,232,15,0
"Victoria","Nymphaeaceae","Nymphaeales",0,0,2,2,2,0
"Vidalasia","Rubiaceae","Gentianales",0,0,0,5,0,NA
"Vieraea","Asteraceae","Asterales",1,0,0,1,1,1
"Viereckia","Asteraceae","Asterales",0,0,0,1,0,NA
"Vietnamocalamus","Poaceae","Poales",0,0,0,1,0,NA
"Vietnamochloa","Poaceae","Poales",0,0,0,1,0,NA
"Vietnamosasa","Poaceae","Poales",0,0,0,3,0,NA
"Vietorchis","Orchidaceae","Asparagales",0,0,0,1,0,NA
"Vigethia","Asteraceae","Asterales",0,0,0,1,0,NA
"Vigna","Fabaceae","Fabales",0,0,1,118,1,0
"Viguiera","Asteraceae","Asterales",0,0,0,153,0,NA
"Viguieranthus","Fabaceae","Fabales",0,0,0,18,0,NA
"Viguierella","Poaceae","Poales",0,0,0,1,0,NA
"Villadia","Crassulaceae","Saxifragales",0,0,0,44,0,NA
"Villanova","Asteraceae","Asterales",0,0,0,4,0,NA
"Villaria","Rubiaceae","Gentianales",0,0,0,5,0,NA
"Villarsia","Menyanthaceae","Asterales",0,0,0,5,0,NA
"Villasenoria","Asteraceae","Asterales",0,0,0,1,0,NA
"Villebrunea","Urticaceae","Rosales",0,0,0,1,0,NA
"Vilmorinia","Fabaceae","Fabales",0,0,0,2,0,NA
"Viminaria","Fabaceae","Fabales",0,0,0,1,0,NA
"Vinca","Apocynaceae","Gentianales",0,0,1,5,1,0
"Vincetoxicum","Apocynaceae","Gentianales",0,1,2,71,2,0
"Vindasia","Acanthaceae","Lamiales",0,0,0,1,0,NA
"Vinicia","Asteraceae","Asterales",0,0,0,1,0,NA
"Vinkia","Haloragaceae","Saxifragales",0,0,0,1,0,NA
"Viola","Violaceae","Malpighiales",1,0,59,478,60,0.0166666666666667
"Viorna","Ranunculaceae","Ranunculales",0,0,0,4,0,NA
"Viposia","Celastraceae","Celastrales",0,0,0,1,0,NA
"Virectaria","Rubiaceae","Gentianales",0,0,2,8,2,0
"Virgilia","Fabaceae","Fabales",2,0,0,2,2,1
"Viridivia","Passifloraceae","Malpighiales",0,0,0,1,0,NA
"Virola","Myristicaceae","Magnoliales",28,0,0,48,28,1
"Virotia","Proteaceae","Proteales",0,0,0,2,0,NA
"Viscainoa","Zygophyllaceae","Zygophyllales",0,0,0,1,0,NA
"Viscum","Santalaceae","Santalales",3,0,0,74,3,1
"Vismia","Hypericaceae","Malpighiales",11,0,0,59,11,1
"Vismianthus","Connaraceae","Oxalidales",1,0,0,2,1,1
"Vitaliana","Primulaceae","Ericales",0,0,1,1,1,0
"Vitekorchis","Orchidaceae","Asparagales",0,0,0,4,0,NA
"Vitellaria","Sapotaceae","Ericales",1,0,0,1,1,1
"Vitellariopsis","Sapotaceae","Ericales",3,0,0,5,3,1
"Vitex","Lamiaceae","Lamiales",48,0,0,223,48,1
"Viticella","Boraginaceae","UnknownOrder-Boraginaceae",0,0,0,1,0,NA
"Vitis","Vitaceae","Vitales",11,0,0,79,11,1
"Vittadinia","Asteraceae","Asterales",0,0,4,29,4,0
"Vittaria","Pteridaceae","Polypodiales",0,0,7,41,7,0
"Vittetia","Asteraceae","Asterales",0,0,0,2,0,NA
"Viviania","Vivianiaceae","Geraniales",1,0,0,3,1,1
"Vlokia","Aizoaceae","Caryophyllales",0,0,0,1,0,NA
"Voacanga","Apocynaceae","Gentianales",2,0,0,14,2,1
"Voanioala","Arecaceae","Arecales",1,0,0,1,1,1
"Voatamalo","Picrodendraceae","Malpighiales",0,0,0,2,0,NA
"Vochysia","Vochysiaceae","Myrtales",29,0,0,117,29,1
"Volkameria","Lamiaceae","Lamiales",0,0,0,11,0,NA
"Volkensinia","Amaranthaceae","Caryophyllales",0,0,0,1,0,NA
"Volkiella","Cyperaceae","Poales",0,0,1,1,1,0
"Volutarella","Asteraceae","Asterales",0,0,0,4,0,NA
"Volutaria","Asteraceae","Asterales",0,0,0,16,0,NA
"Volvulus","Convolvulaceae","Solanales",0,0,0,4,0,NA
"Vossia","Poaceae","Poales",0,0,0,1,0,NA
"Votomita","Melastomataceae","Myrtales",0,0,0,10,0,NA
"Votschia","Primulaceae","Ericales",0,0,0,1,0,NA
"Vouacapoua","Fabaceae","Fabales",3,0,0,11,3,1
"Vouapa","Fabaceae","Fabales",0,0,0,2,0,NA
"Vouarana","Sapindaceae","Sapindales",2,0,0,2,2,1
"Voyria","Gentianaceae","Gentianales",0,0,0,19,0,NA
"Voyriella","Gentianaceae","Gentianales",0,0,0,1,0,NA
"Vriesea","Bromeliaceae","Poales",0,0,16,361,16,0
"Vrydagzynea","Orchidaceae","Asparagales",0,0,0,43,0,NA
"Vuapa","Fabaceae","Fabales",0,0,0,2,0,NA
"Vulpia","Poaceae","Poales",0,0,6,26,6,0
"Vulpiella","Poaceae","Poales",0,0,0,1,0,NA
"Vvedenskia","Apiaceae","Apiales",0,0,0,1,0,NA
"Wachendorfia","Haemodoraceae","Commelinales",0,0,2,4,2,0
"Wagatea","Fabaceae","Fabales",0,0,0,1,0,NA
"Wagneriopteris","Tectariaceae","Polypodiales",0,0,0,6,0,NA
"Wahlenbergia","Campanulaceae","Asterales",2,0,30,263,32,0.0625
"Waireia","Orchidaceae","Asparagales",0,0,0,1,0,NA
"Waitzia","Asteraceae","Asterales",0,0,2,5,2,0
"Wajira","Fabaceae","Fabales",0,0,0,5,0,NA
"Walafrida","Scrophulariaceae","Lamiales",0,0,1,37,1,0
"Waldheimia","Asteraceae","Asterales",0,0,0,6,0,NA
"Waldsteinia","Rosaceae","Rosales",0,0,1,4,1,0
"Wallacea","Ochnaceae","Malpighiales",1,0,0,3,1,1
"Wallaceodendron","Fabaceae","Fabales",1,0,0,1,1,1
"Wallenia","Primulaceae","Ericales",2,0,0,8,2,1
"Walleria","Tecophilaeaceae","Asparagales",0,0,1,3,1,0
"Wallichia","Arecaceae","Arecales",1,0,0,8,1,1
"Walsura","Meliaceae","Sapindales",3,0,0,4,3,1
"Waltheria","Malvaceae","Malvales",2,0,0,47,2,1
"Wamalchitamia","Asteraceae","Asterales",1,0,0,5,1,1
"Wangenheimia","Poaceae","Poales",0,0,0,1,0,NA
"Warburgia","Canellaceae","Canellales",2,0,0,4,2,1
"Warczewiczella","Orchidaceae","Asparagales",0,0,5,11,5,0
"Wardaster","Asteraceae","Asterales",0,0,0,1,0,NA
"Warea","Brassicaceae","Brassicales",0,0,0,4,0,NA
"Warionia","Asteraceae","Asterales",1,0,0,1,1,1
"Warmingia","Orchidaceae","Asparagales",0,0,0,4,0,NA
"Warneckea","Melastomataceae","Myrtales",0,0,0,35,0,NA
"Warnockia","Lamiaceae","Lamiales",0,0,0,1,0,NA
"Warrea","Orchidaceae","Asparagales",0,0,1,3,1,0
"Warreella","Orchidaceae","Asparagales",0,0,0,2,0,NA
"Warreopsis","Orchidaceae","Asparagales",0,0,2,4,2,0
"Warscewiczella","Orchidaceae","Asparagales",0,0,0,1,0,NA
"Warszewiczia","Rubiaceae","Gentianales",2,0,0,8,2,1
"Washingtonia","Apiaceae",NA,0,0,0,3,0,NA
"Washingtonia","Arecaceae","Arecales",2,0,0,2,2,1
"Watsonia","Iridaceae","Asparagales",0,0,39,56,39,0
"Weatherbya","Polypodiaceae","Polypodiales",0,0,0,1,0,NA
"Weberbauera","Brassicaceae","Brassicales",0,0,0,21,0,NA
"Weberbauerella","Fabaceae","Fabales",0,0,0,2,0,NA
"Weberbauerocereus","Cactaceae","Caryophyllales",0,0,0,9,0,NA
"Weberocereus","Cactaceae","Caryophyllales",0,0,0,9,0,NA
"Weddellina","Podostemaceae","Malpighiales",0,0,1,1,1,0
"Wedelia","Asteraceae","Asterales",0,0,2,107,2,0
"Weigela","Caprifoliaceae","Dipsacales",4,0,0,7,4,1
"Weigelastrum","Caprifoliaceae","Dipsacales",0,0,0,1,0,NA
"Weigeltia","Primulaceae","Ericales",0,0,0,1,0,NA
"Weihea","Rhizophoraceae","Malpighiales",0,0,0,1,0,NA
"Weingaertneria","Poaceae","Poales",0,0,0,1,0,NA
"Weingartia","Cactaceae","Caryophyllales",0,0,0,8,0,NA
"Weinmannia","Cunoniaceae","Oxalidales",12,0,0,117,12,1
"Welchiodendron","Myrtaceae","Myrtales",1,0,0,1,1,1
"Weldenia","Commelinaceae","Commelinales",0,0,1,1,1,0
"Welfia","Arecaceae","Arecales",1,0,0,1,1,1
"Wellstedia","Boraginaceae","UnknownOrder-Boraginaceae",0,0,0,1,0,NA
"Welwitschia","Welwitschiaceae","Welwitschiales",1,0,0,1,1,1
"Welwitschiella","Asteraceae","Asterales",0,0,0,1,0,NA
"Wenchengia","Lamiaceae","Lamiales",0,0,0,1,0,NA
"Wendlandia","Rubiaceae","Gentianales",3,0,0,82,3,1
"Wendlandiella","Arecaceae","Arecales",1,0,0,1,1,1
"Wendtia","Vivianiaceae","Geraniales",1,0,0,1,1,1
"Wercklea","Malvaceae","Malvales",0,0,0,11,0,NA
"Werckleocereus","Cactaceae","Caryophyllales",0,0,0,1,0,NA
"Werdermannia","Brassicaceae","Brassicales",0,0,0,2,0,NA
"Werneria","Asteraceae","Asterales",0,0,2,19,2,0
"Westia","Fabaceae","Fabales",0,0,0,5,0,NA
"Westoniella","Asteraceae","Asterales",0,0,0,6,0,NA
"Westringia","Lamiaceae","Lamiales",1,0,0,31,1,1
"Wetria","Euphorbiaceae","Malpighiales",2,0,0,2,2,1
"Wettinia","Arecaceae","Arecales",21,0,0,21,21,1
"Wettsteiniola","Podostemaceae","Malpighiales",0,0,0,3,0,NA
"Whipplea","Hydrangeaceae","Cornales",1,0,0,1,1,1
"Whiteochloa","Poaceae","Poales",0,0,0,6,0,NA
"Whiteodendron","Myrtaceae","Myrtales",1,0,0,1,1,1
"Whitfieldia","Acanthaceae","Lamiales",1,0,0,14,1,1
"Whitmorea","Stemonuraceae","Aquifoliales",1,0,0,1,1,1
"Whittonia","Peridiscaceae","Saxifragales",0,0,0,1,0,NA
"Whyanbeelia","Picrodendraceae","Malpighiales",0,0,0,1,0,NA
"Whytockia","Gesneriaceae","Lamiales",0,0,0,8,0,NA
"Wiborgia","Fabaceae","Fabales",0,0,0,10,0,NA
"Widdringtonia","Cupressaceae","Cupressales",2,0,0,4,2,1
"Widgrenia","Apocynaceae","Gentianales",0,0,0,1,0,NA
"Wielandia","Phyllanthaceae","Malpighiales",4,0,0,13,4,1
"Wiesneria","Alismataceae","Alismatales",0,0,1,3,1,0
"Wiestia","Asteraceae","Asterales",0,0,0,1,0,NA
"Wigandia","Boraginaceae","UnknownOrder-Boraginaceae",1,0,0,2,1,1
"Wigginsia","Cactaceae","Caryophyllales",0,0,0,11,0,NA
"Wightia","Paulowniaceae","Lamiales",1,0,0,1,1,1
"Wikstroemia","Thymelaeaceae","Malvales",5,0,0,88,5,1
"Wilbrandia","Cucurbitaceae","Cucurbitales",0,0,1,6,1,0
"Wilhelmsia","Caryophyllaceae","Caryophyllales",0,0,0,1,0,NA
"Wilkesia","Asteraceae","Asterales",0,0,0,2,0,NA
"Wilkiea","Monimiaceae","Laurales",4,0,0,8,4,1
"Willardia","Fabaceae","Fabales",0,0,0,3,0,NA
"Willdenowia","Restionaceae","Poales",0,0,2,12,2,0
"Willemetia","Asteraceae","Asterales",0,0,0,2,0,NA
"Williamodendron","Lauraceae","Laurales",1,0,0,4,1,1
"Willisia","Podostemaceae","Malpighiales",0,0,0,1,0,NA
"Willkommia","Poaceae","Poales",0,0,0,4,0,NA
"Willoughbya","Asteraceae","Asterales",0,0,0,1,0,NA
"Willughbeia","Apocynaceae","Gentianales",1,0,0,17,1,1
"Wimmerella","Campanulaceae","Asterales",0,0,1,10,1,0
"Wimmeria","Celastraceae","Celastrales",1,0,0,16,1,1
"Windsorina","Rapateaceae","Poales",0,0,1,1,1,0
"Winifredia","Restionaceae","Poales",0,0,1,1,1,0
"Winklera","Brassicaceae","Brassicales",0,0,0,3,0,NA
"Wislizenia","Cleomaceae","Brassicales",0,0,1,3,1,0
"Wissadula","Malvaceae","Malvales",0,0,0,35,0,NA
"Wisteria","Fabaceae","Fabales",2,0,0,9,2,1
"Withania","Solanaceae","Solanales",3,0,0,8,3,1
"Witheringia","Solanaceae","Solanales",1,0,0,19,1,1
"Witsenia","Iridaceae","Asparagales",1,0,0,1,1,1
"Wittmackanthus","Rubiaceae","Gentianales",1,0,0,1,1,1
"Wodyetia","Arecaceae","Arecales",1,0,0,1,1,1
"Wolffia","Araceae","Alismatales",0,0,11,11,11,0
"Wolffiella","Araceae","Alismatales",0,0,10,10,10,0
"Wollastonia","Asteraceae","Asterales",0,0,1,1,1,0
"Wollemia","Araucariaceae","Araucariales",1,0,0,1,1,1
"Woodburnia","Araliaceae","Apiales",0,0,0,1,0,NA
"Woodfordia","Lythraceae","Myrtales",1,0,0,2,1,1
"Woodia","Apocynaceae","Gentianales",0,0,0,3,0,NA
"Woodiellantha","Annonaceae","Magnoliales",0,0,0,1,0,NA
"Woodsia","Woodsiaceae","Polypodiales",0,0,3,43,3,0
"Woodwardia","Blechnaceae","Polypodiales",0,0,2,24,2,0
"Wooleya","Aizoaceae","Caryophyllales",0,0,0,1,0,NA
"Woollsia","Ericaceae","Ericales",1,0,0,1,1,1
"Wormskioldia","Passifloraceae","Malpighiales",0,0,0,1,0,NA
"Woronowia","Rosaceae","Rosales",0,0,0,1,0,NA
"Worsleya","Amaryllidaceae","Asparagales",0,0,1,1,1,0
"Wrightia","Apocynaceae","Gentianales",10,0,0,32,10,1
"Wrixonia","Lamiaceae","Lamiales",0,0,0,2,0,NA
"Wulfenia","Plantaginaceae","Lamiales",0,0,0,5,0,NA
"Wulfeniopsis","Plantaginaceae","Lamiales",0,0,0,1,0,NA
"Wulffia","Asteraceae","Asterales",0,0,0,4,0,NA
"Wullschlaegelia","Orchidaceae","Asparagales",0,0,1,2,1,0
"Wunderlichia","Asteraceae","Asterales",0,0,0,6,0,NA
"Wurdackanthus","Gentianaceae","Gentianales",0,0,0,1,0,NA
"Wurdastom","Melastomataceae","Myrtales",0,0,0,8,0,NA
"Wurmbea","Colchicaceae","Liliales",0,0,20,50,20,0
"Wyethia","Asteraceae","Asterales",0,0,0,11,0,NA
"Xantheranthemum","Acanthaceae","Lamiales",0,0,0,1,0,NA
"Xanthisma","Asteraceae","Asterales",0,0,0,13,0,NA
"Xanthium","Asteraceae","Asterales",0,0,0,11,0,NA
"Xanthocephalum","Asteraceae","Asterales",0,0,0,7,0,NA
"Xanthoceras","Sapindaceae","Sapindales",1,0,0,1,1,1
"Xanthocercis","Fabaceae","Fabales",2,0,0,3,2,1
"Xanthochloa","Poaceae","Poales",0,0,0,1,0,NA
"Xanthomyrtus","Myrtaceae","Myrtales",0,0,0,25,0,NA
"Xanthopappus","Asteraceae","Asterales",0,0,0,1,0,NA
"Xanthophyllum","Polygalaceae","Fabales",9,0,0,58,9,1
"Xanthophytum","Rubiaceae","Gentianales",2,0,0,32,2,1
"Xanthorhiza","Ranunculaceae","Ranunculales",1,0,0,1,1,1
"Xanthorrhoea","Xanthorrhoeaceae","Asparagales",20,0,0,28,20,1
"Xanthosia","Apiaceae","Apiales",0,0,0,1,0,NA
"Xanthosoma","Araceae","Alismatales",0,0,1,76,1,0
"Xanthostachya","Acanthaceae","Lamiales",0,0,0,1,0,NA
"Xanthostemon","Myrtaceae","Myrtales",30,0,0,49,30,1
"Xanthoxalis","Oxalidaceae","Oxalidales",0,0,0,3,0,NA
"Xantolis","Sapotaceae","Ericales",2,0,0,14,2,1
"Xantonnea","Rubiaceae","Gentianales",0,0,0,2,0,NA
"Xantonneopsis","Rubiaceae","Gentianales",0,0,0,1,0,NA
"Xatardia","Apiaceae","Apiales",0,0,0,1,0,NA
"Xenacanthus","Acanthaceae","Lamiales",0,0,0,1,0,NA
"Xenikophyton","Orchidaceae","Asparagales",0,0,0,2,0,NA
"Xenophyllum","Asteraceae","Asterales",0,0,1,21,1,0
"Xenoscapa","Iridaceae","Asparagales",0,0,1,2,1,0
"Xeranthemum","Asteraceae","Asterales",0,0,2,6,2,0
"Xeroaloysia","Verbenaceae","Lamiales",0,0,0,1,0,NA
"Xerochlamys","Sarcolaenaceae","Malvales",1,0,0,8,1,1
"Xerochloa","Poaceae","Poales",0,0,0,3,0,NA
"Xerochrysum","Asteraceae","Asterales",0,0,1,8,1,0
"Xerocladia","Fabaceae","Fabales",0,0,0,1,0,NA
"Xeroderris","Fabaceae","Fabales",2,0,0,2,2,1
"Xerodraba","Brassicaceae","Brassicales",0,0,0,7,0,NA
"Xerolekia","Asteraceae","Asterales",0,0,1,1,1,0
"Xerolirion","Asparagaceae","Asparagales",0,0,1,1,1,0
"Xeronema","Xeronemataceae","Asparagales",0,0,1,2,1,0
"Xerophyllum","Melanthiaceae","Liliales",0,0,2,2,2,0
"Xerophyta","Velloziaceae","Pandanales",2,0,0,34,2,1
"Xerorchis","Orchidaceae","Asparagales",0,0,1,2,1,0
"Xerosicyos","Cucurbitaceae","Cucurbitales",1,1,0,5,1,1
"Xerosiphon","Amaranthaceae","Caryophyllales",0,0,0,2,0,NA
"Xerospermum","Sapindaceae","Sapindales",1,0,0,2,1,1
"Xerospiraea","Rosaceae","Rosales",0,0,0,1,0,NA
"Xerxes","Asteraceae","Asterales",0,0,0,1,0,NA
"Xestaea","Gentianaceae","Gentianales",0,0,0,1,0,NA
"Ximenia","Olacaceae","Santalales",5,0,0,10,5,1
"Ximeniopsis","Olacaceae","Santalales",0,0,0,1,0,NA
"Xiphidium","Haemodoraceae","Commelinales",0,0,1,2,1,0
"Xiphochaeta","Asteraceae","Asterales",0,0,0,1,0,NA
"Xiphopterella","Polypodiaceae","Polypodiales",0,0,0,1,0,NA
"Xiphopteris","Polypodiaceae","Polypodiales",0,0,0,13,0,NA
"Xiphotheca","Fabaceae","Fabales",1,0,0,1,1,1
"Xipotheca","Fabaceae","Fabales",0,0,0,6,0,NA
"Xizangia","Orobanchaceae","Lamiales",0,0,0,1,0,NA
"Xolisma","Ericaceae","Ericales",0,0,0,3,0,NA
"Xolocotzia","Verbenaceae","Lamiales",0,0,0,1,0,NA
"Xylanthemum","Asteraceae","Asterales",0,0,0,7,0,NA
"Xylia","Fabaceae","Fabales",4,0,0,9,4,1
"Xylobium","Orchidaceae","Asparagales",0,0,4,31,4,0
"Xylocalyx","Orobanchaceae","Lamiales",0,0,0,1,0,NA
"Xylocarpus","Meliaceae","Sapindales",3,0,0,3,3,1
"Xylococcus","Ericaceae","Ericales",1,0,0,1,1,1
"Xylomelum","Proteaceae","Proteales",1,0,0,1,1,1
"Xylonagra","Onagraceae","Myrtales",0,0,0,1,0,NA
"Xyloolaena","Sarcolaenaceae","Malvales",2,0,0,5,2,1
"Xylophacos","Fabaceae","Fabales",0,0,0,3,0,NA
"Xylophragma","Bignoniaceae","Lamiales",3,0,0,7,3,1
"Xylopia","Annonaceae","Magnoliales",36,0,0,109,36,1
"Xylopodia","Loasaceae","Cornales",1,0,0,1,1,1
"Xylorhiza","Asteraceae","Asterales",2,0,0,10,2,1
"Xylosma","Salicaceae","Malpighiales",26,0,0,45,26,1
"Xylosteon","Caprifoliaceae","Dipsacales",0,0,0,2,0,NA
"Xylosterculia","Malvaceae","Malvales",0,0,0,1,0,NA
"Xylothamia","Asteraceae","Asterales",0,0,0,8,0,NA
"Xylotheca","Achariaceae","Malpighiales",0,0,0,4,0,NA
"Xylovirgata","Asteraceae","Asterales",0,0,0,1,0,NA
"Xymalos","Monimiaceae","Laurales",1,0,0,1,1,1
"Xyris","Xyridaceae","Poales",0,0,29,361,29,0
"Xyropteris","Lindsaeaceae","Polypodiales",0,0,0,1,0,NA
"Xysmalobium","Apocynaceae","Gentianales",0,0,1,43,1,0
"Yabea","Apiaceae","Apiales",0,0,0,1,0,NA
"Yakirra","Poaceae","Poales",0,0,0,7,0,NA
"Yanomamua","Gentianaceae","Gentianales",0,0,0,1,0,NA
"Yasunia","Lauraceae","Laurales",0,0,0,1,0,NA
"Yavia","Cactaceae","Caryophyllales",0,0,0,1,0,NA
"Yeatesia","Acanthaceae","Lamiales",0,0,0,3,0,NA
"Yermo","Asteraceae","Asterales",0,0,0,1,0,NA
"Yinshania","Brassicaceae","Brassicales",0,0,0,7,0,NA
"Yoania","Orchidaceae","Asparagales",0,0,0,4,0,NA
"Youngia","Asteraceae","Asterales",0,0,1,39,1,0
"Ypsilandra","Melanthiaceae","Liliales",0,0,1,6,1,0
"Ypsilopus","Orchidaceae","Asparagales",0,0,2,5,2,0
"Ypsilorchis","Orchidaceae","Asparagales",0,0,0,1,0,NA
"Yua","Vitaceae","Vitales",0,0,0,2,0,NA
"Yucca","Asparagaceae","Asparagales",12,1,5,49,17,0.705882352941177
"Yulania","Magnoliaceae","Magnoliales",0,0,0,3,0,NA
"Yunquea","Asteraceae","Asterales",0,0,0,1,0,NA
"Yushania","Poaceae","Poales",2,0,0,86,2,1
"Yvesia","Poaceae","Poales",0,0,0,1,0,NA
"Zabelia","Caprifoliaceae","Dipsacales",0,0,0,1,0,NA
"Zagrosia","Asparagaceae","Asparagales",0,0,0,1,0,NA
"Zaleya","Aizoaceae","Caryophyllales",0,0,0,4,0,NA
"Zaluzania","Asteraceae","Asterales",0,0,1,14,1,0
"Zaluzianskya","Scrophulariaceae","Lamiales",0,0,5,59,5,0
"Zameioscirpus","Cyperaceae","Poales",0,0,3,3,3,0
"Zamia","Zamiaceae","Cycadales",8,0,0,65,8,1
"Zamioculcas","Araceae","Alismatales",0,0,1,1,1,0
"Zanha","Sapindaceae","Sapindales",2,0,0,3,2,1
"Zannichellia","Potamogetonaceae","Alismatales",0,0,1,7,1,0
"Zanonia","Cucurbitaceae","Cucurbitales",0,0,0,1,0,NA
"Zantedeschia","Araceae","Alismatales",0,0,1,8,1,0
"Zanthoxylum","Rutaceae","Sapindales",33,0,0,176,33,1
"Zapoteca","Fabaceae","Fabales",2,0,0,21,2,1
"Zataria","Lamiaceae","Lamiales",0,0,0,1,0,NA
"Zauschneria","Onagraceae","Myrtales",0,0,0,5,0,NA
"Zea","Poaceae","Poales",0,0,1,6,1,0
"Zehneria","Cucurbitaceae","Cucurbitales",0,0,2,31,2,0
"Zelenkoa","Orchidaceae","Asparagales",0,0,1,1,1,0
"Zelkova","Ulmaceae","Rosales",4,0,0,6,4,1
"Zeltnera","Gentianaceae","Gentianales",0,0,3,23,3,0
"Zemisia","Asteraceae","Asterales",0,0,0,1,0,NA
"Zenia","Fabaceae","Fabales",1,0,0,1,1,1
"Zenkerella","Fabaceae","Fabales",0,0,0,6,0,NA
"Zenkeria","Poaceae","Poales",0,0,0,5,0,NA
"Zenobia","Ericaceae","Ericales",1,0,0,3,1,1
"Zephyra","Tecophilaeaceae","Asparagales",0,0,2,2,2,0
"Zephyranthes","Amaryllidaceae","Asparagales",0,0,8,88,8,0
"Zerdana","Brassicaceae","Brassicales",0,0,0,1,0,NA
"Zeugandra","Campanulaceae","Asterales",0,0,0,2,0,NA
"Zeugites","Poaceae","Poales",0,0,6,10,6,0
"Zeuktophyllum","Aizoaceae","Caryophyllales",0,0,0,1,0,NA
"Zeuxine","Orchidaceae","Asparagales",0,0,1,75,1,0
"Zeuxinella","Orchidaceae","Asparagales",0,0,0,1,0,NA
"Zexmenia","Asteraceae","Asterales",1,0,0,11,1,1
"Zeyheria","Bignoniaceae","Lamiales",1,0,0,2,1,1
"Zeylanidium","Podostemaceae","Malpighiales",0,0,0,3,0,NA
"Zhumeria","Lamiaceae","Lamiales",0,0,0,1,0,NA
"Zieria","Rutaceae","Sapindales",0,0,0,1,0,NA
"Zieridium","Rutaceae","Sapindales",0,0,0,1,0,NA
"Zigadenus","Melanthiaceae","Liliales",0,0,1,1,1,0
"Zilla","Brassicaceae","Brassicales",1,0,0,2,1,1
"Zingania","Fabaceae","Fabales",0,0,0,1,0,NA
"Zingeria","Poaceae","Poales",0,0,1,5,1,0
"Zingiber","Zingiberaceae","Zingiberales",0,0,5,144,5,0
"Zinnia","Asteraceae","Asterales",0,0,3,22,3,0
"Zinowiewia","Celastraceae","Celastrales",0,0,0,13,0,NA
"Zippelia","Piperaceae","Piperales",0,0,1,1,1,0
"Zizania","Poaceae","Poales",0,0,4,4,4,0
"Zizaniopsis","Poaceae","Poales",0,0,1,5,1,0
"Zizia","Apiaceae","Apiales",0,0,3,6,3,0
"Ziziphora","Lamiaceae","Lamiales",0,0,3,17,3,0
"Ziziphus","Rhamnaceae","Rosales",23,0,0,53,23,1
"Zoegea","Asteraceae","Asterales",0,0,1,3,1,0
"Zollernia","Fabaceae","Fabales",3,0,0,10,3,1
"Zollikoferia","Asteraceae","Asterales",0,0,0,1,0,NA
"Zombia","Arecaceae","Arecales",1,0,0,1,1,1
"Zomicarpa","Araceae","Alismatales",0,0,0,3,0,NA
"Zomicarpella","Araceae","Alismatales",0,0,0,2,0,NA
"Zonotriche","Poaceae","Poales",0,0,0,3,0,NA
"Zootrophion","Orchidaceae","Asparagales",0,0,1,21,1,0
"Zornia","Fabaceae","Fabales",0,0,1,86,1,0
"Zosima","Apiaceae","Apiales",0,0,0,2,0,NA
"Zostera","Zosteraceae","Alismatales",0,0,13,16,13,0
"Zoutpansbergia","Asteraceae","Asterales",0,1,0,1,0,NA
"Zoysia","Poaceae","Poales",0,0,5,11,5,0
"Zuccagnia","Fabaceae","Fabales",1,0,0,1,1,1
"Zuccarinia","Rubiaceae","Gentianales",0,0,0,1,0,NA
"Zuckia","Amaranthaceae","Caryophyllales",0,0,0,1,0,NA
"Zuelania","Salicaceae","Malpighiales",1,0,0,1,1,1
"Zuvanda","Brassicaceae","Brassicales",0,0,0,2,0,NA
"Zygia","Fabaceae","Fabales",12,0,0,65,12,1
"Zygochloa","Poaceae","Poales",1,0,0,1,1,1
"Zygogynum","Winteraceae","Canellales",6,0,0,6,6,1
"Zygopabstia","Orchidaceae","Asparagales",0,0,0,1,0,NA
"Zygopetalum","Orchidaceae","Asparagales",0,0,2,15,2,0
"Zygophlebia","Polypodiaceae","Polypodiales",0,0,0,12,0,NA
"Zygophyllum","Zygophyllaceae","Zygophyllales",0,0,4,69,4,0
"Zygoruellia","Acanthaceae","Lamiales",0,0,0,1,0,NA
"Zygosepalum","Orchidaceae","Asparagales",0,0,2,8,2,0
"Zygosicyos","Cucurbitaceae","Cucurbitales",0,1,0,1,0,NA
"Zygostates","Orchidaceae","Asparagales",0,0,2,22,2,0
"Zygostigma","Gentianaceae","Gentianales",0,0,0,1,0,NA
"Zygotritonia","Iridaceae","Asparagales",0,0,3,4,3,0
"Zyrphelis","Asteraceae","Asterales",0,0,0,9,0,NA
"Zyzyxia","Asteraceae","Asterales",0,0,0,1,0,NA
